O.S.N,Candidate,Party,EVM Votes,Postal Votes,Total Votes,% of Votes,state_constituency
1,ABDUL BATIN KHANDAKAR,Indian National Congress,92698,578,93276,58.58,Assam-ABHAYAPURI NORTH
2,ASRAFUL ISLAM,All India Trinamool Congress,1545,22,1567,0.98,Assam-ABHAYAPURI NORTH
3,BHUPEN ROY,Asom Gana Parishad,59637,858,60495,38,Assam-ABHAYAPURI NORTH
4,AJANTA BARUAH,Assam Jatiya Parishad,1173,91,1264,0.79,Assam-ABHAYAPURI NORTH
5,SHYAM RAJ RABHA,Janata Dal  (United),349,17,366,0.23,Assam-ABHAYAPURI NORTH
6,JAHIDUL ISLAM,Independent,406,7,413,0.26,Assam-ABHAYAPURI NORTH
7,SHEIKH ABDULLAH,Independent,808,3,811,0.51,Assam-ABHAYAPURI NORTH
8,NOTA,None of the Above,1015,10,1025,0.64,Assam-ABHAYAPURI NORTH
1,PURNENDU BANIKYA,Asom Gana Parishad,65130,739,65869,35.59,Assam-ABHAYAPURI SOUTH
2,PRADIP SARKAR,Indian National Congress,112341,613,112954,61.04,Assam-ABHAYAPURI SOUTH
3,KAUSHIK RANJAN DAS,Independent,2090,15,2105,1.14,Assam-ABHAYAPURI SOUTH
4,ROMONATH MONDAL,Independent,2469,20,2489,1.34,Assam-ABHAYAPURI SOUTH
5,NOTA,None of the Above,1617,25,1642,0.89,Assam-ABHAYAPURI SOUTH
1,Aftab Uddin Laskar,Asom Gana Parishad,7458,91,7549,5.59,Assam-ALGAPUR
2,Nijam Uddin Choudhury,All India United Democratic Front,66134,651,66785,49.46,Assam-ALGAPUR
3,Moon Swarnakar,Bharatiya Janata Party,48894,287,49181,36.42,Assam-ALGAPUR
4,Simu Das,All India Forward Bloc,549,3,552,0.41,Assam-ALGAPUR
5,Alim Uddin Laskar,Independent,135,1,136,0.1,Assam-ALGAPUR
6,Imadul Islam Laskar,Independent,93,2,95,0.07,Assam-ALGAPUR
7,Kaji Abdul Hakim,Independent,279,1,280,0.21,Assam-ALGAPUR
8,Gulzar Ahmed Barbhuiya,Independent,339,0,339,0.25,Assam-ALGAPUR
9,Jahanara Begum Mazumder,Independent,314,0,314,0.23,Assam-ALGAPUR
10,Daisy Roy,Independent,1588,13,1601,1.19,Assam-ALGAPUR
11,Badrul Islam Barbhuiya,Independent,1379,24,1403,1.04,Assam-ALGAPUR
12,Babul Kumar,Independent,2339,4,2343,1.74,Assam-ALGAPUR
13,Bulbul Alam Choudhury,Independent,534,0,534,0.4,Assam-ALGAPUR
14,Brojendra Chandra Das,Independent,466,0,466,0.35,Assam-ALGAPUR
15,Manoj Kumar Malakar,Independent,793,1,794,0.59,Assam-ALGAPUR
16,Raju Das,Independent,759,1,760,0.56,Assam-ALGAPUR
17,Raju Deb,Independent,224,0,224,0.17,Assam-ALGAPUR
18,Samin Ahmed Choudhury,Independent,634,0,634,0.47,Assam-ALGAPUR
19,Saleh Ahmed Mazumder,Independent,593,1,594,0.44,Assam-ALGAPUR
20,NOTA,None of the Above,433,9,442,0.33,Assam-ALGAPUR
1,Angkita Dutta,Indian National Congress,43315,397,43712,42.08,Assam-AMGURI
2,PRODIP HAZARIKA,Asom Gana Parishad,49420,471,49891,48.03,Assam-AMGURI
3,Chandra Boruah,Assam Jatiya Parishad,6882,105,6987,6.73,Assam-AMGURI
4,Pradip Hazarika,Independent,1011,11,1022,0.98,Assam-AMGURI
5,Rajkumar Duwara,Independent,953,6,959,0.92,Assam-AMGURI
6,NOTA,None of the Above,1301,12,1313,1.26,Assam-AMGURI
1,ABDUL AZIZ,All India United Democratic Front,73908,544,74452,56.62,Assam-BADARPUR
2,BISWARUP BHATTACHARJEE,Bharatiya Janata Party,49969,535,50504,38.41,Assam-BADARPUR
3,NIZAM UDDIN,Rashtriya Ulama Council,356,3,359,0.27,Assam-BADARPUR
4,SAHAB UDDIN,Assam Jatiya Parishad,2111,12,2123,1.61,Assam-BADARPUR
5,OLIOUR RAHAMAN TAPADAR,Independent,72,0,72,0.05,Assam-BADARPUR
6,ABDUL MALIK,Independent,455,1,456,0.35,Assam-BADARPUR
7,ABDUL HASIB,Independent,157,2,159,0.12,Assam-BADARPUR
8,ABDUS SUKKUR BEIG,Independent,77,1,78,0.06,Assam-BADARPUR
9,ENAM UDDIN,Independent,98,5,103,0.08,Assam-BADARPUR
10,KABIL MIYA,Independent,290,2,292,0.22,Assam-BADARPUR
11,NAJIM UDDIN,Independent,216,2,218,0.17,Assam-BADARPUR
12,BAHAR ASHIK,Independent,175,0,175,0.13,Assam-BADARPUR
13,RASID AHMED,Independent,229,0,229,0.17,Assam-BADARPUR
14,RIYAJ UDDIN,Independent,566,0,566,0.43,Assam-BADARPUR
15,NOTA,None of the Above,1692,14,1706,1.3,Assam-BADARPUR
1,Rajib Ahmed,All India United Democratic Front,65338,77,65415,43.24,Assam-BAGHBAR
2,Sherman Ali Ahmed,Indian National Congress,79245,112,79357,52.46,Assam-BAGHBAR
3,Hasinara Khatun,Bharatiya Janata Party,3018,20,3038,2.01,Assam-BAGHBAR
4,Abdul Aziz,Voters Party  International,612,1,613,0.41,Assam-BAGHBAR
5,Salim Khan,Bhartiya Rashtrawadi Party,170,0,170,0.11,Assam-BAGHBAR
6,Jahidul Islam,Janata Dal  (United),158,0,158,0.1,Assam-BAGHBAR
7,Moshwaraf Hussein,The National Road Map Party of India,408,1,409,0.27,Assam-BAGHBAR
8,Rejaul Karim,Republican Party of India (Athawale),617,0,617,0.41,Assam-BAGHBAR
9,Lil Chan Uddin,Republican Party of India (A),272,0,272,0.18,Assam-BAGHBAR
10,Afil Uddin Talukdar,Independent,486,1,487,0.32,Assam-BAGHBAR
11,NOTA,None of the Above,737,3,740,0.49,Assam-BAGHBAR
1,Augustine Enghee,Indian National Congress,36226,52,36278,22.24,Assam-BAITHALANGSO
2,Rupsing Teron,Bharatiya Janata Party,89577,138,89715,55,Assam-BAITHALANGSO
3,Welcome Teron,National People's Party,1874,7,1881,1.15,Assam-BAITHALANGSO
4,Sima Engtipi,Janata Dal  (United),942,0,942,0.58,Assam-BAITHALANGSO
5,Sarsing Engleng,Independent,11537,10,11547,7.08,Assam-BAITHALANGSO
6,Pratima Engheepi,Independent,1478,1,1479,0.91,Assam-BAITHALANGSO
7,Bikram Hanse,Independent,17955,10,17965,11.01,Assam-BAITHALANGSO
8,Rina Beypi,Independent,1218,5,1223,0.75,Assam-BAITHALANGSO
9,NOTA,None of the Above,2082,0,2082,1.28,Assam-BAITHALANGSO
1,PRABEEN BARO,Bodoland Peoples Front,38540,73,38613,28.96,Assam-BARAMA
2,BHUPEN BARO,"United Peopleâ€™s Party, Liberal",62270,115,62385,46.78,Assam-BARAMA
3,SAROJANI BASUMATARY,Voters Party  International,1795,3,1798,1.35,Assam-BARAMA
4,NABA KUMAR SARANIA,Independent,25851,39,25890,19.42,Assam-BARAMA
5,PRADIP KUMAR BARO,Independent,2568,1,2569,1.93,Assam-BARAMA
6,NOTA,None of the Above,2090,2,2092,1.57,Assam-BARAMA
1,GANESH KUMAR LIMBU,Bharatiya Janata Party,70176,393,70569,51.5,Assam-BARCHALLA
2,RAM PRASAD SHARMA,Indian National Congress,52628,159,52787,38.52,Assam-BARCHALLA
3,UPEN RAJ NATH,Assam Jatiya Parishad,10108,84,10192,7.44,Assam-BARCHALLA
4,HEMANTA KUMAR ADHIKARY,Independent,1613,11,1624,1.19,Assam-BARCHALLA
5,NOTA,None of the Above,1850,6,1856,1.35,Assam-BARCHALLA
1,JITU GOSWAMI,Bharatiya Janata Party,69799,312,70111,48.7,Assam-BARHAMPUR
2,SURESH BORAH,Indian National Congress,69111,249,69360,48.18,Assam-BARHAMPUR
3,DIPIKA SAIKIA KEOT,Assam Jatiya Parishad,1901,21,1922,1.34,Assam-BARHAMPUR
4,PARBIN CHOUDHURY,Asom Jana Morcha,332,1,333,0.23,Assam-BARHAMPUR
5,SONARAM BORA,SOCIALIST UNITY CENTRE OF INDIA (COMMUNIST),520,3,523,0.36,Assam-BARHAMPUR
6,SAMSHEDDIN AHMED,Independent,416,1,417,0.29,Assam-BARHAMPUR
7,NOTA,None of the Above,1285,6,1291,0.9,Assam-BARHAMPUR
1,CHAMPAK KALITA,All India United Democratic Front,1104,2,1106,0.64,Assam-BARKHETRI
2,DIGANTA BARMAN,Indian National Congress,85697,129,85826,49.46,Assam-BARKHETRI
3,NARAYAN DEKA,Bharatiya Janata Party,81580,192,81772,47.13,Assam-BARKHETRI
4,PULAKESH BARUAH,Assam Jatiya Parishad,2572,10,2582,1.49,Assam-BARKHETRI
5,SANTANU KALITA,Janata Dal  (United),802,3,805,0.46,Assam-BARKHETRI
6,BHUPEN TALUKDAR,Independent,487,0,487,0.28,Assam-BARKHETRI
7,NOTA,None of the Above,941,0,941,0.54,Assam-BARKHETRI
1,AMALENDU DAS,Bharatiya Janata Party,56906,496,57402,46.12,Assam-BARKHOLA
2,MISBAHUL ISLAM LASKAR,Indian National Congress,63950,483,64433,51.77,Assam-BARKHOLA
3,MEHBUB RAHMAN BARBHUIYA,Assam Jatiya Parishad,774,2,776,0.62,Assam-BARKHOLA
4,NAZMUL HOQUE LASKAR,Independent,261,2,263,0.21,Assam-BARKHOLA
5,HIFZUR RAHMAN LASKAR,Independent,474,1,475,0.38,Assam-BARKHOLA
6,NOTA,None of the Above,1095,10,1105,0.89,Assam-BARKHOLA
1,ABDUR RAHIM AHMED,Indian National Congress,110509,574,111083,61.04,Assam-BARPETA
2,Gunindra Nath Das,Asom Gana Parishad,65897,467,66364,36.47,Assam-BARPETA
3,SIRAJUL HOQUE,Rashtriya Ulama Council,749,5,754,0.41,Assam-BARPETA
4,Pintu Ghosh,Political Justice Party,686,8,694,0.38,Assam-BARPETA
5,Shyamal Kr. Mandal,Janata Dal  (United),384,21,405,0.22,Assam-BARPETA
6,SHAFIQUL ISLAM,The National Road Map Party of India,961,4,965,0.53,Assam-BARPETA
7,NOTA,None of the Above,1672,55,1727,0.95,Assam-BARPETA
1,Angoorlata Deka,Bharatiya Janata Party,51261,197,51458,36.64,Assam-BATADROBA
2,Sibamoni Bora,Indian National Congress,84039,239,84278,60.02,Assam-BATADROBA
3,Anupam Baruah,Janata Dal  (United),812,3,815,0.58,Assam-BATADROBA
4,Fakar Uddin,Asom Jana Morcha,272,2,274,0.2,Assam-BATADROBA
5,Musleha Begum,Rashtriya Ulama Council,461,2,463,0.33,Assam-BATADROBA
6,Prafulla Rajkhowa,Independent,368,2,370,0.26,Assam-BATADROBA
7,Matiur Rahman,Independent,1682,8,1690,1.2,Assam-BATADROBA
8,NOTA,None of the Above,1072,6,1078,0.77,Assam-BATADROBA
1,RANJIT DUTTA,Bharatiya Janata Party,53335,248,53583,50.93,Assam-BEHALI
2,ANJAN UPADHYAYA,Assam Jatiya Parishad,3322,21,3343,3.18,Assam-BEHALI
3,BIBEK DAS,Communist Party of India  (Marxist-Leninist)  (Liberation),21452,79,21531,20.46,Assam-BEHALI
4,JAYANTA BORAH,Independent,23617,127,23744,22.57,Assam-BEHALI
5,NOTA,None of the Above,3003,9,3012,2.86,Assam-BEHALI
1,PHANIDHAR TALUKDAR,All India United Democratic Front,55546,429,55975,44.57,Assam-BHABANIPUR
2,RANJIT DEKA,Asom Gana Parishad,52236,512,52748,42,Assam-BHABANIPUR
3,ANOWAR UDDIN AHMED,Republican Party of India (Athawale),462,10,472,0.38,Assam-BHABANIPUR
4,SATYA CHANDRA ARJYA,Bharatiya Gana Parishad,348,21,369,0.29,Assam-BHABANIPUR
5,HASEN ALI,Voters Party  International,529,5,534,0.43,Assam-BHABANIPUR
6,ABUL KALAM AZAD,Independent,5351,49,5400,4.3,Assam-BHABANIPUR
7,KAMAL KUMAR MEDHI,Independent,3190,27,3217,2.56,Assam-BHABANIPUR
8,SUBAN ALI,Independent,415,1,416,0.33,Assam-BHABANIPUR
9,BINOY KHERKATARY,Independent,1563,31,1594,1.27,Assam-BHABANIPUR
10,MAKHAN SWARGIARY,Independent,1333,25,1358,1.08,Assam-BHABANIPUR
11,MD. RAHMAN ALI,Independent,1037,12,1049,0.84,Assam-BHABANIPUR
12,RUHUL AMIN,Independent,1432,2,1434,1.14,Assam-BHABANIPUR
13,NOTA,None of the Above,1027,10,1037,0.83,Assam-BHABANIPUR
1,DR. AMIYA KUMAR BHUYAN,Bharatiya Janata Party,58592,387,58979,48.53,Assam-BIHPURIA
2,BHUPEN KUMAR BORAH,Indian National Congress,48511,290,48801,40.16,Assam-BIHPURIA
3,ACHYUT SAIKIA (MADHAB),Assam Jatiya Parishad,6423,87,6510,5.36,Assam-BIHPURIA
4,SHOBHESHWAR GOGOI,Voters Party  International,726,3,729,0.6,Assam-BIHPURIA
5,ANUP SAIKIA,Independent,2532,13,2545,2.09,Assam-BIHPURIA
6,TULESWAR PEGU,Independent,1922,10,1932,1.59,Assam-BIHPURIA
7,PREMADHAR BORA,Independent,726,18,744,0.61,Assam-BIHPURIA
8,MOHIM BANIA,Independent,471,1,472,0.39,Assam-BIHPURIA
9,NOTA,None of the Above,807,7,814,0.67,Assam-BIHPURIA
1,AJOY KUMAR RAY,Bharatiya Janata Party,44909,824,45733,32.69,Assam-BIJNI
2,KAMALSHING NARZARY,Bodoland Peoples Front,43995,735,44730,31.97,Assam-BIJNI
3,NANDADEB BRAHMA,Voters Party  International,482,21,503,0.36,Assam-BIJNI
4,PHANIN BORO,"United Peopleâ€™s Party, Liberal",34899,683,35582,25.43,Assam-BIJNI
5,RUPAM KUMAR DAS,Assam Jatiya Parishad,9766,185,9951,7.11,Assam-BIJNI
6,ABDUL AWAL PARAMANIK,Independent,657,12,669,0.48,Assam-BIJNI
7,SOLEMAN MONDAL,Independent,548,23,571,0.41,Assam-BIJNI
8,BAHARUL ISLAM NAGORI,Independent,777,11,788,0.56,Assam-BIJNI
9,NOTA,None of the Above,1368,20,1388,0.99,Assam-BIJNI
1,ASHOK KUMAR SINGHI,Bharatiya Janata Party,66325,443,66768,34.11,Assam-BILASIPARA EAST
2,SAMSUL HUDA,All India United Democratic Front,115714,354,116068,59.3,Assam-BILASIPARA EAST
3,ABDUL MONNAF PRAMANIK,Janata Dal  (United),907,1,908,0.46,Assam-BILASIPARA EAST
4,KANULAL DAS,Assam Jatiya Parishad,3338,37,3375,1.72,Assam-BILASIPARA EAST
5,PRODIP CHANDRA ROY,Republican Party of India,397,6,403,0.21,Assam-BILASIPARA EAST
6,MOZNUR RAHMAN,Independent,474,4,478,0.24,Assam-BILASIPARA EAST
7,MOYNUL HOQUE,Independent,369,2,371,0.19,Assam-BILASIPARA EAST
8,ABDUL JABBAR,Independent,480,3,483,0.25,Assam-BILASIPARA EAST
9,JITENDRA NATH ADHIKARY,Independent,631,3,634,0.32,Assam-BILASIPARA EAST
10,MOMINUR ISLAM,Independent,2888,3,2891,1.48,Assam-BILASIPARA EAST
11,MOSHLEM UDDIN CHOUDHURY,Independent,1657,0,1657,0.85,Assam-BILASIPARA EAST
12,NOTA,None of the Above,1706,2,1708,0.87,Assam-BILASIPARA EAST
1,DR. ABU BAKAR SIDDIQUE,Bharatiya Janata Party,26907,147,27054,16.78,Assam-BILASIPARA WEST
2,ABDUR REZZAK SHEIKH,All India Trinamool Congress,6422,35,6457,4.01,Assam-BILASIPARA WEST
3,HAFIZ BASHIR AHMED,All India United Democratic Front,90166,363,90529,56.16,Assam-BILASIPARA WEST
4,AKBAR ALI MONDAL,The National Road Map Party of India,1624,3,1627,1.01,Assam-BILASIPARA WEST
5,DR. ANES AHMED,Assam Jatiya Parishad,1511,11,1522,0.94,Assam-BILASIPARA WEST
6,ALI AKBAR MIAH,Independent,30670,101,30771,19.09,Assam-BILASIPARA WEST
7,IFTARUL ISLAM PARAMANIK,Independent,1921,5,1926,1.19,Assam-BILASIPARA WEST
8,NOTA,None of the Above,1298,8,1306,0.81,Assam-BILASIPARA WEST
1,ANJAN BORAH,Indian National Congress,61687,304,61991,44.23,Assam-BISWANATH
2,PROMOD BORTHAKUR,Bharatiya Janata Party,70842,359,71201,50.8,Assam-BISWANATH
3,DULDUL BORKATAKI,Assam Jatiya Parishad,3004,29,3033,2.16,Assam-BISWANATH
4,DWIP BORTHAKUR,Independent,980,3,983,0.7,Assam-BISWANATH
5,MILICHARAN BASUMATARY,Independent,1169,2,1171,0.84,Assam-BISWANATH
6,NOTA,None of the Above,1766,8,1774,1.27,Assam-BISWANATH
1,DAVID RENGMA,National People's Party,1466,6,1472,1.24,Assam-BOKAJAN
2,NUMAL MOMIN,Bharatiya Janata Party,60404,322,60726,51.05,Assam-BOKAJAN
3,RATON ENGTI,Indian National Congress,42655,186,42841,36.02,Assam-BOKAJAN
4,AMLONG INGTI,Communist Party of India  (Marxist-Leninist)  (Liberation),1568,4,1572,1.32,Assam-BOKAJAN
5,RAJENDRA RONGPI,Autonomous State Demand Committee,3388,22,3410,2.87,Assam-BOKAJAN
6,SANJAY KEMPRAI,Bhartiya Tribal Party,710,0,710,0.6,Assam-BOKAJAN
7,SEMSON TERON,Independent,6602,28,6630,5.57,Assam-BOKAJAN
8,NOTA,None of the Above,1576,8,1584,1.33,Assam-BOKAJAN
1,ATUL BORA,Asom Gana Parishad,72067,863,72930,60.56,Assam-BOKAKHAT
2,MRIDUL SAIKIA,Nationalist Congress Party,961,22,983,0.82,Assam-BOKAKHAT
3,REBA KANTA GOGOI,Assam Jatiya Parishad,2295,39,2334,1.94,Assam-BOKAKHAT
4,SIMON TANTI,Independent,639,10,649,0.54,Assam-BOKAKHAT
5,JITEN GOGOI,Independent,5453,97,5550,4.61,Assam-BOKAKHAT
6,JIBON CHANDRA BORAH,Independent,3281,79,3360,2.79,Assam-BOKAKHAT
7,DINESH KARMAKAR,Independent,912,16,928,0.77,Assam-BOKAKHAT
8,DULAL BORA,Independent,1521,24,1545,1.28,Assam-BOKAKHAT
9,PRANAB DOLEY,Independent,27405,344,27749,23.04,Assam-BOKAKHAT
10,BIJOY KUTUM,Independent,969,15,984,0.82,Assam-BOKAKHAT
11,HEMANTA DOLOI,Independent,927,6,933,0.77,Assam-BOKAKHAT
12,NOTA,None of the Above,2465,17,2482,2.06,Assam-BOKAKHAT
1,GOPI NATH DAS,All India Trinamool Congress,12542,29,12571,6.13,Assam-BOKO
2,JYOTI PRASAD DAS,Asom Gana Parishad,67985,162,68147,33.23,Assam-BOKO
3,NANDITA DAS,Indian National Congress,120504,109,120613,58.82,Assam-BOKO
4,NOTA,None of the Above,3723,12,3735,1.82,Assam-BOKO
1,PRABHAT BAISNAB,National People's Party,1595,51,1646,1.07,Assam-BONGAIGAON
2,PHANI BHUSAN CHOUDHURY,Asom Gana Parishad,82036,764,82800,53.9,Assam-BONGAIGAON
3,SHANKAR PRASAD RAY,Indian National Congress,44386,247,44633,29.05,Assam-BONGAIGAON
4,DIPU CHOUDHURY,Assam Jatiya Parishad,13872,116,13988,9.1,Assam-BONGAIGAON
5,SANTANU MUKHERJEE,Political Justice Party,2254,12,2266,1.47,Assam-BONGAIGAON
6,SABENDRA BASUMATARY,Voters Party  International,927,25,952,0.62,Assam-BONGAIGAON
7,SRI SUJIT KUMAR ROY,Bharatiya Gana Parishad,2163,21,2184,1.42,Assam-BONGAIGAON
8,KAILASH DAS,Independent,1807,3,1810,1.18,Assam-BONGAIGAON
9,GAUTAM DUTTA,Independent,1167,5,1172,0.76,Assam-BONGAIGAON
10,NOTA,None of the Above,2149,30,2179,1.42,Assam-BONGAIGAON
1,AJOY PHUKAN,Indian National Congress,34673,151,34824,26.92,Assam-CHABUA
2,PONAKAN BARUAH,Asom Gana Parishad,53205,349,53554,41.4,Assam-CHABUA
3,ANANTA HAZARIKA,Lok Jan Shakti Party,2437,26,2463,1.9,Assam-CHABUA
4,PRAKASH TANTI,Rashtriya Lok Samta Party,2732,29,2761,2.13,Assam-CHABUA
5,PRIYANKA NEOG,Independent,16641,59,16700,12.91,Assam-CHABUA
6,BHABEN BARUAH,Independent,11736,57,11793,9.12,Assam-CHABUA
7,LAWRANCE NAG,Independent,3915,11,3926,3.04,Assam-CHABUA
8,NOTA,None of the Above,3325,7,3332,2.58,Assam-CHABUA
1,HITESH BASUMATARY,Bodoland Peoples Front,34786,279,35065,27.56,Assam-CHAPAGURI
2,URKHAO GWRA BRAHMA,"United Peopleâ€™s Party, Liberal",61302,502,61804,48.58,Assam-CHAPAGURI
3,RAJKUMAR BARO,Voters Party  International,1415,26,1441,1.13,Assam-CHAPAGURI
4,KHAMPHA KHUNGUR GOYARY,Independent,907,14,921,0.72,Assam-CHAPAGURI
5,JYOTISH KUMAR DAS,Independent,5061,58,5119,4.02,Assam-CHAPAGURI
6,SUJAN DAS,Independent,20817,172,20989,16.5,Assam-CHAPAGURI
7,NOTA,None of the Above,1863,21,1884,1.48,Assam-CHAPAGURI
1,DR. KAMALA KANTA KALITA,Asom Gana Parishad,65756,64,65820,39.5,Assam-CHAYGAON
2,REKIBUDDIN AHMED,Indian National Congress,93826,38,93864,56.32,Assam-CHAYGAON
3,DEBAJIT ADHIKARI,Assam Jatiya Parishad,2476,5,2481,1.49,Assam-CHAYGAON
4,NURUL ISLAM,Rashtriya Lok Samta Party,360,0,360,0.22,Assam-CHAYGAON
5,SHYAMAL DUTTA,Bharatiya Gana Parishad,689,1,690,0.41,Assam-CHAYGAON
6,AZMAL HOQUE,Independent,577,1,578,0.35,Assam-CHAYGAON
7,NOIMUDDIN AHMED,Independent,535,0,535,0.32,Assam-CHAYGAON
8,DR. FARUK AHMED BHUYAN,Independent,834,0,834,0.5,Assam-CHAYGAON
9,NOTA,None of the Above,1484,3,1487,0.89,Assam-CHAYGAON
1,ABDUL GONI,All India Trinamool Congress,1612,5,1617,1.26,Assam-CHENGA
2,ASHRAFUL HUSSAIN,All India United Democratic Front,75108,204,75312,58.83,Assam-CHENGA
3,RABIUL HUSSAIN,Asom Gana Parishad,23263,110,23373,18.26,Assam-CHENGA
4,SUKUR ALI AHMED,Indian National Congress,22498,75,22573,17.63,Assam-CHENGA
5,GIAS UDDIN AHMED,Assam Jatiya Parishad,728,5,733,0.57,Assam-CHENGA
6,JASHIM KHAN,Voters Party  International,469,0,469,0.37,Assam-CHENGA
7,SEKH NURUL ALAM,Republican Party of India (Athawale),352,0,352,0.27,Assam-CHENGA
8,RUPDHAN AHMED,Bahujan Maha Party,1288,2,1290,1.01,Assam-CHENGA
9,ABUL HASHEM,Independent,427,2,429,0.34,Assam-CHENGA
10,ABDUR RAHIM ALI,Independent,375,0,375,0.29,Assam-CHENGA
11,NURUL AMIN,Independent,787,1,788,0.62,Assam-CHENGA
12,NOTA,None of the Above,695,1,696,0.54,Assam-CHENGA
1,ILIAS ALI,Indian National Congress,62549,410,62959,29.37,Assam-DALGAON
2,MAZIBUR RAHMAN,All India United Democratic Front,117914,428,118342,55.2,Assam-DALGAON
3,HABIBAR RAHMAN,Asom Gana Parishad,28223,121,28344,13.22,Assam-DALGAON
4,SAIFUL HOQUE,Voters Party  International,1795,16,1811,0.84,Assam-DALGAON
5,ARAB ALI,Independent,1219,8,1227,0.57,Assam-DALGAON
6,NOTA,None of the Above,1676,13,1689,0.79,Assam-DALGAON
1,BANI HAZARIKA,Indian National Congress,51171,375,51546,38.73,Assam-DERGAON
2,BHABENDRA NATH BHARALI,Asom Gana Parishad,63612,431,64043,48.12,Assam-DERGAON
3,ANANDA CHANDRA DAS,Assam Jatiya Parishad,7477,108,7585,5.7,Assam-DERGAON
4,PROBIN DAS,Independent,7452,35,7487,5.63,Assam-DERGAON
5,NOTA,None of the Above,2421,20,2441,1.83,Assam-DERGAON
1,NABA KUMAR DOLEY,Bharatiya Janata Party,85371,1011,86382,50.83,Assam-DHAKUAKHANA
2,PADMALOCHAN DOLEY,Indian National Congress,75923,863,76786,45.18,Assam-DHAKUAKHANA
3,JUTIKA DOLEY,SOCIALIST UNITY CENTRE OF INDIA (COMMUNIST),893,12,905,0.53,Assam-DHAKUAKHANA
4,LALIT PEGU,Voters Party  International,1613,16,1629,0.96,Assam-DHAKUAKHANA
5,SATYAJIT REGAN,Assam Jatiya Parishad,2949,39,2988,1.76,Assam-DHAKUAKHANA
6,NOTA,None of the Above,1245,9,1254,0.74,Assam-DHAKUAKHANA
1,CHANDRA MOHAN PATOWARY,Bharatiya Janata Party,68016,346,68362,56.73,Assam-DHARMAPUR
2,RATUL PATOWARY,Indian National Congress,43186,142,43328,35.96,Assam-DHARMAPUR
3,PRAMOD CHANDRA BHAGABATI,SOCIALIST UNITY CENTRE OF INDIA (COMMUNIST),571,0,571,0.47,Assam-DHARMAPUR
4,Dr. SHIKHAR KUMAR SARMA,Assam Jatiya Parishad,6502,25,6527,5.42,Assam-DHARMAPUR
5,JYOTIRMAY SHARMA,Independent,618,1,619,0.51,Assam-DHARMAPUR
6,NOTA,None of the Above,1083,5,1088,0.9,Assam-DHARMAPUR
1,ASHOK SINGHAL,Bharatiya Janata Party,93329,439,93768,56.89,Assam-DHEKIAJULI
2,BENUDHAR NATH,Indian National Congress,58492,206,58698,35.62,Assam-DHEKIAJULI
3,RANJAY BASUMATARY,Voters Party  International,2058,14,2072,1.26,Assam-DHEKIAJULI
4,SATRUGHANA SASONI,Assam Jatiya Parishad,1547,13,1560,0.95,Assam-DHEKIAJULI
5,SANJOY DEY,Bharatiya Gana Parishad,1239,6,1245,0.76,Assam-DHEKIAJULI
6,TARUN SAHU,Independent,3480,14,3494,2.12,Assam-DHEKIAJULI
7,JAGYA RAM MIRDHA,Independent,1411,3,1414,0.86,Assam-DHEKIAJULI
8,NOTA,None of the Above,2554,5,2559,1.55,Assam-DHEKIAJULI
1,Ranoj Pegu,Bharatiya Janata Party,86744,937,87681,45.33,Assam-DHEMAJI
2,Sailen Sonowal,Indian National Congress,44228,604,44832,23.18,Assam-DHEMAJI
3,Chittaranjan Basumatary,Assam Jatiya Parishad,56528,361,56889,29.41,Assam-DHEMAJI
4,Hem Kanta Miri,SOCIALIST UNITY CENTRE OF INDIA (COMMUNIST),1149,9,1158,0.6,Assam-DHEMAJI
5,Ayub Khang Brahma,Independent,1190,19,1209,0.63,Assam-DHEMAJI
6,NOTA,None of the Above,1629,14,1643,0.85,Assam-DHEMAJI
1,Aminul Islam,All India United Democratic Front,145682,206,145888,70.39,Assam-DHING
2,Sanjib Kumar Bora,Bharatiya Janata Party,8982,66,9048,4.37,Assam-DHING
3,Md. Anjar Hussain,Assam Jatiya Parishad,1127,12,1139,0.55,Assam-DHING
4,Inamul Huda,Revolutionary Communist Party of India  (Rasik Bhatt),3447,6,3453,1.67,Assam-DHING
5,Saiful Islam Choudhury,Asom Jana Morcha,877,4,881,0.43,Assam-DHING
6,Shahnaz Begum,Janata Dal  (United),762,5,767,0.37,Assam-DHING
7,Mehboob Muktar,Independent,42862,59,42921,20.71,Assam-DHING
8,Mustafa Shahidul Islam,Independent,1325,2,1327,0.64,Assam-DHING
9,NOTA,None of the Above,1818,2,1820,0.88,Assam-DHING
1,KAMAKHYA PRASAD MALA,Indian National Congress,61868,308,62176,41.44,Assam-DHOLAI
2,PARIMAL SUKLA BAIDYA,Bharatiya Janata Party,81896,672,82568,55.03,Assam-DHOLAI
3,GOUR CHANDRA DAS,SOCIALIST UNITY CENTRE OF INDIA (COMMUNIST),1823,11,1834,1.22,Assam-DHOLAI
4,RAM RATAN DUSAD,Assam Jatiya Parishad,376,5,381,0.25,Assam-DHOLAI
5,ANANTA MOHAN ROY,Independent,355,1,356,0.24,Assam-DHOLAI
6,DIPAK RANJAN ROY,Independent,417,8,425,0.28,Assam-DHOLAI
7,PARIMAL DAS,Independent,746,4,750,0.5,Assam-DHOLAI
8,NOTA,None of the Above,1558,3,1561,1.04,Assam-DHOLAI
1,DR. DEBAMOY SANYAL,Bharatiya Janata Party,45864,236,46100,26.13,Assam-DHUBRI
2,NAZRUL HOQUE,All India United Democratic Front,123669,244,123913,70.24,Assam-DHUBRI
3,AZAD ALI SHEIKH,Assam Jatiya Parishad,1698,6,1704,0.97,Assam-DHUBRI
4,TAHABIL ALOM SARKAR,Janata Dal  (United),266,1,267,0.15,Assam-DHUBRI
5,DEWAN HABIBUR RAHMAN,SOCIALIST UNITY CENTRE OF INDIA (COMMUNIST),323,0,323,0.18,Assam-DHUBRI
6,MOBARAK HUSSAIN,Independent,502,5,507,0.29,Assam-DHUBRI
7,RASUL HOQUE,Independent,2123,3,2126,1.21,Assam-DHUBRI
8,NOTA,None of the Above,1479,4,1483,0.84,Assam-DHUBRI
1,PRASANTA PHUKAN,Bharatiya Janata Party,68029,733,68762,60.43,Assam-DIBRUGARH
2,RAJKUMAR NILANETRA NEOG,Indian National Congress,30512,245,30757,27.03,Assam-DIBRUGARH
3,AJIT BORGOHAIN,Assam Jatiya Parishad,10971,91,11062,9.72,Assam-DIBRUGARH
4,SYED MAHSHINUR RAHMAN,Asom Songrami Mancha(Asom),596,5,601,0.53,Assam-DIBRUGARH
5,KAMAL HAZARIKA,Independent,750,5,755,0.66,Assam-DIBRUGARH
6,NOTA,None of the Above,1834,11,1845,1.62,Assam-DIBRUGARH
1,SHIBANATH CHETIA,Indian National Congress,32063,178,32241,30.08,Assam-DIGBOI
2,SUREN  PHUKAN,Bharatiya Janata Party,58692,525,59217,55.24,Assam-DIGBOI
3,PAHLAD NAYAK,Assam Jatiya Parishad,12957,44,13001,12.13,Assam-DIGBOI
4,NOTA,None of the Above,2724,9,2733,2.55,Assam-DIGBOI
1,Sum Ronghang,Indian National Congress,36209,295,36504,23.97,Assam-DIPHU
2,Bidya Sing Engleng,Bharatiya Janata Party,76301,731,77032,50.58,Assam-DIPHU
3,Rajen Timung,National People's Party,1350,22,1372,0.9,Assam-DIPHU
4,Ranjit Kramsa,Communist Party of India  (Marxist-Leninist)  (Liberation),1448,19,1467,0.96,Assam-DIPHU
5,Hemsing Tisso,Autonomous State Demand Committee,7314,65,7379,4.85,Assam-DIPHU
6,Jones Ingti Kathar,Independent,23198,158,23356,15.34,Assam-DIPHU
7,Dilip Sing Bey,Independent,915,12,927,0.61,Assam-DIPHU
8,Bhogeswar Shyam,Independent,840,6,846,0.56,Assam-DIPHU
9,Rohili Tokbipi,Independent,1088,3,1091,0.72,Assam-DIPHU
10,NOTA,None of the Above,2305,15,2320,1.52,Assam-DIPHU
1,ATUL BORA,Bharatiya Janata Party,195218,825,196043,64,Assam-DISPUR
2,MANJIT MAHANTA,Indian National Congress,74127,259,74386,24.28,Assam-DISPUR
3,HRIDAYANANDA GOGOI,Nationalist Congress Party,1174,10,1184,0.39,Assam-DISPUR
4,PALLABI RABHA,Janata Dal  (United),833,14,847,0.28,Assam-DISPUR
5,PRINCE FAIZUL HAQUE,Assam Jatiya Parishad,15582,54,15636,5.1,Assam-DISPUR
6,SUKANTA MAZUMDAR,Bharatiya Gana Parishad,536,4,540,0.18,Assam-DISPUR
7,SONAMONI DAS,Lok Jan Shakti Party,735,0,735,0.24,Assam-DISPUR
8,CHARAN CHANDRA DEKA,Independent,2131,24,2155,0.7,Assam-DISPUR
9,NITUL DAS,Independent,592,11,603,0.2,Assam-DISPUR
10,PALLABI DOLEY,Independent,775,13,788,0.26,Assam-DISPUR
11,BISWAJIT NATH,Independent,1236,3,1239,0.4,Assam-DISPUR
12,SHAILEN KALITA,Independent,5143,5,5148,1.68,Assam-DISPUR
13,HEMENDRA NATH DEKA,Independent,1226,6,1232,0.4,Assam-DISPUR
14,NOTA,None of the Above,5756,26,5782,1.89,Assam-DISPUR
1,DURGA BHUMIJ,Indian National Congress,40791,190,40981,34.8,Assam-DOOM DOOMA
2,RUPESH GOWALA,Bharatiya Janata Party,48872,247,49119,41.71,Assam-DOOM DOOMA
3,RAJESH KISHAN,Political Justice Party,1693,10,1703,1.45,Assam-DOOM DOOMA
4,SURESH BHUMIJ,Assam Jatiya Parishad,4321,27,4348,3.69,Assam-DOOM DOOMA
5,KANAK CHETIA,Independent,2174,7,2181,1.85,Assam-DOOM DOOMA
6,DEBAJIT MORAN,Independent,921,8,929,0.79,Assam-DOOM DOOMA
7,LAKHESWAR MORAN,Independent,15224,88,15312,13,Assam-DOOM DOOMA
8,NOTA,None of the Above,3180,6,3186,2.71,Assam-DOOM DOOMA
1,MANOJ KUMAR BASUMATARY (MUNITION),National People's Party,1180,10,1190,0.66,Assam-DUDHNAI
2,JADAB SWARGIARY,Indian National Congress,78347,204,78551,43.46,Assam-DUDHNAI
3,SHYAMJIT RABHA,Bharatiya Janata Party,76995,280,77275,42.75,Assam-DUDHNAI
4,DIGANTA  KUMAR  RABHA,Janata Dal  (United),1257,13,1270,0.7,Assam-DUDHNAI
5,BORJIT BORO,Voters Party  International,2451,11,2462,1.36,Assam-DUDHNAI
6,ANIL RABHA,Independent,675,3,678,0.38,Assam-DUDHNAI
7,DIPAK KUMAR RABHA,Independent,16443,44,16487,9.12,Assam-DUDHNAI
8,BATSRANG G. MOMIN,Independent,1470,5,1475,0.82,Assam-DUDHNAI
9,NOTA,None of the Above,1362,5,1367,0.76,Assam-DUDHNAI
1,TERASH GOWALA,Bharatiya Janata Party,54376,386,54762,42.35,Assam-DULIAJAN
2,DHRUBAJYOTI GOGOI,Indian National Congress,46392,260,46652,36.08,Assam-DULIAJAN
3,MADHAB DAS,Lok Jan Shakti Party,1505,13,1518,1.17,Assam-DULIAJAN
4,LURINJYOTI GOGOI,Assam Jatiya Parishad,24027,165,24192,18.71,Assam-DULIAJAN
5,NOTA,None of the Above,2191,2,2193,1.7,Assam-DULIAJAN
1,ASHIMA BARDOLOI,Indian National Congress,29246,115,29361,17.16,Assam-GAUHATI EAST
2,RAJ PRASAD SAIKIA,National People's Party,643,0,643,0.38,Assam-GAUHATI EAST
3,SIDDHARTHA BHATTACHARYA,Bharatiya Janata Party,113033,428,113461,66.33,Assam-GAUHATI EAST
4,ADIP KUMAR PHUKAN,Assam Jatiya Parishad,20949,100,21049,12.31,Assam-GAUHATI EAST
5,PRANAB JYOTI DAS,Republican Party of India (Athawale),251,1,252,0.15,Assam-GAUHATI EAST
6,BAPI AICH,Bharatiya Gana Parishad,228,0,228,0.13,Assam-GAUHATI EAST
7,BHUPEN SARMA,All India Forward Bloc,266,5,271,0.16,Assam-GAUHATI EAST
8,MITALI DEKA DEVI,Lok Jan Shakti Party,371,2,373,0.22,Assam-GAUHATI EAST
9,DIWAS PHUKAN,Independent,1149,6,1155,0.68,Assam-GAUHATI EAST
10,PRANAY DAS,Independent,846,4,850,0.5,Assam-GAUHATI EAST
11,NOTA,None of the Above,3403,14,3417,2,Assam-GAUHATI EAST
1,MIRA BORTHAKUR GOSWAMI,Indian National Congress,58990,94,59084,25.72,Assam-GAUHATI WEST
2,RAMENDRA NARAYAN KALITA,Asom Gana Parishad,137286,247,137533,59.87,Assam-GAUHATI WEST
3,AVIJIT CHAKRABORTY,Bharatiya Gana Parishad,2308,14,2322,1.01,Assam-GAUHATI WEST
4,KALYAN KUMAR SHARMA,Republican Party of India (Athawale),1175,3,1178,0.51,Assam-GAUHATI WEST
5,KISHOR KUMAR DAS,Lok Jan Shakti Party,836,5,841,0.37,Assam-GAUHATI WEST
6,DEBAKESH MALLA BUZAR BARUAH,Janata Dal  (United),793,1,794,0.35,Assam-GAUHATI WEST
7,PANKAJ DAS,Swarna Bharat Party,579,3,582,0.25,Assam-GAUHATI WEST
8,RUNA LAILA,Assam Jatiya Parishad,5767,3,5770,2.51,Assam-GAUHATI WEST
9,AMITABH SARMA,Independent,867,3,870,0.38,Assam-GAUHATI WEST
10,KAZI NEKIB AHMED,Independent,1402,5,1407,0.61,Assam-GAUHATI WEST
11,DHANANJAY KALITA,Independent,5794,6,5800,2.52,Assam-GAUHATI WEST
12,NESARUDDIN AHMED,Independent,701,0,701,0.31,Assam-GAUHATI WEST
13,BALESWAR RANGPI,Independent,5869,5,5874,2.56,Assam-GAUHATI WEST
14,RAKTIMAVA SWAMI,Independent,1314,1,1315,0.57,Assam-GAUHATI WEST
15,SWAPNALI DAS,Independent,1711,7,1718,0.75,Assam-GAUHATI WEST
16,NOTA,None of the Above,3917,8,3925,1.71,Assam-GAUHATI WEST
1,NIZANUR RAHMAN,All India United Democratic Front,111963,231,112194,61.07,Assam-GAURIPUR
2,BANENDRA KUMAR MUSHAHARY,Bharatiya Janata Party,63081,268,63349,34.48,Assam-GAURIPUR
3,JABBAR ALI,Janata Dal  (United),578,2,580,0.32,Assam-GAURIPUR
4,MIR HUSSAIN SARKAR,Republican Party of India (A),786,4,790,0.43,Assam-GAURIPUR
5,AKUL BARMAN,Independent,402,4,406,0.22,Assam-GAURIPUR
6,ABDUR REZZAK HOSSAIN,Independent,1754,4,1758,0.96,Assam-GAURIPUR
7,KHAGENDRA NATH RAY,Independent,866,6,872,0.47,Assam-GAURIPUR
8,NIRANJAN PRODHANI,Independent,615,0,615,0.33,Assam-GAURIPUR
9,MD. MOHIBUL HAQUE,Independent,1401,4,1405,0.76,Assam-GAURIPUR
10,NOTA,None of the Above,1748,10,1758,0.96,Assam-GAURIPUR
1,ABUL KALAM RASHEED ALAM,Indian National Congress,112744,251,112995,57.81,Assam-GOALPARA EAST
2,KOFIL UDDIN AHMED,Nationalist Congress Party,1055,4,1059,0.54,Assam-GOALPARA EAST
3,JYOTISH DAS,Asom Gana Parishad,67422,325,67747,34.66,Assam-GOALPARA EAST
4,RINKU MAZUMDAR,National People's Party,1547,4,1551,0.79,Assam-GOALPARA EAST
5,SHEIKH MD. JIAUL HOQUE,All India Trinamool Congress,662,3,665,0.34,Assam-GOALPARA EAST
6,IMDAD HUSSAIN,Assam Jatiya Parishad,1235,14,1249,0.64,Assam-GOALPARA EAST
7,CHITRALEKHA DAS,SOCIALIST UNITY CENTRE OF INDIA (COMMUNIST),322,5,327,0.17,Assam-GOALPARA EAST
8,FARUK AHMED,All India Minorities Front,862,1,863,0.44,Assam-GOALPARA EAST
9,MAZIBAR RAHMAN,Republican Party of India (A),513,0,513,0.26,Assam-GOALPARA EAST
10,AMINUL HOQUE,Independent,3434,3,3437,1.76,Assam-GOALPARA EAST
11,DHARMA NARAYAN NATH,Independent,1330,11,1341,0.69,Assam-GOALPARA EAST
12,MEHBUBAR RAHMAN,Independent,665,0,665,0.34,Assam-GOALPARA EAST
13,RANJAN SARKAR,Independent,1354,2,1356,0.69,Assam-GOALPARA EAST
14,NOTA,None of the Above,1697,9,1706,0.87,Assam-GOALPARA EAST
1,ABDUR RASHID MANDAL,Indian National Congress,85553,199,85752,54.18,Assam-GOALPARA WEST
2,ABDUL BATEN SIKDAR,National People's Party,1463,5,1468,0.93,Assam-GOALPARA WEST
3,NIZAM UDDIN,All India Trinamool Congress,946,3,949,0.6,Assam-GOALPARA WEST
4,SHEIKH SHAH ALOM,Asom Gana Parishad,39599,129,39728,25.1,Assam-GOALPARA WEST
5,ABTABUL AMBIA MOLLAH,Janata Dal  (United),317,5,322,0.2,Assam-GOALPARA WEST
6,SAFIOR RAHMAN,Assam Jatiya Parishad,686,13,699,0.44,Assam-GOALPARA WEST
7,PUSPADHAR NATH,Voters Party  International,1250,7,1257,0.79,Assam-GOALPARA WEST
8,MOHIBUL ISLAM,SOCIALIST UNITY CENTRE OF INDIA (COMMUNIST),808,6,814,0.51,Assam-GOALPARA WEST
9,CHAN ALI MIAH,Independent,17745,41,17786,11.24,Assam-GOALPARA WEST
10,JAHANGIR ALOM MONDAL,Independent,567,1,568,0.36,Assam-GOALPARA WEST
11,JEHIRUL ISLAM,Independent,626,2,628,0.4,Assam-GOALPARA WEST
12,DELOWAR HUSSAIN,Independent,532,1,533,0.34,Assam-GOALPARA WEST
13,NABAJYOTI RABHA,Independent,5244,32,5276,3.33,Assam-GOALPARA WEST
14,PABITRA KUMAR NATH,Independent,1196,3,1199,0.76,Assam-GOALPARA WEST
15,NOTA,None of the Above,1298,10,1308,0.83,Assam-GOALPARA WEST
1,RIPUN BORA,Indian National Congress,63744,186,63930,39.18,Assam-GOHPUR
2,SRI UTPAL BORAH,Bharatiya Janata Party,92894,330,93224,57.14,Assam-GOHPUR
3,DR GOPAL PHUKAN,Assam Jatiya Parishad,2887,17,2904,1.78,Assam-GOHPUR
4,SRI SABIR NARZARY,Voters Party  International,1340,12,1352,0.83,Assam-GOHPUR
5,NOTA,None of the Above,1745,8,1753,1.07,Assam-GOHPUR
1,Ajanta Neog,Bharatiya Janata Party,81054,597,81651,50.63,Assam-GOLAGHAT
2,Bitupan Saikia,Indian National Congress,71841,485,72326,44.84,Assam-GOLAGHAT
3,Rina Saikia,Assam Jatiya Parishad,5013,49,5062,3.14,Assam-GOLAGHAT
4,NOTA,None of the Above,2233,12,2245,1.39,Assam-GOLAGHAT
1,ASHWINI RAY SARKAR,Bharatiya Janata Party,78671,500,79171,43.14,Assam-GOLAKGANJ
2,ABDUS SOBAHAN ALI SARKAR,Indian National Congress,89611,259,89870,48.96,Assam-GOLAKGANJ
3,SAHIDUR RAHMAN,All India Trinamool Congress,1111,3,1114,0.61,Assam-GOLAKGANJ
4,ATIKUR RAHMAN,Assam Jatiya Parishad,408,2,410,0.22,Assam-GOLAKGANJ
5,MOMINUR ALOM,Rashtriya Ulama Council,342,1,343,0.19,Assam-GOLAKGANJ
6,ABU TAHER BEPARI,Independent,10391,40,10431,5.68,Assam-GOLAKGANJ
7,NILIMOY PRODHANI,Independent,1026,4,1030,0.56,Assam-GOLAKGANJ
8,NOTA,None of the Above,1171,1,1172,0.64,Assam-GOLAKGANJ
1,Majendra Narzary,Bodoland Peoples Front,69780,627,70407,45.19,Assam-GOSSAIGAON
2,Saidur Islam,The National Road Map Party of India,1280,4,1284,0.82,Assam-GOSSAIGAON
3,Ratan Hasda,Janata Dal  (United),1030,26,1056,0.68,Assam-GOSSAIGAON
4,Somnath Narzary,"United Peopleâ€™s Party, Liberal",59499,565,60064,38.55,Assam-GOSSAIGAON
5,Abdul Samad Choudhury,Independent,3810,21,3831,2.46,Assam-GOSSAIGAON
6,Uttam Kumar Talukdar,Independent,1101,15,1116,0.72,Assam-GOSSAIGAON
7,Osman Goni SK,Independent,794,3,797,0.51,Assam-GOSSAIGAON
8,Khairul Anam Khandakar,Independent,9150,24,9174,5.89,Assam-GOSSAIGAON
9,Riajul Hoque,Independent,1407,5,1412,0.91,Assam-GOSSAIGAON
10,Ruhit Basumatary,Independent,866,6,872,0.56,Assam-GOSSAIGAON
11,Surjyanath Tudu,Independent,3966,16,3982,2.56,Assam-GOSSAIGAON
12,NOTA,None of the Above,1792,9,1801,1.16,Assam-GOSSAIGAON
1,NANDITA GORLOSA,Bharatiya Janata Party,67119,678,67797,56.73,Assam-HAFLONG
2,NIRMAL LANGTHASA,Indian National Congress,48659,540,49199,41.16,Assam-HAFLONG
3,KHANDAN DAULAGUPU,Bhartiya Tribal Party,819,7,826,0.69,Assam-HAFLONG
4,LONGKI ENGHI,Janata Dal  (United),718,5,723,0.6,Assam-HAFLONG
5,NOTA,None of the Above,963,10,973,0.81,Assam-HAFLONG
1,ZAKIR HUSSAIN LASKAR,All India United Democratic Front,70541,516,71057,55.15,Assam-HAILAKANDI
2,MILON DAS,Bharatiya Janata Party,46720,583,47303,36.72,Assam-HAILAKANDI
3,SAFIQUE KAMAL BARLASKAR,All India Trinamool Congress,384,5,389,0.3,Assam-HAILAKANDI
4,MONUJ MOHAN DEB,Bharatiya Gana Parishad,217,9,226,0.18,Assam-HAILAKANDI
5,SUSHIL PAUL,SOCIALIST UNITY CENTRE OF INDIA (COMMUNIST),126,5,131,0.1,Assam-HAILAKANDI
6,ABUL HUSSAIN BARBHUIYA,Independent,84,0,84,0.07,Assam-HAILAKANDI
7,WAHIDUL ISLAM CHOUDHURY,Independent,84,0,84,0.07,Assam-HAILAKANDI
8,KSHITISH RANJAN PAUL,Independent,484,5,489,0.38,Assam-HAILAKANDI
9,GULA AHMED MAZUMDER,Independent,138,0,138,0.11,Assam-HAILAKANDI
10,BINOY KUMAR ROY,Independent,119,7,126,0.1,Assam-HAILAKANDI
11,MUJIB AHMED CHOUDHURY,Independent,617,3,620,0.48,Assam-HAILAKANDI
12,SAIDUR RAHMAN BARBHUIYA,Independent,542,1,543,0.42,Assam-HAILAKANDI
13,HILAL UDDIN LASKAR,Independent,6517,66,6583,5.11,Assam-HAILAKANDI
14,NOTA,None of the Above,1058,5,1063,0.83,Assam-HAILAKANDI
1,ANOWAR HUSSAIN(Ganesh),Indian National Congress,28456,48,28504,18.79,Assam-HAJO
2,SRI SUMAN HARIPRIYA,Bharatiya Janata Party,65923,242,66165,43.63,Assam-HAJO
3,MD INTAJOR RAHAMAN,All India Minorities Front,1335,3,1338,0.88,Assam-HAJO
4,Dulu Ahmed,Assam Jatiya Parishad,51710,87,51797,34.15,Assam-HAJO
5,MD SAFIQUL HOQUE S K,Independent,655,0,655,0.43,Assam-HAJO
6,JAIDEEP TALUKDAR,Independent,718,1,719,0.47,Assam-HAJO
7,PRABHAT KALITA,Independent,685,2,687,0.45,Assam-HAJO
8,MON KASHYAP,Independent,700,0,700,0.46,Assam-HAJO
9,NOTA,None of the Above,1099,1,1100,0.73,Assam-HAJO
1,Debabrata Saha,Indian National Congress,91789,219,92008,41.43,Assam-HOJAI
2,Ramkrishna Ghosh,Bharatiya Janata Party,125259,531,125790,56.64,Assam-HOJAI
3,Raj Kumar Gupta,Lok Raksha Party,1131,6,1137,0.51,Assam-HOJAI
4,Dulal Sutradhar,Independent,724,3,727,0.33,Assam-HOJAI
5,Najmul Hussain Laskar,Independent,708,2,710,0.32,Assam-HOJAI
6,NOTA,None of the Above,1720,4,1724,0.78,Assam-HOJAI
1,Chomang Teron,National People's Party,1108,10,1118,1.08,Assam-HOWRAGHAT
2,Darsing Ronghang,Bharatiya Janata Party,57369,558,57927,55.74,Assam-HOWRAGHAT
3,Sanjeeb Teron,Indian National Congress,26014,230,26244,25.25,Assam-HOWRAGHAT
4,Chandra Kanta Terang,Autonomous State Demand Committee,5059,39,5098,4.91,Assam-HOWRAGHAT
5,Pradip Tokbi,Janata Dal  (United),638,1,639,0.61,Assam-HOWRAGHAT
6,Rabi Kumar Phangcho,Communist Party of India  (Marxist-Leninist)  (Liberation),1819,14,1833,1.76,Assam-HOWRAGHAT
7,Rakesh Ronghang,Independent,715,3,718,0.69,Assam-HOWRAGHAT
8,Suren Kramsa,Independent,8958,32,8990,8.65,Assam-HOWRAGHAT
9,NOTA,None of the Above,1349,6,1355,1.3,Assam-HOWRAGHAT
1,PIJUSH HAZARIKA,Bharatiya Janata Party,106307,336,106643,53.54,Assam-JAGIROAD
2,SWAPAN KUMAR MANDAL,Indian National Congress,77055,184,77239,38.78,Assam-JAGIROAD
3,BUBUL DAS,Assam Jatiya Parishad,12768,47,12815,6.43,Assam-JAGIROAD
4,SUKANTA MAZUMDAR,Bharatiya Gana Parishad,900,3,903,0.45,Assam-JAGIROAD
5,NOTA,None of the Above,1593,2,1595,0.8,Assam-JAGIROAD
1,Aftab Uddin Mollah,Indian National Congress,75826,200,76026,50.75,Assam-JALESWAR
2,Osman Goni,Bharatiya Janata Party,14015,38,14053,9.38,Assam-JALESWAR
3,Khurshid Mirza Ashikur Rahman,All India Trinamool Congress,1842,5,1847,1.23,Assam-JALESWAR
4,DR. Reza M A Amin,All India United Democratic Front,53950,96,54046,36.08,Assam-JALESWAR
5,Osman Goni Mollah,SOCIALIST UNITY CENTRE OF INDIA (COMMUNIST),564,2,566,0.38,Assam-JALESWAR
6,Roshidul Hoque,Assam Jatiya Parishad,913,2,915,0.61,Assam-JALESWAR
7,Akheruzzaman Mollah,Independent,754,0,754,0.5,Assam-JALESWAR
8,Mujaharul Islam,Independent,626,0,626,0.42,Assam-JALESWAR
9,NOTA,None of the Above,968,2,970,0.65,Assam-JALESWAR
1,ROMEN CHANDRA BORTHAKUR,Indian National Congress,28788,63,28851,17.07,Assam-JALUKBARI
2,HIMANTA BISWA SARMA,Bharatiya Janata Party,130232,530,130762,77.39,Assam-JALUKBARI
3,NABA KUMAR NATH,Independent,1211,7,1218,0.72,Assam-JALUKBARI
4,MOINUL HOQUE,Independent,1137,4,1141,0.68,Assam-JALUKBARI
5,HEMANTA KUMAR SUT,Independent,4834,4,4838,2.86,Assam-JALUKBARI
6,NOTA,None of the Above,2150,7,2157,1.28,Assam-JALUKBARI
1,Sadik Ullah Bhuyan,Asom Gana Parishad,18259,83,18342,9.8,Assam-JAMUNAMUKH
2,Siraj Uddin Ajmal,All India United Democratic Front,136148,754,136902,73.14,Assam-JAMUNAMUKH
3,Rezwan Ahmed,All India Trinamool Congress,1386,24,1410,0.75,Assam-JAMUNAMUKH
4,Jahirul Islam Laskar,Janata Dal  (United),234,4,238,0.13,Assam-JAMUNAMUKH
5,Bodrul Hoque,Assam Jatiya Parishad,3275,17,3292,1.76,Assam-JAMUNAMUKH
6,Abdul Kadir,Independent,213,4,217,0.12,Assam-JAMUNAMUKH
7,Abdul Malik Borbhuyan,Independent,287,2,289,0.15,Assam-JAMUNAMUKH
8,Gauri Kuwar,Independent,369,4,373,0.2,Assam-JAMUNAMUKH
9,Siraj Uddin,Independent,381,2,383,0.2,Assam-JAMUNAMUKH
10,Diluwara Begum Chowdhury,Independent,17911,117,18028,9.63,Assam-JAMUNAMUKH
11,Nashir Uddin Laskar,Independent,595,1,596,0.32,Assam-JAMUNAMUKH
12,Noor Ahmed,Independent,508,2,510,0.27,Assam-JAMUNAMUKH
13,Badar Uddin,Independent,3361,9,3370,1.8,Assam-JAMUNAMUKH
14,Hari Mohan Das,Independent,1652,5,1657,0.89,Assam-JAMUNAMUKH
15,NOTA,None of the Above,1567,8,1575,0.84,Assam-JAMUNAMUKH
1,Abdul Jalil Talukdar,All India Trinamool Congress,1204,8,1212,0.66,Assam-JANIA
2,Rafiqul Islam,All India United Democratic Front,155917,266,156183,84.6,Assam-JANIA
3,Shahidul Islam,Bharatiya Janata Party,11353,55,11408,6.18,Assam-JANIA
4,Zinnat Ali,The National Road Map Party of India,486,2,488,0.26,Assam-JANIA
5,Mazidul Islam,National Republican Congress,304,4,308,0.17,Assam-JANIA
6,Shukur Ali,Assam Jatiya Parishad,778,6,784,0.42,Assam-JANIA
7,Sheikh Jamsedur Rahman,Janata Dal  (United),165,0,165,0.09,Assam-JANIA
8,Arshad Ahmed,Independent,683,5,688,0.37,Assam-JANIA
9,Ashraful Islam,Independent,8317,17,8334,4.51,Assam-JANIA
10,Inumani Begum,Independent,573,0,573,0.31,Assam-JANIA
11,Faruk Khan,Independent,1835,3,1838,1,Assam-JANIA
12,Raizuddin,Independent,1742,2,1744,0.94,Assam-JANIA
13,NOTA,None of the Above,884,6,890,0.48,Assam-JANIA
1,BHUBAN PEGU,Bharatiya Janata Party,167875,536,168411,68.69,Assam-JONAI
2,HEMA HARI PRASANNA PEGU,Indian National Congress,57227,197,57424,23.42,Assam-JONAI
3,PHANIRAM TAYENG,Assam Jatiya Parishad,7680,46,7726,3.15,Assam-JONAI
4,BHAGYA CHUNGKRANG,Janata Dal  (United),1001,5,1006,0.41,Assam-JONAI
5,BHABANI BORO,Independent,1491,20,1511,0.62,Assam-JONAI
6,MADHAB MACHAHARY,Independent,6382,22,6404,2.61,Assam-JONAI
7,NOTA,None of the Above,2663,13,2676,1.09,Assam-JONAI
1,RANA GOSWAMI,Indian National Congress,61181,652,61833,44.2,Assam-JORHAT
2,HITENDRA NATH GOSWAMI,Bharatiya Janata Party,67500,821,68321,48.84,Assam-JORHAT
3,NIROD CHANGKAKOTI,Assam Jatiya Parishad,6843,82,6925,4.95,Assam-JORHAT
4,RANJIT BARUAH,Independent,1087,13,1100,0.79,Assam-JORHAT
5,NOTA,None of the Above,1701,16,1717,1.23,Assam-JORHAT
1,DURGA DAS BORO,Bodoland Peoples Front,60604,211,60815,41.05,Assam-KALAIGAON
2,MADHU RAM DEKA,Bharatiya Janata Party,53382,331,53713,36.26,Assam-KALAIGAON
3,KAMAL AZAD,"United Peopleâ€™s Party, Liberal",16814,57,16871,11.39,Assam-KALAIGAON
4,JITENDRA CHALIHA,SOCIALIST UNITY CENTRE OF INDIA (COMMUNIST),425,2,427,0.29,Assam-KALAIGAON
5,BHAGABAN DEKA,Voters Party  International,1239,6,1245,0.84,Assam-KALAIGAON
6,JADAV SAIKIA,Assam Jatiya Parishad,2875,33,2908,1.96,Assam-KALAIGAON
7,RADHE SHYAM CHAUHAN,Janata Dal  (United),483,5,488,0.33,Assam-KALAIGAON
8,SUDHENDU MOHAN TALUKDAR,Bharatiya Gana Parishad,683,3,686,0.46,Assam-KALAIGAON
9,KAMAL CHOUDHURY,Independent,2078,3,2081,1.4,Assam-KALAIGAON
10,KANU RAM SAIKIA,Independent,835,2,837,0.57,Assam-KALAIGAON
11,GWMBWR MOCHAHARY,Independent,825,12,837,0.57,Assam-KALAIGAON
12,DULAL KUMAR BARUAH,Independent,2381,4,2385,1.61,Assam-KALAIGAON
13,PANKAJ ASOMIYA,Independent,2533,16,2549,1.72,Assam-KALAIGAON
14,RAKESH BARO,Independent,968,4,972,0.66,Assam-KALAIGAON
15,NOTA,None of the Above,1316,8,1324,0.89,Assam-KALAIGAON
1,Keshab Mahanta,Asom Gana Parishad,72591,1086,73677,59.06,Assam-KALIABOR
2,Prasanta Kumar Saikia,Indian National Congress,44243,714,44957,36.04,Assam-KALIABOR
3,Mukul Baruah,Assam Jatiya Parishad,2595,32,2627,2.11,Assam-KALIABOR
4,Bhaskar Sarmah,Independent,1624,52,1676,1.34,Assam-KALIABOR
5,NOTA,None of the Above,1790,19,1809,1.45,Assam-KALIABOR
1,Kishor Kumar Bhattacharyya,Indian National Congress,62582,387,62969,41.89,Assam-KAMALPUR
2,Diganta Kalita,Bharatiya Janata Party,80344,739,81083,53.93,Assam-KAMALPUR
3,Sisir Kumar Kakati,SOCIALIST UNITY CENTRE OF INDIA (COMMUNIST),1164,7,1171,0.78,Assam-KAMALPUR
4,Jitul Deka,Independent,3491,17,3508,2.33,Assam-KAMALPUR
5,NOTA,None of the Above,1597,8,1605,1.07,Assam-KAMALPUR
1,KAMALAKHYA DEY PURKAYASTHA,Indian National Congress,60375,623,60998,41.57,Assam-KARIMGANJ NORTH
2,DR MANASH DAS,Bharatiya Janata Party,51865,809,52674,35.89,Assam-KARIMGANJ NORTH
3,AHAD UDDIN,Rashtriya Ulama Council,312,2,314,0.21,Assam-KARIMGANJ NORTH
4,GOPAL CHANDRA PAUL,Samajwadi Party,92,0,92,0.06,Assam-KARIMGANJ NORTH
5,NAZRUL ISLAM CHOUDHURY,All India Forward Bloc,852,6,858,0.58,Assam-KARIMGANJ NORTH
6,SUJIT KUMAR PAUL,SOCIALIST UNITY CENTRE OF INDIA (COMMUNIST),161,4,165,0.11,Assam-KARIMGANJ NORTH
7,ABDUL JABBAR CHOUDHURY,Independent,114,1,115,0.08,Assam-KARIMGANJ NORTH
8,JAKIR HUSSAIN,Independent,474,1,475,0.32,Assam-KARIMGANJ NORTH
9,MD JUBAIR AHMED CHOUDHURY,Independent,117,4,121,0.08,Assam-KARIMGANJ NORTH
10,DEBAJYOTI DEB ROY (SUJAN),Independent,562,16,578,0.39,Assam-KARIMGANJ NORTH
11,NAZIM UDDIN KHAN,Independent,433,1,434,0.3,Assam-KARIMGANJ NORTH
12,MOHAMMAD ABDUL BATIN,Independent,102,0,102,0.07,Assam-KARIMGANJ NORTH
13,RUHUL QUDDUS,Independent,127,1,128,0.09,Assam-KARIMGANJ NORTH
14,LUTFUR RAHMAN,Independent,466,1,467,0.32,Assam-KARIMGANJ NORTH
15,SAHABUL ISLAM CHOUDHURY,Independent,27916,128,28044,19.11,Assam-KARIMGANJ NORTH
16,NOTA,None of the Above,1172,8,1180,0.8,Assam-KARIMGANJ NORTH
1,AZIZ AHMED KHAN,Asom Gana Parishad,55835,587,56422,37.54,Assam-KARIMGANJ SOUTH
2,SIDDEQUE AHMED,Indian National Congress,88074,835,88909,59.16,Assam-KARIMGANJ SOUTH
3,PRONAB KUMAR ROY,Rashtriya Lok Samta Party,695,9,704,0.47,Assam-KARIMGANJ SOUTH
4,ABU SUFIAN,Independent,131,0,131,0.09,Assam-KARIMGANJ SOUTH
5,ABDUL BASIT,Independent,101,1,102,0.07,Assam-KARIMGANJ SOUTH
6,SUFIAN AHMED,Independent,515,1,516,0.34,Assam-KARIMGANJ SOUTH
7,JAHARUL HAQUE,Independent,122,0,122,0.08,Assam-KARIMGANJ SOUTH
8,FORZAN KHAN,Independent,106,0,106,0.07,Assam-KARIMGANJ SOUTH
9,FAIZ AHMED,Independent,120,3,123,0.08,Assam-KARIMGANJ SOUTH
10,BIMAL KRISHNA DAS,Independent,234,7,241,0.16,Assam-KARIMGANJ SOUTH
11,BILAL AHMED,Independent,141,0,141,0.09,Assam-KARIMGANJ SOUTH
12,RAJESH DEY PURKAYASTHA,Independent,148,0,148,0.1,Assam-KARIMGANJ SOUTH
13,SHAMIM AHMED CHOUDHURY,Independent,165,1,166,0.11,Assam-KARIMGANJ SOUTH
14,SAYED ALI AHMED,Independent,297,0,297,0.2,Assam-KARIMGANJ SOUTH
15,HUSSAIN AHMED,Independent,1167,0,1167,0.78,Assam-KARIMGANJ SOUTH
16,NOTA,None of the Above,974,11,985,0.66,Assam-KARIMGANJ SOUTH
1,Khalil Uddin Mazumder,Indian National Congress,82610,658,83268,51.22,Assam-KATIGORA
2,Gautam Roy,Bharatiya Janata Party,75513,816,76329,46.95,Assam-KATIGORA
3,Abdul Odud Choudhury,Independent,474,2,476,0.29,Assam-KATIGORA
4,Junaid Ahmed Barbhuiya,Independent,194,1,195,0.12,Assam-KATIGORA
5,Nasir Uddin Barbhuiya,Independent,139,1,140,0.09,Assam-KATIGORA
6,Monsur Hassan Choudhury,Independent,196,1,197,0.12,Assam-KATIGORA
7,GMC SAHAB UDDIN AHMED,Independent,292,5,297,0.18,Assam-KATIGORA
8,Hilal Ahmed Talukder,Independent,562,1,563,0.35,Assam-KATIGORA
9,NOTA,None of the Above,1106,6,1112,0.68,Assam-KATIGORA
1,SANJEEV ROY,Indian National Congress,2884,47,2931,1.9,Assam-KATLICHERRA
2,SUZAM UDDIN LASKAR,All India United Democratic Front,79415,354,79769,51.83,Assam-KATLICHERRA
3,SUBRATA KUMAR NATH,Bharatiya Janata Party,66337,461,66798,43.41,Assam-KATLICHERRA
4,RAM KUMAR NUNIA,Janata Dal  (United),667,5,672,0.44,Assam-KATLICHERRA
5,ACHAB UDDIN BARBHUIYA,Independent,189,1,190,0.12,Assam-KATLICHERRA
6,AFTAB UDDIN BARBHUIYA,Independent,193,1,194,0.13,Assam-KATLICHERRA
7,ABDUL BASIT LASKAR,Independent,111,0,111,0.07,Assam-KATLICHERRA
8,AHMED HUSSAIN BARBHUIYA,Independent,181,1,182,0.12,Assam-KATLICHERRA
9,JOHUR UDDIN TALUKDAR,Independent,154,1,155,0.1,Assam-KATLICHERRA
10,BADAR UDDIN LASKAR,Independent,96,0,96,0.06,Assam-KATLICHERRA
11,MOJMUL ISLAM LASKAR,Independent,207,0,207,0.13,Assam-KATLICHERRA
12,RAJESH PAUL,Independent,264,5,269,0.17,Assam-KATLICHERRA
13,LUTHFUR RAHMAN LASKAR,Independent,906,0,906,0.59,Assam-KATLICHERRA
14,SAHAB UDDIN LASKAR,Independent,666,0,666,0.43,Assam-KATLICHERRA
15,NOTA,None of the Above,742,3,745,0.48,Assam-KATLICHERRA
1,Bismita Gogoi,Indian National Congress,38284,238,38522,33.14,Assam-KHUMTAI
2,Mrinal Saikia,Bharatiya Janata Party,65270,385,65655,56.49,Assam-KHUMTAI
3,Susenfa Gogoi,Asom Songrami Mancha(Asom),1083,7,1090,0.94,Assam-KHUMTAI
4,Paban Saikia,Assam Jatiya Parishad,7348,20,7368,6.34,Assam-KHUMTAI
5,Dipak Guwala,Independent,668,4,672,0.58,Assam-KHUMTAI
6,Priyam Konwar,Independent,1526,1,1527,1.31,Assam-KHUMTAI
7,NOTA,None of the Above,1398,1,1399,1.2,Assam-KHUMTAI
1,PRAMILA RANI BRAHMA,Bodoland Peoples Front,62922,498,63420,41.11,Assam-KOKRAJHAR EAST
2,MIJING BRAHMA,Voters Party  International,1240,36,1276,0.83,Assam-KOKRAJHAR EAST
3,LAWRENCE ISLARY,"United Peopleâ€™s Party, Liberal",82817,698,83515,54.14,Assam-KOKRAJHAR EAST
4,MANAJ KUMAR BRAHMA,Independent,3229,35,3264,2.12,Assam-KOKRAJHAR EAST
5,SHRI SAILENDRA NATH BRAHMA,Independent,888,9,897,0.58,Assam-KOKRAJHAR EAST
6,NOTA,None of the Above,1865,18,1883,1.22,Assam-KOKRAJHAR EAST
1,RABIRAM NARZARY,Bodoland Peoples Front,76826,683,77509,49.68,Assam-KOKRAJHAR WEST
2,MANARANJAN BRAHMA,"United Peopleâ€™s Party, Liberal",64593,845,65438,41.94,Assam-KOKRAJHAR WEST
3,RANENDRA KOCH,Janata Dal  (United),901,37,938,0.6,Assam-KOKRAJHAR WEST
4,RAJENDRA MUSHAHARY,The National Road Map Party of India,827,15,842,0.54,Assam-KOKRAJHAR WEST
5,KAUSHIK MOHAN BRAHMA,Independent,6636,26,6662,4.27,Assam-KOKRAJHAR WEST
6,GAUTAM BARO,Independent,1156,10,1166,0.75,Assam-KOKRAJHAR WEST
7,RANJAY KR. BRAHMA,Independent,1821,11,1832,1.17,Assam-KOKRAJHAR WEST
8,NOTA,None of the Above,1626,19,1645,1.05,Assam-KOKRAJHAR WEST
1,DR. ASIF MOHAMMAD NAZAR,Indian National Congress,60782,150,60932,37.3,Assam-LAHARIGHAT
2,KADIRUZZAMAN ZINNAH,Bharatiya Janata Party,34553,179,34732,21.26,Assam-LAHARIGHAT
3,TASLIMA NASRIN,Janata Dal  (United),420,4,424,0.26,Assam-LAHARIGHAT
4,SHOMZIDA YEASMIN,Assam Jatiya Parishad,1368,3,1371,0.84,Assam-LAHARIGHAT
5,SIDDIQUE AHMED,Independent,58739,165,58904,36.06,Assam-LAHARIGHAT
6,MAHANANDA PATGIRI,Independent,3774,9,3783,2.32,Assam-LAHARIGHAT
7,MAZAHARUL ISLAM SIDDIQUEE,Independent,846,3,849,0.52,Assam-LAHARIGHAT
8,RABINDRA NATH BISWAS,Independent,509,3,512,0.31,Assam-LAHARIGHAT
9,RAJAUL KARIM,Independent,788,1,789,0.48,Assam-LAHARIGHAT
10,NOTA,None of the Above,1068,5,1073,0.66,Assam-LAHARIGHAT
1,BINOD HAZARIKA,Bharatiya Janata Party,58773,522,59295,48.13,Assam-LAHOWAL
2,MANOJ DHANOWAR,Indian National Congress,41751,296,42047,34.13,Assam-LAHOWAL
3,PRANAB SAIKIA,Rashtriya Lok Samta Party,1214,3,1217,0.99,Assam-LAHOWAL
4,LIKHON BORUAH,Assam Jatiya Parishad,10638,88,10726,8.71,Assam-LAHOWAL
5,DIBYAJIT  DUTTA,Independent,5561,15,5576,4.53,Assam-LAHOWAL
6,PROBHU LAL VAISHNAVA,Independent,1365,6,1371,1.11,Assam-LAHOWAL
7,NOTA,None of the Above,2937,17,2954,2.4,Assam-LAHOWAL
1,UTPAL DUTTA,Asom Gana Parishad,12368,118,12486,7.99,Assam-LAKHIMPUR
2,DR. JOY PRAKASH DAS (J.P.),Indian National Congress,66965,386,67351,43.09,Assam-LAKHIMPUR
3,MANAB DEKA,Bharatiya Janata Party,70032,355,70387,45.03,Assam-LAKHIMPUR
4,DILWAR HUSSAIN,Voters Party  International,950,3,953,0.61,Assam-LAKHIMPUR
5,BIRINCHI PEGU,SOCIALIST UNITY CENTRE OF INDIA (COMMUNIST),463,4,467,0.3,Assam-LAKHIMPUR
6,RANJAN BORPATRA GOHAIN,Assam Jatiya Parishad,2430,23,2453,1.57,Assam-LAKHIMPUR
7,NIRMAL PAYENG,Independent,1082,5,1087,0.7,Assam-LAKHIMPUR
8,NOTA,None of the Above,1106,8,1114,0.71,Assam-LAKHIMPUR
1,Kaushik Rai,Bharatiya Janata Party,54896,445,55341,44.61,Assam-LAKHIPUR
2,Mukesh Pandey,Indian National Congress,42202,439,42641,34.38,Assam-LAKHIPUR
3,Alim Uddin Mazumder,Assam Jatiya Parishad,2952,39,2991,2.41,Assam-LAKHIPUR
4,Kshirode Karmakar,Independent,381,7,388,0.31,Assam-LAKHIPUR
5,Chiranjit Acharjee,Independent,641,5,646,0.52,Assam-LAKHIPUR
6,Thoiba Singha,Independent,20146,357,20503,16.53,Assam-LAKHIPUR
7,NOTA,None of the Above,1531,5,1536,1.24,Assam-LAKHIPUR
1,Tutu Acharjya,All India Trinamool Congress,927,1,928,0.53,Assam-LUMDING
2,Sibu Misra,Bharatiya Janata Party,88944,164,89108,51.04,Assam-LUMDING
3,Swapan Kar,Indian National Congress,77263,114,77377,44.32,Assam-LUMDING
4,Mausumi Sarma Bezbaruah,Assam Jatiya Parishad,3251,9,3260,1.87,Assam-LUMDING
5,Iskikar Ahmed,Independent,696,0,696,0.4,Assam-LUMDING
6,Ujjal Deb,Independent,729,3,732,0.42,Assam-LUMDING
7,Sayed Hussain Borbhuyan,Independent,993,0,993,0.57,Assam-LUMDING
8,NOTA,None of the Above,1483,2,1485,0.85,Assam-LUMDING
1,BIMAN BORUAH,Nationalist Congress Party,688,5,693,0.61,Assam-MAHMARA
2,JOGEN MOHAN,Bharatiya Janata Party,50899,383,51282,45.18,Assam-MAHMARA
3,SURUJ DEHINGIA,Indian National Congress,37908,239,38147,33.61,Assam-MAHMARA
4,BHUPEN PHUKON,All India Forward Bloc,594,1,595,0.52,Assam-MAHMARA
5,MANIK GOGOI,Assam Jatiya Parishad,11287,70,11357,10.01,Assam-MAHMARA
6,RANJIT SAHU,Independent,638,4,642,0.57,Assam-MAHMARA
7,LOHIT GOGOI,Independent,9405,36,9441,8.32,Assam-MAHMARA
8,NOTA,None of the Above,1338,2,1340,1.18,Assam-MAHMARA
1,CHARAN BORO,Bodoland Peoples Front,53903,506,54409,42.32,Assam-MAJBAT
2,JITU KISSAN,Bharatiya Janata Party,38006,346,38352,29.83,Assam-MAJBAT
3,RATENDRA DAIMARY,"United Peopleâ€™s Party, Liberal",28179,234,28413,22.1,Assam-MAJBAT
4,SUNIL SARKAR,Voters Party  International,816,11,827,0.64,Assam-MAJBAT
5,KHURSHID ALAM MAZUMDAR,Independent,326,7,333,0.26,Assam-MAJBAT
6,GOLAM MOSTAFA,Independent,565,0,565,0.44,Assam-MAJBAT
7,SAIFUL ISLAM,Independent,1957,14,1971,1.53,Assam-MAJBAT
8,JIARUL HOQUE SARKER,Independent,650,4,654,0.51,Assam-MAJBAT
9,SANTOSH KURMI,Independent,1240,7,1247,0.97,Assam-MAJBAT
10,NOTA,None of the Above,1776,9,1785,1.39,Assam-MAJBAT
1,RAJIB LOCHAN PEGU,Indian National Congress,28047,197,28244,26.7,Assam-MAJULI
2,SARBANANDA SONOWAL,Bharatiya Janata Party,70618,818,71436,67.53,Assam-MAJULI
3,BHAITY RICHONG,SOCIALIST UNITY CENTRE OF INDIA (COMMUNIST),1074,6,1080,1.02,Assam-MAJULI
4,SISHUDHAR DOLEY,Assam Jatiya Parishad,3201,45,3246,3.07,Assam-MAJULI
5,PURNA PEGU,Independent,694,7,701,0.66,Assam-MAJULI
6,NOTA,None of the Above,1070,5,1075,1.02,Assam-MAJULI
1,GURU JYOTI DAS,Bharatiya Janata Party,86294,738,87032,42.72,Assam-MANGALDOI
2,BASANTA DAS,Indian National Congress,111004,382,111386,54.68,Assam-MANGALDOI
3,GAKUL BARUAH,Assam Jatiya Parishad,2708,38,2746,1.35,Assam-MANGALDOI
4,JITENDRA SARKAR,Voters Party  International,977,3,980,0.48,Assam-MANGALDOI
5,NOTA,None of the Above,1555,12,1567,0.77,Assam-MANGALDOI
1,AMINUL ISLAM,National People's Party,1963,4,1967,0.95,Assam-MANKACHAR
2,ZABED ISLAM,Asom Gana Parishad,68484,549,69033,33.3,Assam-MANKACHAR
3,MD. AMINUL ISLAM,All India United Democratic Front,125130,743,125873,60.72,Assam-MANKACHAR
4,SAYED HASSAN IMAN,Janata Dal  (United),917,2,919,0.44,Assam-MANKACHAR
5,SHAHIDUR ALAM,SOCIALIST UNITY CENTRE OF INDIA (COMMUNIST),738,1,739,0.36,Assam-MANKACHAR
6,ZAMER ALI,Independent,4196,4,4200,2.03,Assam-MANKACHAR
7,MONOWAR HUSSAIN,Independent,2631,6,2637,1.27,Assam-MANKACHAR
8,RUKUNUR ZAMAN,Independent,1003,2,1005,0.48,Assam-MANKACHAR
9,NOTA,None of the Above,920,1,921,0.44,Assam-MANKACHAR
1,BHASKAR SHARMA,Bharatiya Janata Party,86237,403,86640,56.52,Assam-MARGHERITA
2,MANORANJAN BORGOHAIN,Indian National Congress,28021,119,28140,18.36,Assam-MARGHERITA
3,SANJAY KUMAR DEB,Assam Jatiya Parishad,22879,56,22935,14.96,Assam-MARGHERITA
4,IGNATIUS EKKA,Independent,10299,16,10315,6.73,Assam-MARGHERITA
5,BHOGESWAR SHYAM,Independent,1263,6,1269,0.83,Assam-MARGHERITA
6,RANTU SONOWAL,Independent,1439,5,1444,0.94,Assam-MARGHERITA
7,NOTA,None of the Above,2528,8,2536,1.65,Assam-MARGHERITA
1,Ramani Tanti,Bharatiya Janata Party,44703,159,44862,46.81,Assam-MARIANI
2,Rupjyoti Kurmi,Indian National Congress,47093,215,47308,49.36,Assam-MARIANI
3,Gopal Chandra Ghatuwar,Asom Songrami Mancha(Asom),1602,10,1612,1.68,Assam-MARIANI
4,NOTA,None of the Above,2048,8,2056,2.15,Assam-MARIANI
1,MUNIN MAHANTA,Communist Party of India,27219,71,27290,17.43,Assam-MARIGAON
2,RAMA KANTA DEWRI,Bharatiya Janata Party,81346,311,81657,52.15,Assam-MARIGAON
3,BANI KANTA DAS,Assam Jatiya Parishad,45011,114,45125,28.82,Assam-MARIGAON
4,RATUL BORA,Independent,933,6,939,0.6,Assam-MARIGAON
5,NOTA,None of the Above,1566,5,1571,1,Assam-MARIGAON
1,CHAKRADHAR GOGOI,Bharatiya Janata Party,54970,634,55604,49.68,Assam-MORAN
2,PRANJAL GHATOWAR,Indian National Congress,33051,212,33263,29.72,Assam-MORAN
3,SANJIB CHANGMAI,Assam Jatiya Parishad,9359,140,9499,8.49,Assam-MORAN
4,ELIASH SICHAN,Independent,507,11,518,0.46,Assam-MORAN
5,MOHINI MOHAN LIGIRA,Independent,8763,71,8834,7.89,Assam-MORAN
6,RAPHAEL KUJUR,Independent,2276,17,2293,2.05,Assam-MORAN
7,NOTA,None of the Above,1895,15,1910,1.71,Assam-MORAN
1,TARANGA GOGOI,Bharatiya Janata Party,46999,269,47268,42.57,Assam-NAHARKATIA
2,NAREN SONOWAL (BOTALI),Asom Gana Parishad,4058,36,4094,3.69,Assam-NAHARKATIA
3,PRANATI PHUKAN,Indian National Congress,32169,123,32292,29.08,Assam-NAHARKATIA
4,LURINJYOTI GOGOI,Assam Jatiya Parishad,25093,139,25232,22.72,Assam-NAHARKATIA
5,TANU KUMAR DHADUMIA,Independent,694,2,696,0.63,Assam-NAHARKATIA
6,NOTA,None of the Above,1452,2,1454,1.31,Assam-NAHARKATIA
1,GOPI BARUAH,All India Trinamool Congress,1382,7,1389,0.77,Assam-NALBARI
2,JAYANTA MALLA BARUAH,Bharatiya Janata Party,105747,443,106190,58.84,Assam-NALBARI
3,PRADYUT KUMAR BHUYAN,Indian National Congress,56632,101,56733,31.43,Assam-NALBARI
4,KENEDI PEGU,SOCIALIST UNITY CENTRE OF INDIA (COMMUNIST),855,7,862,0.48,Assam-NALBARI
5,NAGEN DEKA,Assam Jatiya Parishad,11726,52,11778,6.53,Assam-NALBARI
6,APURBA PATHAK,Independent,573,2,575,0.32,Assam-NALBARI
7,KESHAB BARMAN,Independent,1147,3,1150,0.64,Assam-NALBARI
8,NOTA,None of the Above,1802,6,1808,1,Assam-NALBARI
1,JAYANTA KHAUND,Asom Gana Parishad,35003,276,35279,18.23,Assam-NAOBOICHA
2,DIPAK SAIKIA,Nationalist Congress Party,570,11,581,0.3,Assam-NAOBOICHA
3,BIRI JOY,National People's Party,3774,5,3779,1.95,Assam-NAOBOICHA
4,BHARAT CHANDRA NARAH,Indian National Congress,52697,208,52905,27.34,Assam-NAOBOICHA
5,ANUPAM CHUTIA,SOCIALIST UNITY CENTRE OF INDIA (COMMUNIST),780,1,781,0.4,Assam-NAOBOICHA
6,UBAIDUR RAHMAN,Rashtriya Ulama Council,735,0,735,0.38,Assam-NAOBOICHA
7,PUTALI KAYASTHA,Assam Jatiya Parishad,1906,28,1934,1,Assam-NAOBOICHA
8,BIKASH DEBNATH,Bharatiya Gana Parishad,3053,18,3071,1.59,Assam-NAOBOICHA
9,AJIJUR RAHMAN,Independent,49156,136,49292,25.47,Assam-NAOBOICHA
10,ABDUL GOFFUR,Independent,1299,1,1300,0.67,Assam-NAOBOICHA
11,SAHEBA AHMED,Independent,1029,3,1032,0.53,Assam-NAOBOICHA
12,RAO GAJENDRA SINGH,Independent,40610,100,40710,21.04,Assam-NAOBOICHA
13,NOTA,None of the Above,2092,10,2102,1.09,Assam-NAOBOICHA
1,Debabrata Saikia,Indian National Congress,51905,482,52387,47.56,Assam-NAZIRA
2,Mayur Borgohain,Bharatiya Janata Party,51243,461,51704,46.94,Assam-NAZIRA
3,Ribulaya Gogoi,Assam Jatiya Parishad,2859,37,2896,2.63,Assam-NAZIRA
4,Horen Borgohain,All India Forward Bloc,637,3,640,0.58,Assam-NAZIRA
5,Mintu Boruah,Independent,1055,6,1061,0.96,Assam-NAZIRA
6,NOTA,None of the Above,1461,9,1470,1.33,Assam-NAZIRA
1,RUPAK SARMAH,Bharatiya Janata Party,80712,386,81098,52.01,Assam-NOWGONG
2,SANTANU SARMA,Indian National Congress,69841,174,70015,44.9,Assam-NOWGONG
3,ANUP LASKAR,Assam Jatiya Parishad,1994,15,2009,1.29,Assam-NOWGONG
4,ABDUL AWAL BHUYAN,Lok Jan Shakti Party,172,0,172,0.11,Assam-NOWGONG
5,SAHJAHAN ALI AHMED,Rashtriya Ulama Council,322,0,322,0.21,Assam-NOWGONG
6,ANWAR WAHID,Independent,238,0,238,0.15,Assam-NOWGONG
7,ASHA BEGUM,Independent,352,0,352,0.23,Assam-NOWGONG
8,IKBAL HUSSAIN,Independent,153,0,153,0.1,Assam-NOWGONG
9,JIABUR RAHMAN,Independent,158,2,160,0.1,Assam-NOWGONG
10,NRIPENDRA MANDAL,Independent,325,3,328,0.21,Assam-NOWGONG
11,NOTA,None of the Above,1092,3,1095,0.7,Assam-NOWGONG
1,JATIN MALI,Indian National Congress,27260,60,27320,20.72,Assam-PALASBARI
2,HEMANGA THAKURIA,Bharatiya Janata Party,68196,115,68311,51.81,Assam-PALASBARI
3,PANKAJ LOCHAN GOSWAMI,Assam Jatiya Parishad,28595,46,28641,21.72,Assam-PALASBARI
4,ANIL BORO,Independent,2297,9,2306,1.75,Assam-PALASBARI
5,JURI MALI,Independent,1724,6,1730,1.31,Assam-PALASBARI
6,MUKUT KALITA,Independent,1014,3,1017,0.77,Assam-PALASBARI
7,MUNMI DUTTA,Independent,1091,3,1094,0.83,Assam-PALASBARI
8,NOTA,None of the Above,1425,2,1427,1.08,Assam-PALASBARI
1,KARUNA KANTA SWARGIARY,Bodoland Peoples Front,36501,286,36787,30.8,Assam-PANERY
2,BISWAJIT DAIMARY,Bharatiya Janata Party,71898,741,72639,60.82,Assam-PANERY
3,BHUMITRA KACHARI,Voters Party  International,2080,23,2103,1.76,Assam-PANERY
4,SWARNALATA CHALIHA,SOCIALIST UNITY CENTRE OF INDIA (COMMUNIST),1264,16,1280,1.07,Assam-PANERY
5,BAPAN BANIK,Independent,1750,12,1762,1.48,Assam-PANERY
6,BISWAJIT MINJ,Independent,2519,14,2533,2.12,Assam-PANERY
7,NOTA,None of the Above,2324,11,2335,1.95,Assam-PANERY
1,RANJEET KUMAR DASS,Bharatiya Janata Party,80163,1121,81284,71.67,Assam-PATACHARKUCHI
2,SANTANU SARMA,Indian National Congress,18203,228,18431,16.25,Assam-PATACHARKUCHI
3,KRISHNAMANI DAS,Republican Party of India (Athawale),589,19,608,0.54,Assam-PATACHARKUCHI
4,PABINDRA DEKA,Assam Jatiya Parishad,9613,218,9831,8.67,Assam-PATACHARKUCHI
5,CHAKRA PANI MEDHI,Independent,1558,17,1575,1.39,Assam-PATACHARKUCHI
6,NOTA,None of the Above,1669,16,1685,1.49,Assam-PATACHARKUCHI
1,KRISHNENDU PAUL,Bharatiya Janata Party,74067,779,74846,49.66,Assam-PATHARKANDI
2,SACHIN SAHOO,Indian National Congress,69800,579,70379,46.7,Assam-PATHARKANDI
3,SABBIR AHMED,Asom Gana Parishad,541,2,543,0.36,Assam-PATHARKANDI
4,JAYANTA SINHA,Republican Party of India,180,8,188,0.12,Assam-PATHARKANDI
5,NURUL ISLAM,All India Forward Bloc,83,1,84,0.06,Assam-PATHARKANDI
6,BULU CHANDA,SOCIALIST UNITY CENTRE OF INDIA (COMMUNIST),98,3,101,0.07,Assam-PATHARKANDI
7,MD. BAHAR UDDIN,Rashtriya Ulama Council,172,2,174,0.12,Assam-PATHARKANDI
8,HUMAYUN KABIR,Assam Jatiya Parishad,262,1,263,0.17,Assam-PATHARKANDI
9,IBRAHIM ALI,Independent,281,6,287,0.19,Assam-PATHARKANDI
10,YEAFUS ALI,Independent,127,11,138,0.09,Assam-PATHARKANDI
11,CHANDAN DAS,Independent,174,0,174,0.12,Assam-PATHARKANDI
12,YASHOBANTA KUAMR DAS,Independent,169,2,171,0.11,Assam-PATHARKANDI
13,SANJOY KUMAR MALAKAR,Independent,216,0,216,0.14,Assam-PATHARKANDI
14,SAHIN UZ JAMAN,Independent,835,0,835,0.55,Assam-PATHARKANDI
15,SHIHAB UDDIN AHMED,Independent,1018,2,1020,0.68,Assam-PATHARKANDI
16,NOTA,None of the Above,1283,5,1288,0.85,Assam-PATHARKANDI
1,BISHNU DAS,Asom Gana Parishad,76202,251,76453,42.75,Assam-RAHA
2,SASHI KANTA DAS,Indian National Congress,89356,155,89511,50.05,Assam-RAHA
3,UTPAL BANIA,Assam Jatiya Parishad,5542,74,5616,3.14,Assam-RAHA
4,MONI DAS,Janata Party,1044,66,1110,0.62,Assam-RAHA
5,GUNESWAR DAS,Independent,1174,40,1214,0.68,Assam-RAHA
6,CHITRALEKHA DAS,Independent,1124,15,1139,0.64,Assam-RAHA
7,RUBUL DAS,Independent,2285,4,2289,1.28,Assam-RAHA
8,NOTA,None of the Above,1497,20,1517,0.85,Assam-RAHA
1,ABHIJIT HAZARIKA,Indian National Congress,47609,218,47827,36.26,Assam-RANGAPARA
2,KRISHNA KAMAL TANTI,Bharatiya Janata Party,69765,407,70172,53.2,Assam-RANGAPARA
3,AJAY TANTI,Assam Jatiya Parishad,2941,35,2976,2.26,Assam-RANGAPARA
4,ABDUL JALIL,Janata Dal  (United),558,5,563,0.43,Assam-RANGAPARA
5,JITENDRA KUMAR SHARMA,Voters Party  International,1048,3,1051,0.8,Assam-RANGAPARA
6,BIJOY TIRKEY,Independent,935,5,940,0.71,Assam-RANGAPARA
7,MATHEW TOPNO,Independent,6105,2,6107,4.63,Assam-RANGAPARA
8,NOTA,None of the Above,2268,5,2273,1.72,Assam-RANGAPARA
1,Bhagaban Dev Misra,Communist Party of India  (Marxist),64267,357,64624,39.69,Assam-RANGIA
2,Bhabesh Kalita,Bharatiya Janata Party,84067,777,84844,52.11,Assam-RANGIA
3,Pabitra Boro,Voters Party  International,1329,42,1371,0.84,Assam-RANGIA
4,DR. Babul Sahariah,Assam Jatiya Parishad,3509,51,3560,2.19,Assam-RANGIA
5,Biswajit Brahma,Janata Dal  (United),602,9,611,0.38,Assam-RANGIA
6,Sahabuddin Ali Ahmed,Independent,1083,9,1092,0.67,Assam-RANGIA
7,Jayanta Kumar Kalita,Independent,1272,18,1290,0.79,Assam-RANGIA
8,Hareswar Barman,Independent,3486,19,3505,2.15,Assam-RANGIA
9,NOTA,None of the Above,1919,6,1925,1.18,Assam-RANGIA
1,BIJOY MALAKAR,Bharatiya Janata Party,83750,961,84711,61.92,Assam-RATABARI
2,SAMBHU SING MALLAH,Indian National Congress,48197,293,48490,35.44,Assam-RATABARI
3,SANCHITA SUKLA,SOCIALIST UNITY CENTRE OF INDIA (COMMUNIST),705,3,708,0.52,Assam-RATABARI
4,DIPENDRA DAS,Independent,196,0,196,0.14,Assam-RATABARI
5,BIKASH LAL DHUBI,Independent,295,3,298,0.22,Assam-RATABARI
6,BISHNU DHARI MALAH,Independent,232,0,232,0.17,Assam-RATABARI
7,BEBUL DAS,Independent,348,0,348,0.25,Assam-RATABARI
8,SUJIT ROY,Independent,625,3,628,0.46,Assam-RATABARI
9,NOTA,None of the Above,1147,53,1200,0.88,Assam-RATABARI
1,NAJIR HUSSAIN,Bharatiya Janata Party,25600,139,25739,14.22,Assam-RUPOHIHAT
2,NURUL HUDA,Indian National Congress,131652,439,132091,73,Assam-RUPOHIHAT
3,SHAFIQUL ISLAM,Assam Jatiya Parishad,9966,40,10006,5.53,Assam-RUPOHIHAT
4,SAMSUL ALAM,Janata Dal  (United),473,5,478,0.26,Assam-RUPOHIHAT
5,JINNATUL ISLAM,Rashtriya Ulama Council,439,4,443,0.24,Assam-RUPOHIHAT
6,ABU SHAMA,Independent,1109,8,1117,0.62,Assam-RUPOHIHAT
7,WAKIBUR ISLAM,Independent,404,4,408,0.23,Assam-RUPOHIHAT
8,NAZRUL ISLAM,Independent,1528,7,1535,0.85,Assam-RUPOHIHAT
9,NURUL AMIN CHOWDHURY,Independent,8115,23,8138,4.5,Assam-RUPOHIHAT
10,NOTA,None of the Above,988,9,997,0.55,Assam-RUPOHIHAT
1,BOLIN CHETIA,Bharatiya Janata Party,64147,708,64855,45.49,Assam-SADIYA
2,LAKHIN CHANDRA CHETIA,Indian National Congress,42217,554,42771,30,Assam-SADIYA
3,JAGADISH BHUYAN,Assam Jatiya Parishad,29532,317,29849,20.94,Assam-SADIYA
4,TIKENDRA THAPA,Voters Party  International,1086,18,1104,0.77,Assam-SADIYA
5,RIJUMONI GOGOI,Independent,1041,14,1055,0.74,Assam-SADIYA
6,LALIT DEORI,Independent,1013,10,1023,0.72,Assam-SADIYA
7,NOTA,None of the Above,1905,13,1918,1.35,Assam-SADIYA
1,ASADUL ISLAM,Bharatiya Janata Party,8899,20,8919,5.12,Assam-SALMARA SOUTH
2,WAZED ALI CHOUDHURY,Indian National Congress,146031,217,146248,83.98,Assam-SALMARA SOUTH
3,JENAT MOLLAH,Nationalist Congress Party,1470,0,1470,0.84,Assam-SALMARA SOUTH
4,ABDUS SOBUR MIAH,SOCIALIST UNITY CENTRE OF INDIA (COMMUNIST),1268,7,1275,0.73,Assam-SALMARA SOUTH
5,TALEB ALI,Janata Dal  (United),222,0,222,0.13,Assam-SALMARA SOUTH
6,NURAL ISLAM,Rashtriya Ulama Council,1115,1,1116,0.64,Assam-SALMARA SOUTH
7,NOZRUL ISLAM,Independent,1472,5,1477,0.85,Assam-SALMARA SOUTH
8,NURUL ISLAM MOLLAH,Independent,10665,9,10674,6.13,Assam-SALMARA SOUTH
9,FOZLUL HOQUE CHOUDHURY,Independent,1806,1,1807,1.04,Assam-SALMARA SOUTH
10,NOTA,None of the Above,937,0,937,0.54,Assam-SALMARA SOUTH
1,ANIL SAIKIA,Bharatiya Janata Party,54790,235,55025,39.4,Assam-SAMAGURI
2,RAKIBUL HUSSAIN,Indian National Congress,80813,310,81123,58.09,Assam-SAMAGURI
3,ABIDUR RAHMAN,Assam Jatiya Parishad,1670,8,1678,1.2,Assam-SAMAGURI
4,PRANJIT BHOWMIK,Bharatiya Gana Parishad,702,3,705,0.5,Assam-SAMAGURI
5,NOTA,None of the Above,1115,1,1116,0.8,Assam-SAMAGURI
1,KALPANA PATOWARY,Asom Gana Parishad,47272,232,47504,26.56,Assam-SARUKHETRI
2,SAYED JEHERUL ISLAM,All India Trinamool Congress,1082,15,1097,0.61,Assam-SARUKHETRI
3,JAKIR HUSSAIN SIKDAR,Indian National Congress,76669,376,77045,43.07,Assam-SARUKHETRI
4,MINAKSHI RAHMAN,All India United Democratic Front,44577,228,44805,25.05,Assam-SARUKHETRI
5,AJIDUL ISLAM,Republican Party of India (A),544,4,548,0.31,Assam-SARUKHETRI
6,NAJRUL ISLAM,Janata Party,447,5,452,0.25,Assam-SARUKHETRI
7,NABAB MEZBAHUL ALAM,Janata Dal  (United),194,0,194,0.11,Assam-SARUKHETRI
8,MANIK CHANDRA BARO,Assam Jatiya Parishad,3062,31,3093,1.73,Assam-SARUKHETRI
9,SHAHJAHAN ALI,The National Road Map Party of India,711,0,711,0.4,Assam-SARUKHETRI
10,HALIMA KHATUN,SOCIALIST UNITY CENTRE OF INDIA (COMMUNIST),462,1,463,0.26,Assam-SARUKHETRI
11,BINAD ALI,Independent,922,1,923,0.52,Assam-SARUKHETRI
12,MATIAR RAHMAN,Independent,778,2,780,0.44,Assam-SARUKHETRI
13,NOTA,None of the Above,1260,5,1265,0.71,Assam-SARUKHETRI
1,BISWAJIT PHUKAN,Bharatiya Janata Party,106425,665,107090,51.49,Assam-SARUPATHAR
2,ROSELINA TIRKEY,Indian National Congress,67351,380,67731,32.57,Assam-SARUPATHAR
3,RAJU PHUKAN,Assam Jatiya Parishad,27446,210,27656,13.3,Assam-SARUPATHAR
4,GOPAL GOGOI,Independent,2528,36,2564,1.23,Assam-SARUPATHAR
5,NOTA,None of the Above,2943,2,2945,1.42,Assam-SARUPATHAR
1,Ajit Hazarika,Nationalist Congress Party,428,6,434,0.35,Assam-SIBSAGAR
2,Subhramitra Gogoi,Indian National Congress,19147,182,19329,15.56,Assam-SIBSAGAR
3,Surabhi Rajkonwari,Bharatiya Janata Party,44964,380,45344,36.5,Assam-SIBSAGAR
4,AKHIL GOGOI,Independent,56914,305,57219,46.06,Assam-SIBSAGAR
5,RUPA BORAH,Independent,815,4,819,0.66,Assam-SIBSAGAR
6,Hemanta Boruah,Independent,429,6,435,0.35,Assam-SIBSAGAR
7,NOTA,None of the Above,635,4,639,0.51,Assam-SIBSAGAR
1,CHANDAN BRAHMA,Bodoland Peoples Front,65413,354,65767,38.27,Assam-SIDLI
2,JOYANTA BASUMATARY,"United Peopleâ€™s Party, Liberal",96550,537,97087,56.5,Assam-SIDLI
3,RANJAY KUMAR BRAHMA,Janata Dal  (United),1536,20,1556,0.91,Assam-SIDLI
4,JISOYA CHAMPRAMARY,Independent,3070,14,3084,1.79,Assam-SIDLI
5,SMRITI BASUMATARY,Independent,1828,22,1850,1.08,Assam-SIDLI
6,NOTA,None of the Above,2469,16,2485,1.45,Assam-SIDLI
1,TAMAL KANTI BANIK,Indian National Congress,60525,455,60980,34.75,Assam-SILCHAR
2,DIPAYAN CHAKRABORTY,Bharatiya Janata Party,97433,1125,98558,56.17,Assam-SILCHAR
3,DULALI CHAKRABORTY,SOCIALIST UNITY CENTRE OF INDIA (COMMUNIST),741,14,755,0.43,Assam-SILCHAR
4,PRASANTA LASKAR,Republican Party of India (A),178,3,181,0.1,Assam-SILCHAR
5,BISHWAY CHAMAK GOSWAMI,Bharatiya Gana Parishad,150,5,155,0.09,Assam-SILCHAR
6,RAJU SINHA,Hindusthan Nirman Dal,483,9,492,0.28,Assam-SILCHAR
7,ANUP DUTTA,Independent,194,3,197,0.11,Assam-SILCHAR
8,ANUPAM DEV,Independent,154,2,156,0.09,Assam-SILCHAR
9,DILIP KUMAR PAUL,Independent,11099,155,11254,6.41,Assam-SILCHAR
10,BAKTAR UDDIN MAZUMDER,Independent,218,4,222,0.13,Assam-SILCHAR
11,BAPPI PAUL,Independent,92,1,93,0.05,Assam-SILCHAR
12,BIJU CHANDA,Independent,97,1,98,0.06,Assam-SILCHAR
13,RUSNA BEGUM LASKAR,Independent,146,3,149,0.08,Assam-SILCHAR
14,SHANKAR CHAKRABORTY,Independent,254,0,254,0.14,Assam-SILCHAR
15,SHUVADIP DATTA,Independent,523,0,523,0.3,Assam-SILCHAR
16,NOTA,None of the Above,1375,23,1398,0.8,Assam-SILCHAR
1,KULDIP BARUA,Indian National Congress,67316,289,67605,45.52,Assam-SIPAJHAR
2,PARAMANANDA RAJBONGSHI,Bharatiya Janata Party,74203,536,74739,50.33,Assam-SIPAJHAR
3,GITIKA KAKATI,Assam Jatiya Parishad,2172,29,2201,1.48,Assam-SIPAJHAR
4,PAHESWARI BARUA,SOCIALIST UNITY CENTRE OF INDIA (COMMUNIST),213,6,219,0.15,Assam-SIPAJHAR
5,HARESWAR DEKA,Voters Party  International,420,3,423,0.28,Assam-SIPAJHAR
6,AMIYA KUMAR DEKA,Independent,499,8,507,0.34,Assam-SIPAJHAR
7,AROON BAROOA,Independent,244,4,248,0.17,Assam-SIPAJHAR
8,ASIFUN NESSA,Independent,357,3,360,0.24,Assam-SIPAJHAR
9,SAHNUR ALI,Independent,877,0,877,0.59,Assam-SIPAJHAR
10,NOTA,None of the Above,1323,3,1326,0.89,Assam-SIPAJHAR
1,AMINUL HAQUE LASKAR,Bharatiya Janata Party,51695,588,52283,35.49,Assam-SONAI
2,KARIM UDDIN BARBHUIYA,All India United Democratic Front,71463,474,71937,48.83,Assam-SONAI
3,M. SANTI KUMAR SINGHA,All India Trinamool Congress,2728,68,2796,1.9,Assam-SONAI
4,ANJAN KUMAR CHANDA,SOCIALIST UNITY CENTRE OF INDIA (COMMUNIST),242,2,244,0.17,Assam-SONAI
5,ANWAR HUSSAIN LASKAR,Samajwadi Party,461,8,469,0.32,Assam-SONAI
6,ABDUL MATLIB LASKAR,Independent,138,3,141,0.1,Assam-SONAI
7,ASHISH HALDAR,Independent,14392,108,14500,9.84,Assam-SONAI
8,ANAMUL HAQUE,Independent,729,6,735,0.5,Assam-SONAI
9,KARIM UDDIN BARBHUIYA,Independent,222,14,236,0.16,Assam-SONAI
10,DILIP KUMAR DAS,Independent,288,11,299,0.2,Assam-SONAI
11,MD NAZRUL ISLAM LASKAR,Independent,240,1,241,0.16,Assam-SONAI
12,BIJAN PAUL,Independent,675,4,679,0.46,Assam-SONAI
13,SHUKUMAR SONAR,Independent,481,1,482,0.33,Assam-SONAI
14,SAYAL AHMED BARBHUIYA,Independent,1060,1,1061,0.72,Assam-SONAI
15,NOTA,None of the Above,1226,5,1231,0.84,Assam-SONAI
1,DHARMESWAR KONWAR,Bharatiya Janata Party,69247,443,69690,48,Assam-SONARI
2,SUSHIL KUMAR SURI,Indian National Congress,54346,227,54573,37.59,Assam-SONARI
3,GAUTOM HATIMURIA,Assam Jatiya Parishad,16738,61,16799,11.57,Assam-SONARI
4,RATAN HEMROM,Independent,1613,4,1617,1.11,Assam-SONARI
5,NOTA,None of the Above,2501,9,2510,1.73,Assam-SONARI
1,PADMA HAZARIKA,Bharatiya Janata Party,83602,1205,84807,56.5,Assam-SOOTEA
2,PRANESWAR BASUMATARY,Indian National Congress,60056,376,60432,40.26,Assam-SOOTEA
3,ANILA BASUMATARY,Voters Party  International,2409,32,2441,1.63,Assam-SOOTEA
4,NOTA,None of the Above,2395,16,2411,1.61,Assam-SOOTEA
1,MANORANJAN TALUKDAR,Communist Party of India  (Marxist),95638,496,96134,50.21,Assam-SORBHOG
2,SANKAR CHANDRA DAS,Bharatiya Janata Party,85248,624,85872,44.85,Assam-SORBHOG
3,DEVANANDA DAS,Janata Dal  (United),617,27,644,0.34,Assam-SORBHOG
4,PRAKASH BRAHMA,Republican Party of India (Athawale),593,24,617,0.32,Assam-SORBHOG
5,MATIAR RAHMAN,The National Road Map Party of India,396,4,400,0.21,Assam-SORBHOG
6,SANTANU MUKHERJEE,Political Justice Party,850,2,852,0.45,Assam-SORBHOG
7,ABDUL HANNAN,Independent,790,5,795,0.42,Assam-SORBHOG
8,IKBAL HUSSAIN,Independent,869,4,873,0.46,Assam-SORBHOG
9,DWIPEN BARMAN,Independent,2416,16,2432,1.27,Assam-SORBHOG
10,FAIZAN NESSA,Independent,935,10,945,0.49,Assam-SORBHOG
11,NOTA,None of the Above,1880,16,1896,0.99,Assam-SORBHOG
1,RANGJA KHUNGUR BASUMATARY,Bodoland Peoples Front,46492,143,46635,27.66,Assam-TAMULPUR
2,KANAK BASUMATARY,Voters Party  International,1693,22,1715,1.02,Assam-TAMULPUR
3,NIRMALA DAS,Bharatiya Gana Parishad,7623,72,7695,4.56,Assam-TAMULPUR
4,LEHO RAM BORO,"United Peopleâ€™s Party, Liberal",78484,334,78818,46.75,Assam-TAMULPUR
5,KESHAB CHANDRA RAJBONGSHI,Independent,14344,35,14379,8.53,Assam-TAMULPUR
6,DIMBESWAR RABHA,Independent,1553,21,1574,0.93,Assam-TAMULPUR
7,NAGEN CHANDRA DAS,Independent,3696,17,3713,2.2,Assam-TAMULPUR
8,NILAMANI RAJBONGSHI,Independent,1357,4,1361,0.81,Assam-TAMULPUR
9,YASWANTA CHAUHAN,Independent,6536,13,6549,3.88,Assam-TAMULPUR
10,RAMCHARAN DEKA,Independent,2091,12,2103,1.25,Assam-TAMULPUR
11,SATYA NATH KALITA,Independent,1468,7,1475,0.87,Assam-TAMULPUR
12,NOTA,None of the Above,2552,10,2562,1.52,Assam-TAMULPUR
1,PALLABI GOGOI,Indian National Congress,45752,453,46205,44.48,Assam-TEOK
2,RENUPOMA RAJKHOWA,Asom Gana Parishad,47121,434,47555,45.78,Assam-TEOK
3,RUBI NEOG,Lok Jan Shakti Party,1057,52,1109,1.07,Assam-TEOK
4,KABINDRA CHETIA PHUKAN,Independent,5923,33,5956,5.73,Assam-TEOK
5,SIMANTA KUMAR DUTTA,Independent,1110,10,1120,1.08,Assam-TEOK
6,NOTA,None of the Above,1904,23,1927,1.86,Assam-TEOK
1,ANUJ KUMAR MECH,Indian National Congress,60982,349,61331,40.93,Assam-TEZPUR
2,PRITHIRAJ RAVA,Asom Gana Parishad,70835,619,71454,47.69,Assam-TEZPUR
3,JANMONI BORAH,Assam Jatiya Parishad,8560,126,8686,5.8,Assam-TEZPUR
4,NAYANMONI CHOUDHURY,SOCIALIST UNITY CENTRE OF INDIA (COMMUNIST),908,8,916,0.61,Assam-TEZPUR
5,ALOK NATH,Independent,3973,64,4037,2.69,Assam-TEZPUR
6,AKASH JYOTI SINGHA,Independent,580,10,590,0.39,Assam-TEZPUR
7,SHEIKH MOHAMMAD SADIQUE,Independent,765,4,769,0.51,Assam-TEZPUR
8,NOTA,None of the Above,2007,43,2050,1.37,Assam-TEZPUR
1,KUSHAL DOWARI,Bharatiya Janata Party,45613,407,46020,47.49,Assam-THOWRA
2,SUSHANTA BORGOHAIN,Indian National Congress,47643,383,48026,49.56,Assam-THOWRA
3,DIPEN TANTI,Assam Jatiya Parishad,1662,43,1705,1.76,Assam-THOWRA
4,NOTA,None of the Above,1140,6,1146,1.18,Assam-THOWRA
1,Etuwa Munda,Indian National Congress,34162,119,34281,28.8,Assam-TINGKHONG
2,Bimal Borah,Bharatiya Janata Party,62118,557,62675,52.66,Assam-TINGKHONG
3,Subhakaran Konhain,Assam Jatiya Parishad,16618,72,16690,14.02,Assam-TINGKHONG
4,Bikash Kullu,Independent,3432,13,3445,2.89,Assam-TINGKHONG
5,NOTA,None of the Above,1921,7,1928,1.62,Assam-TINGKHONG
1,RABIN CHANDRA KACHARI,Nationalist Congress Party,1313,7,1320,1.01,Assam-TINSUKIA
2,SANJOY KISHAN,Bharatiya Janata Party,85320,537,85857,65.58,Assam-TINSUKIA
3,ALOK ROY,Janata Dal  (United),1175,13,1188,0.91,Assam-TINSUKIA
4,SHAMSHER SINGH,Assam Jatiya Parishad,14915,145,15060,11.5,Assam-TINSUKIA
5,CHINTU BARUAH,Lok Jan Shakti Party,757,11,768,0.59,Assam-TINSUKIA
6,PROBIN KUMAR HAZARIKA,Rashtriya Lok Samta Party,1066,15,1081,0.83,Assam-TINSUKIA
7,BUDHI NATH PRAJAPATI,Political Justice Party,2902,8,2910,2.22,Assam-TINSUKIA
8,SWAPAN PAUL,Bharatiya Gana Parishad,840,10,850,0.65,Assam-TINSUKIA
9,HIRA DEVI,Rashtriya Janata Dal,13283,38,13321,10.17,Assam-TINSUKIA
10,SUBHASISH BHATTACHARJEE (KAJU),Independent,5984,47,6031,4.61,Assam-TINSUKIA
11,NOTA,None of the Above,2513,26,2539,1.94,Assam-TINSUKIA
1,Bhaskar Jyoti Baruah,Indian National Congress,63711,592,64303,52.89,Assam-TITABAR
2,Hemanta Kalita,Bharatiya Janata Party,50425,499,50924,41.89,Assam-TITABAR
3,Sailendra Kumar Hazarika,Assam Jatiya Parishad,3832,53,3885,3.2,Assam-TITABAR
4,Dilip Gogoi,Independent,890,11,901,0.74,Assam-TITABAR
5,NOTA,None of the Above,1557,5,1562,1.28,Assam-TITABAR
1,Rihon Daimari,Bodoland Peoples Front,56243,673,56916,46.47,Assam-UDALGURI
2,GOBINDA CHANDRA BASUMATARI,"United Peopleâ€™s Party, Liberal",61092,675,61767,50.43,Assam-UDALGURI
3,NOTA,None of the Above,3774,31,3805,3.11,Assam-UDALGURI
1,AJIT SINGH,Indian National Congress,58674,386,59060,45.28,Assam-UDHARBOND
2,MIHIR KANTI SHOME,Bharatiya Janata Party,61175,570,61745,47.34,Assam-UDHARBOND
3,Aynul Hoque Laskar,Assam Jatiya Parishad,802,9,811,0.62,Assam-UDHARBOND
4,Debojyoti Bhattacharjee,Independent,276,5,281,0.22,Assam-UDHARBOND
5,Rahul Roy,Independent,5763,33,5796,4.44,Assam-UDHARBOND
6,Subrata Mazumder,Independent,540,4,544,0.42,Assam-UDHARBOND
7,Suman Das,Independent,705,5,710,0.54,Assam-UDHARBOND
8,NOTA,None of the Above,1483,11,1494,1.15,Assam-UDHARBOND
1,M. G. Kannan,Indian National Congress,61488,2162,63650,40.96,Kerala-ADOOR
2,Chittayam Gopakumar,Communist Party of India,63958,2611,66569,42.83,Kerala-ADOOR
3,Adv. Pandalam Prathapan,Bharatiya Janata Party,23299,681,23980,15.43,Kerala-ADOOR
4,Vipin Kanikonathu,Bahujan Samaj Party,177,1,178,0.11,Kerala-ADOOR
5,Rajankulakkada,Anna Democratic Human Rights Movement Party of India,88,7,95,0.06,Kerala-ADOOR
6,Saranyaraj,SOCIALIST UNITY CENTRE OF INDIA (COMMUNIST),121,6,127,0.08,Kerala-ADOOR
7,R. Kannan S/o Rajan,Independent,210,8,218,0.14,Kerala-ADOOR
8,NOTA,None of the Above,580,14,594,0.38,Kerala-ADOOR
1,P.P Chitharanjan,Communist Party of India  (Marxist),71262,2150,73412,46.33,Kerala-ALAPPUZHA
2,Dr.K.S Manoj,Indian National Congress,60095,1673,61768,38.98,Kerala-ALAPPUZHA
3,Sandeep Vachaspati,Bharatiya Janata Party,21204,446,21650,13.66,Kerala-ALAPPUZHA
4,Subeendran K.C,Bahujan Samaj Party,204,3,207,0.13,Kerala-ALAPPUZHA
5,K.A Vinod,SOCIALIST UNITY CENTRE OF INDIA (COMMUNIST),202,3,205,0.13,Kerala-ALAPPUZHA
6,Shylendran,Bahujan Dravida Party,114,1,115,0.07,Kerala-ALAPPUZHA
7,NOTA,None of the Above,1068,21,1089,0.69,Kerala-ALAPPUZHA
1,CHANDRAN,Bahujan Samaj Party,688,11,699,0.52,Kerala-ALATHUR
2,PALAYAM PRADEEP,Indian National Congress,39762,773,40535,29.94,Kerala-ALATHUR
3,PRASANTH SIVAN,Bharatiya Janata Party,18115,234,18349,13.56,Kerala-ALATHUR
4,K.D.PRASENAN,Communist Party of India  (Marxist),72947,1706,74653,55.15,Kerala-ALATHUR
5,RAJESH.M,Independent,339,8,347,0.26,Kerala-ALATHUR
6,NOTA,None of the Above,765,18,783,0.58,Kerala-ALATHUR
1,ANWAR SADATH,Indian National Congress,72500,1203,73703,49,Kerala-ALUVA
2,M.N. GOPI,Bharatiya Janata Party,15660,233,15893,10.57,Kerala-ALUVA
3,A.G. AJAYAN,SOCIALIST UNITY CENTRE OF INDIA (COMMUNIST),224,4,228,0.15,Kerala-ALUVA
4,VISWAKALA THANKAPPAN,Marxist Communist Party of India (United),340,2,342,0.23,Kerala-ALUVA
5,K.M. SHEFRIN,Welfare Party Of India,1681,32,1713,1.14,Kerala-ALUVA
6,V.A RASHEED,SOCIAL DEMOCRATIC PARTY OF INDIA,2194,30,2224,1.48,Kerala-ALUVA
7,Ar SHELNA NISHAD,Independent,54042,775,54817,36.44,Kerala-ALUVA
8,K.V. SARALA,Independent,558,11,569,0.38,Kerala-ALUVA
9,NOTA,None of the Above,931,8,939,0.62,Kerala-ALUVA
1,Anoop Antony,Bharatiya Janata Party,21974,415,22389,16.34,Kerala-AMBALAPUZHA
2,Adv.M.Liju,Indian National Congress,48841,1399,50240,36.67,Kerala-AMBALAPUZHA
3,H.Salam,Communist Party of India  (Marxist),59602,1763,61365,44.79,Kerala-AMBALAPUZHA
4,M.M.Thahir,SOCIAL DEMOCRATIC PARTY OF INDIA,1672,18,1690,1.23,Kerala-AMBALAPUZHA
5,Subaida,SOCIALIST UNITY CENTRE OF INDIA (COMMUNIST),218,3,221,0.16,Kerala-AMBALAPUZHA
6,Subhadramma Thottappally,Welfare Party Of India,513,12,525,0.38,Kerala-AMBALAPUZHA
7,NOTA,None of the Above,562,29,591,0.43,Kerala-AMBALAPUZHA
1,Adv. JOSE THETTAYIL,Janata Dal  (Secular),54620,1013,55633,40.31,Kerala-ANGAMALY
2,Adv. K V SABU,Bharatiya Janata Party,8547,130,8677,6.29,Kerala-ANGAMALY
3,Stalin Nikathithara,Bahujan Samaj Party,322,4,326,0.24,Kerala-ANGAMALY
4,ROJI M JOHN,Indian National Congress,70163,1399,71562,51.86,Kerala-ANGAMALY
5,JOTHILAKSHMI,SOCIALIST UNITY CENTRE OF INDIA (COMMUNIST),292,9,301,0.22,Kerala-ANGAMALY
6,MARTIN PAUL,Independent,621,2,623,0.45,Kerala-ANGAMALY
7,Velayudhan,Independent,200,6,206,0.15,Kerala-ANGAMALY
8,NOTA,None of the Above,647,22,669,0.48,Kerala-ANGAMALY
1,BIJU MATHEW,Bharatiya Janata Party,28226,873,29099,17.98,Kerala-ARANMULA
2,VEENA GEORGE,Communist Party of India  (Marxist),72192,2758,74950,46.3,Kerala-ARANMULA
3,Adv. K. SIVADASAN NAIR,Indian National Congress,53142,2805,55947,34.56,Kerala-ARANMULA
4,OMALLOOR RAMACHANDRAN,Ambedkarite Party of India,229,7,236,0.15,Kerala-ARANMULA
5,SANTHI OMALLOOR,Anna Democratic Human Rights Movement Party of India,130,3,133,0.08,Kerala-ARANMULA
6,ARJUNAN C. K,Independent,65,2,67,0.04,Kerala-ARANMULA
7,PRASANTH ARANMULA,Independent,129,14,143,0.09,Kerala-ARANMULA
8,SIVADASAN NAIR S/o RAGHAVAN NAIR,Independent,607,22,629,0.39,Kerala-ARANMULA
9,G. SUGATHAN,Independent,86,1,87,0.05,Kerala-ARANMULA
10,NOTA,None of the Above,564,11,575,0.36,Kerala-ARANMULA
1,DALEEMA,Communist Party of India  (Marxist),73865,1752,75617,45.97,Kerala-AROOR
2,RUGMA PRADEEP,Bahujan Samaj Party,665,17,682,0.41,Kerala-AROOR
3,Adv. SHANIMOL OSMAN,Indian National Congress,67023,1581,68604,41.71,Kerala-AROOR
4,ANIYAPPAN,Bharath Dharma Jana Sena,17233,246,17479,10.63,Kerala-AROOR
5,AMBIKA K N  (PRIYANKA ANUP),Democratic Social Justice Party,466,9,475,0.29,Kerala-AROOR
6,K  PRATHAPAN,SOCIALIST UNITY CENTRE OF INDIA (COMMUNIST),358,16,374,0.23,Kerala-AROOR
7,PRAMOD PERUMPUZHA,Anna Democratic Human Rights Movement Party of India,161,0,161,0.1,Kerala-AROOR
8,VAYALAR RAJEEVAN,Bahujan Dravida Party,159,5,164,0.1,Kerala-AROOR
9,CHANDRAN,Independent,88,1,89,0.05,Kerala-AROOR
10,NOTA,None of the Above,833,13,846,0.51,Kerala-AROOR
1,Krishnankutty. M,Bahujan Samaj Party,904,19,923,0.63,Kerala-ARUVIKKARA
2,K. S. Sabarinadhan,Indian National Congress,59877,1853,61730,42.37,Kerala-ARUVIKKARA
3,C. Sivankutty,Bharatiya Janata Party,15060,319,15379,10.55,Kerala-ARUVIKKARA
4,Adv. G. Steephen,Communist Party of India  (Marxist),64795,1981,66776,45.83,Kerala-ARUVIKKARA
5,NOTA,None of the Above,885,15,900,0.62,Kerala-ARUVIKKARA
1,O S AMBIKA,Communist Party of India  (Marxist),67003,2895,69898,47.35,Kerala-ATTINGAL
2,VIPINLAL VIDHYADHARAN,Bahujan Samaj Party,894,33,927,0.63,Kerala-ATTINGAL
3,ADV. A SREEDHARAN,Revolutionary Socialist Party,35672,1266,36938,25.02,Kerala-ATTINGAL
4,ADV. P SUDHEER,Bharatiya Janata Party,37455,807,38262,25.92,Kerala-ATTINGAL
5,ASHA PRAKASH,Anna Democratic Human Rights Movement Party of India,332,7,339,0.23,Kerala-ATTINGAL
6,AMBILI,Independent,178,13,191,0.13,Kerala-ATTINGAL
7,NOTA,None of the Above,1032,39,1071,0.73,Kerala-ATTINGAL
1,K Ranjith,Bharatiya Janata Party,15403,338,15741,10.86,Kerala-AZHIKODE
2,K M Shaji,Indian Union Muslim League,58490,1163,59653,41.17,Kerala-AZHIKODE
3,K V Sumesh,Communist Party of India  (Marxist),63895,1899,65794,45.41,Kerala-AZHIKODE
4,ABDUL JABBAR K K,SOCIAL DEMOCRATIC PARTY OF INDIA,2348,9,2357,1.63,Kerala-AZHIKODE
5,RESMI RAVI,SOCIALIST UNITY CENTRE OF INDIA (COMMUNIST),224,2,226,0.16,Kerala-AZHIKODE
6,Pavithran Kurikkalot,Independent,41,7,48,0.03,Kerala-AZHIKODE
7,Prasad V P,Independent,96,8,104,0.07,Kerala-AZHIKODE
8,K M SHAJI (MAMBA),Independent,256,21,277,0.19,Kerala-AZHIKODE
9,Sumesh M (Mauvery House),Independent,177,3,180,0.12,Kerala-AZHIKODE
10,NOTA,None of the Above,503,14,517,0.36,Kerala-AZHIKODE
1,JOBISH BALUSSERY,Bahujan Samaj Party,465,11,476,0.26,Kerala-BALUSSERI
2,DHARMAJAN BOLGATTY,Indian National Congress,69145,2322,71467,39.28,Kerala-BALUSSERI
3,LIBIN BALUSSERY,Bharatiya Janata Party,16033,457,16490,9.06,Kerala-BALUSSERI
4,Adv. K.M. SACHINDEV,Communist Party of India  (Marxist),88612,3227,91839,50.47,Kerala-BALUSSERI
5,CHANDRIKA,Welfare Party Of India,856,33,889,0.49,Kerala-BALUSSERI
6,MOHANDAS UNNIKULAM,Republican Party of India (A),109,6,115,0.06,Kerala-BALUSSERI
7,DHARMENDRAN,Independent,235,12,247,0.14,Kerala-BALUSSERI
8,NOTA,None of the Above,397,34,431,0.24,Kerala-BALUSSERI
1,ABDUL GAFOOR K. K,Bahujan Samaj Party,269,3,272,0.16,Kerala-BEYPORE
2,Adv. P. M NIYAS,Indian National Congress,52579,839,53418,32.33,Kerala-BEYPORE
3,Adv. PRAKASHBABU,Bharatiya Janata Party,25822,445,26267,15.9,Kerala-BEYPORE
4,Adv. P. A  MOHAMED RIYAS,Communist Party of India  (Marxist),80505,1660,82165,49.73,Kerala-BEYPORE
5,JAMAL CHALIYAM,SOCIAL DEMOCRATIC PARTY OF INDIA,2015,14,2029,1.23,Kerala-BEYPORE
6,E.M NIYAS S/o  SALEEM BABU,Independent,159,3,162,0.1,Kerala-BEYPORE
7,NIYAS K S/o KOYA KUNIYIL,Independent,106,5,111,0.07,Kerala-BEYPORE
8,P. P MUHAMMAD RIYAS S/o MAMUKKOYA,Independent,160,5,165,0.1,Kerala-BEYPORE
9,NOTA,None of the Above,601,20,621,0.38,Kerala-BEYPORE
1,J.Chinchurani,Communist Party of India,64754,2498,67252,45.69,Kerala-CHADAYAMANGALAM
2,M.M.Naseer,Indian National Congress,51745,1829,53574,36.4,Kerala-CHADAYAMANGALAM
3,Lalu,Bahujan Samaj Party,400,6,406,0.28,Kerala-CHADAYAMANGALAM
4,Vishnu Pattathanam,Bharatiya Janata Party,21747,491,22238,15.11,Kerala-CHADAYAMANGALAM
5,Archana Prajith,Welfare Party Of India,590,15,605,0.41,Kerala-CHADAYAMANGALAM
6,Ratheesh Kadakkal,Anna Democratic Human Rights Movement Party of India,268,12,280,0.19,Kerala-CHADAYAMANGALAM
7,Sharafath Mallam,SOCIAL DEMOCRATIC PARTY OF INDIA,1853,26,1879,1.28,Kerala-CHADAYAMANGALAM
8,Shibu.K.Chadayamangalam,Independent,257,1,258,0.18,Kerala-CHADAYAMANGALAM
9,NOTA,None of the Above,671,14,685,0.47,Kerala-CHADAYAMANGALAM
1,M S Asokan,Bahujan Samaj Party,597,20,617,0.43,Kerala-CHALAKKUDY
2,DENNIES K ANTONY,Kerala Congress  (M),59516,1315,60831,42.49,Kerala-CHALAKKUDY
3,Saneeshkumar Joseph,Indian National Congress,60452,1436,61888,43.23,Kerala-CHALAKKUDY
4,Unnikrishnan K.A,Bharath Dharma Jana Sena,17014,287,17301,12.09,Kerala-CHALAKKUDY
5,Dharmajan P K,SOCIALIST UNITY CENTRE OF INDIA (COMMUNIST),244,9,253,0.18,Kerala-CHALAKKUDY
6,Cheriya,Independent,137,6,143,0.1,Kerala-CHALAKKUDY
7,Joshy Vattoly,Independent,143,17,160,0.11,Kerala-CHALAKKUDY
8,T N Rajan,Independent,692,21,713,0.5,Kerala-CHALAKKUDY
9,Rosilin,Independent,234,14,248,0.17,Kerala-CHALAKKUDY
10,NOTA,None of the Above,983,17,1000,0.7,Kerala-CHALAKKUDY
1,Amruth Dev T,Bahujan Samaj Party,1048,31,1079,0.87,Kerala-CHANGANASSERY
2,Adv. Job Maichil,Kerala Congress  (M),54244,1181,55425,44.85,Kerala-CHANGANASSERY
3,Adv G Raman Nair,Bharatiya Janata Party,14106,385,14491,11.73,Kerala-CHANGANASSERY
4,M. K. Nizamuddin,SOCIAL DEMOCRATIC PARTY OF INDIA,1065,10,1075,0.87,Kerala-CHANGANASSERY
5,Rejitha Jayaram,SOCIALIST UNITY CENTRE OF INDIA (COMMUNIST),323,5,328,0.27,Kerala-CHANGANASSERY
6,V. J.  Laly,Kerala Congress,47997,1369,49366,39.94,Kerala-CHANGANASSERY
7,JOEMON JOSEPH SRAMPICKAL,Independent,138,19,157,0.13,Kerala-CHANGANASSERY
8,Tijo Karikkandam,Independent,1077,17,1094,0.89,Kerala-CHANGANASSERY
9,Babychen Mukkadan,Independent,134,2,136,0.11,Kerala-CHANGANASSERY
10,NOTA,None of the Above,430,4,434,0.35,Kerala-CHANGANASSERY
1,B. B. GOPAKUMAR,Bharatiya Janata Party,41305,785,42090,30.61,Kerala-CHATHANNUR
2,G.S. JAYALAL,Communist Party of India,57529,1767,59296,43.12,Kerala-CHATHANNUR
3,N. PEETHAMBARAKURUP,Indian National Congress,33206,1074,34280,24.93,Kerala-CHATHANNUR
4,SUNU BHASKARAN,Bahujan Samaj Party,359,5,364,0.26,Kerala-CHATHANNUR
5,SHANMUGHAN PARAVUR,Anna Democratic Human Rights Movement Party of India,518,6,524,0.38,Kerala-CHATHANNUR
6,VARINJAM RAJEEV,Independent,122,13,135,0.1,Kerala-CHATHANNUR
7,SETHU,Independent,168,4,172,0.13,Kerala-CHATHANNUR
8,NOTA,None of the Above,616,26,642,0.47,Kerala-CHATHANNUR
1,VIVEK GOPAN,Bharatiya Janata Party,13943,268,14211,9.95,Kerala-CHAVARA
2,SHIBU BABY JOHN,Revolutionary Socialist Party,60103,2083,62186,43.52,Kerala-CHAVARA
3,JOHNSON KANDACHIRA,Independent,1209,14,1223,0.86,Kerala-CHAVARA
4,VIJI RATHEESH,Independent,369,7,376,0.26,Kerala-CHAVARA
5,Dr.SUJITH VIJAYANPILLAI,Independent,61220,2062,63282,44.29,Kerala-CHAVARA
6,SUJITHMON,Independent,895,6,901,0.63,Kerala-CHAVARA
7,NOTA,None of the Above,679,22,701,0.49,Kerala-CHAVARA
1,K RADHAKRISHNAN,Communist Party of India  (Marxist),81885,1530,83415,54.41,Kerala-CHELAKKARA
2,C C SREEKUMAR,Indian National Congress,43150,865,44015,28.71,Kerala-CHELAKKARA
3,SHAJUMON VATTEKKAD,Bharatiya Janata Party,23716,329,24045,15.68,Kerala-CHELAKKARA
4,CHANDRAN THIYATH,SOCIAL DEMOCRATIC PARTY OF INDIA,1110,10,1120,0.73,Kerala-CHELAKKARA
5,NOTA,None of the Above,709,11,720,0.47,Kerala-CHELAKKARA
1,M. V. GOPAKUMAR,Bharatiya Janata Party,33789,831,34620,23.52,Kerala-CHENGANNUR
2,M. MURALI,Indian National Congress,38099,1310,39409,26.78,Kerala-CHENGANNUR
3,SHAJI T. GEORGE,Bahujan Samaj Party,523,11,534,0.36,Kerala-CHENGANNUR
4,SAJI CHERIAN,Communist Party of India  (Marxist),69501,2001,71502,48.58,Kerala-CHENGANNUR
5,T. K. GOPINATHAN,SOCIALIST UNITY CENTRE OF INDIA (COMMUNIST),308,8,316,0.21,Kerala-CHENGANNUR
6,MELVIN. K. MATHEW,Democratic Social Justice Party,190,8,198,0.13,Kerala-CHENGANNUR
7,POULOSE,Independent,99,2,101,0.07,Kerala-CHENGANNUR
8,NOTA,None of the Above,449,42,491,0.33,Kerala-CHENGANNUR
1,VAYALAR JAYAKUMAR,Bahujan Samaj Party,594,19,613,0.34,Kerala-CHERTHALA
2,P PRASAD,Communist Party of India,80876,2826,83702,47,Kerala-CHERTHALA
3,ADV.S SARATH,Indian National Congress,74886,2668,77554,43.55,Kerala-CHERTHALA
4,ADV.P S JYOTHIS,Bharath Dharma Jana Sena,14254,308,14562,8.18,Kerala-CHERTHALA
5,KARTHIKEYAN,Independent,192,1,193,0.11,Kerala-CHERTHALA
6,SARATH S KANNATTUVELI,Independent,487,14,501,0.28,Kerala-CHERTHALA
7,SHAJAHAN V A,Independent,178,23,201,0.11,Kerala-CHERTHALA
8,ADV.SONNYMON K MATHEW,Independent,164,5,169,0.09,Kerala-CHERTHALA
9,NOTA,None of the Above,583,19,602,0.34,Kerala-CHERTHALA
1,Anil Mangalapuram,Bahujan Samaj Party,1077,20,1097,0.76,Kerala-CHIRAYINKEEZHU
2,B. S. Anoop,Indian National Congress,47402,1215,48617,33.51,Kerala-CHIRAYINKEEZHU
3,Ashanath G. S,Bharatiya Janata Party,30369,617,30986,21.36,Kerala-CHIRAYINKEEZHU
4,V. Sasi,Communist Party of India,60701,1933,62634,43.17,Kerala-CHIRAYINKEEZHU
5,Advocate G. Anil Kumar,Welfare Party Of India,605,11,616,0.42,Kerala-CHIRAYINKEEZHU
6,Anoop Gangan,Independent,369,3,372,0.26,Kerala-CHIRAYINKEEZHU
7,NOTA,None of the Above,750,8,758,0.52,Kerala-CHIRAYINKEEZHU
1,K. KRISHNANKUTTY,Janata Dal  (Secular),82816,1856,84672,55.38,Kerala-CHITTUR
2,A. CHANDRAN,Bahujan Samaj Party,907,11,918,0.6,Kerala-CHITTUR
3,V. NATESAN,Bharatiya Janata Party,14257,201,14458,9.46,Kerala-CHITTUR
4,Adv. SUMESH ACHUTHAN,Indian National Congress,49724,1070,50794,33.22,Kerala-CHITTUR
5,PRAMEELA. K,Independent,542,10,552,0.36,Kerala-CHITTUR
6,NSK PURAM SASIKUMAR,Independent,226,0,226,0.15,Kerala-CHITTUR
7,NOTA,None of the Above,1273,12,1285,0.84,Kerala-CHITTUR
1,D. Kumar,Indian National Congress,50421,780,51201,44.22,Kerala-DEVIKULAM
2,Adv. A. Raja,Communist Party of India  (Marxist),58183,866,59049,51,Kerala-DEVIKULAM
3,Ganesan. S,Independent,4675,42,4717,4.07,Kerala-DEVIKULAM
4,NOTA,None of the Above,804,3,807,0.7,Kerala-DEVIKULAM
1,C. K. Padmanabhan,Bharatiya Janata Party,14352,271,14623,9.13,Kerala-DHARMADAM
2,Pinarayi Vijayan,Communist Party of India  (Marxist),92140,3382,95522,59.61,Kerala-DHARMADAM
3,C. Raghunathan,Indian National Congress,44089,1310,45399,28.33,Kerala-DHARMADAM
4,Basheer Kannadiparamba,SOCIAL DEMOCRATIC PARTY OF INDIA,2266,14,2280,1.42,Kerala-DHARMADAM
5,Chovva Raghunathan,Independent,136,1,137,0.09,Kerala-DHARMADAM
6,Valayar Bhagyavathi,Independent,1720,33,1753,1.09,Kerala-DHARMADAM
7,C. P. Maharoof,Independent,66,6,72,0.04,Kerala-DHARMADAM
8,Vadi Harindran,Independent,53,8,61,0.04,Kerala-DHARMADAM
9,NOTA,None of the Above,390,10,400,0.25,Kerala-DHARMADAM
1,T P Jayachandran Master,Bharatiya Janata Party,31056,954,32010,19.48,Kerala-ELATHUR
2,A .K Saseendran,Nationalist Congress Party,80607,3032,83639,50.89,Kerala-ELATHUR
3,TAHIR MOKKANDI,Welfare Party Of India,1911,89,2000,1.22,Kerala-ELATHUR
4,RADHAKRISHNAN P K,Independent,548,32,580,0.35,Kerala-ELATHUR
5,Sulphikar Mayoori,Independent,43621,1516,45137,27.46,Kerala-ELATHUR
6,NOTA,None of the Above,960,24,984,0.6,Kerala-ELATHUR
1,Adv. C. Dinesh,Bharatiya Janata Party,6509,174,6683,4.66,Kerala-ERANAD
2,P.K. Basheer,Indian Union Muslim League,75952,2124,78076,54.49,Kerala-ERANAD
3,Velayudhan,Bahujan Samaj Party,1227,20,1247,0.87,Kerala-ERANAD
4,K.T. Abdurahiman,Independent,54218,1312,55530,38.76,Kerala-ERANAD
5,Adv. Sebastian,Independent,1077,23,1100,0.77,Kerala-ERANAD
6,NOTA,None of the Above,626,10,636,0.44,Kerala-ERANAD
1,Padmaja S. Menon,Bharatiya Janata Party,15813,230,16043,14.57,Kerala-ERANAKULAM
2,T. J. Vinod,Indian National Congress,45066,864,45930,41.72,Kerala-ERANAKULAM
3,Prof. Leslie Pallath,Twenty 20 Party,10550,84,10634,9.66,Kerala-ERANAKULAM
4,K. S. Anilkumar,Independent,215,10,225,0.2,Kerala-ERANAKULAM
5,Ashokan,Independent,173,3,176,0.16,Kerala-ERANAKULAM
6,SHAJI GEORGE PRANATHA,Independent,34528,432,34960,31.75,Kerala-ERANAKULAM
7,Shaji George Plakkil,Independent,290,15,305,0.28,Kerala-ERANAKULAM
8,Siciliamma Teacher,Independent,70,1,71,0.06,Kerala-ERANAKULAM
9,Sujith C. Sukumaran,Independent,1024,18,1042,0.95,Kerala-ERANAKULAM
10,NOTA,None of the Above,705,7,712,0.65,Kerala-ERANAKULAM
1,M. Noushad,Communist Party of India  (Marxist),69793,1780,71573,56.25,Kerala-ERAVIPURAM
2,Babudivakaran,Revolutionary Socialist Party,42452,1000,43452,34.15,Kerala-ERAVIPURAM
3,Mohanan Mayyanad,Bahujan Samaj Party,535,8,543,0.43,Kerala-ERAVIPURAM
4,M. Unnikrishnan,Anna Democratic Human Rights Movement Party of India,424,6,430,0.34,Kerala-ERAVIPURAM
5,Renjith Ravindran,Bharath Dharma Jana Sena,8353,115,8468,6.66,Kerala-ERAVIPURAM
6,S. Sudhilal,SOCIALIST UNITY CENTRE OF INDIA (COMMUNIST),205,8,213,0.17,Kerala-ERAVIPURAM
7,Ayathil Riyas,SOCIAL DEMOCRATIC PARTY OF INDIA,1441,3,1444,1.13,Kerala-ERAVIPURAM
8,N. Shihabudeen,Independent,183,4,187,0.15,Kerala-ERAVIPURAM
9,NOTA,None of the Above,914,17,931,0.73,Kerala-ERAVIPURAM
1,Jijith K Joy,Bahujan Samaj Party,1135,30,1165,0.92,Kerala-ETTUMANOOR
2,V N Vasavan,Communist Party of India  (Marxist),56632,1657,58289,46.2,Kerala-ETTUMANOOR
3,T N HariKumar,Bharatiya Janata Party,13401,345,13746,10.9,Kerala-ETTUMANOOR
4,A G Ajayakumar,SOCIALIST UNITY CENTRE OF INDIA (COMMUNIST),244,3,247,0.2,Kerala-ETTUMANOOR
5,Adv. Prince Lukose,Kerala Congress,42598,1388,43986,34.86,Kerala-ETTUMANOOR
6,Charley Thomas Panikkaridam,Independent,305,25,330,0.26,Kerala-ETTUMANOOR
7,Lathika Subhash,Independent,7410,214,7624,6.04,Kerala-ETTUMANOOR
8,NOTA,None of the Above,768,12,780,0.62,Kerala-ETTUMANOOR
1,N.K.AKBAR,Communist Party of India  (Marxist),76052,1020,77072,52.52,Kerala-GURUVAYOOR
2,Adv.K N A KHADER,Indian Union Muslim League,57918,886,58804,40.07,Kerala-GURUVAYOOR
3,ASHARAF VADAKKOOT,SOCIAL DEMOCRATIC PARTY OF INDIA,2870,19,2889,1.97,Kerala-GURUVAYOOR
4,M.KUMAR,SOCIALIST UNITY CENTRE OF INDIA (COMMUNIST),288,13,301,0.21,Kerala-GURUVAYOOR
5,DILEEP NAIR,Democratic Social Justice Party,6222,72,6294,4.29,Kerala-GURUVAYOOR
6,ANTONY,Independent,382,10,392,0.27,Kerala-GURUVAYOOR
7,NOTA,None of the Above,997,10,1007,0.69,Kerala-GURUVAYOOR
1,RAMESH CHENNITHALA,Indian National Congress,70056,2712,72768,48.31,Kerala-HARIPAD
2,Adv. R. SAJILAL,Communist Party of India,57251,1851,59102,39.24,Kerala-HARIPAD
3,K. SOMAN,Bharatiya Janata Party,17441,449,17890,11.88,Kerala-HARIPAD
4,MADHU. T,SOCIALIST UNITY CENTRE OF INDIA (COMMUNIST),194,10,204,0.14,Kerala-HARIPAD
5,Adv. NIYAZ BHARATI,Independent,118,5,123,0.08,Kerala-HARIPAD
6,NOTA,None of the Above,525,11,536,0.36,Kerala-HARIPAD
1,BABU VARGHESE VATTOLI,Bahujan Samaj Party,1096,10,1106,0.84,Kerala-IDUKKI
2,ROSHY AUGUSTINE,Kerala Congress  (M),61033,1335,62368,47.48,Kerala-IDUKKI
3,ADV. K FRANCIS GEORGE,Kerala Congress,55439,1356,56795,43.24,Kerala-IDUKKI
4,ADV. SANGEETHA VISWANATHAN,Bharath Dharma Jana Sena,9148,138,9286,7.07,Kerala-IDUKKI
5,BIJEESH THOMAS,Independent,604,6,610,0.46,Kerala-IDUKKI
6,VINCENT JACOB,Independent,336,4,340,0.26,Kerala-IDUKKI
7,SAJEEV,Independent,164,5,169,0.13,Kerala-IDUKKI
8,NOTA,None of the Above,661,16,677,0.52,Kerala-IDUKKI
1,ANIAMMA TEACHER,Bharatiya Janata Party,7608,217,7825,5.13,Kerala-IRIKKUR
2,SAJI KUTTIYANIMATTAM,Kerala Congress  (M),64467,2287,66754,43.77,Kerala-IRIKKUR
3,Adv. Sajeev Joseph,Indian National Congress,74194,2570,76764,50.33,Kerala-IRIKKUR
4,CHACKO KARIMBIL,Independent,295,16,311,0.2,Kerala-IRIKKUR
5,Joy John,Independent,123,5,128,0.08,Kerala-IRIKKUR
6,SAJAN KUTTIYANIKKAL,Independent,268,7,275,0.18,Kerala-IRIKKUR
7,NOTA,None of the Above,449,10,459,0.3,Kerala-IRIKKUR
1,Jacob Thomas,Bharatiya Janata Party,33685,644,34329,22.12,Kerala-IRINJALAKKUDA
2,R Bindu,Communist Party of India  (Marxist),60843,1650,62493,40.27,Kerala-IRINJALAKKUDA
3,Thomas J Unniyadan,Kerala Congress,54851,1693,56544,36.44,Kerala-IRINJALAKKUDA
4,Joshy,Independent,292,13,305,0.2,Kerala-IRINJALAKKUDA
5,Bindu,Independent,206,14,220,0.14,Kerala-IRINJALAKKUDA
6,Bindu,Independent,141,21,162,0.1,Kerala-IRINJALAKKUDA
7,Vaxerin,Independent,503,33,536,0.35,Kerala-IRINJALAKKUDA
8,NOTA,None of the Above,583,7,590,0.38,Kerala-IRINJALAKKUDA
1,Adv. Anju Mathew,Bahujan Samaj Party,1188,19,1207,0.92,Kerala-KADUTHURUTHY
2,Ligin Lal,Bharatiya Janata Party,11419,251,11670,8.88,Kerala-KADUTHURUTHY
3,Stephen George,Kerala Congress  (M),53819,1591,55410,42.17,Kerala-KADUTHURUTHY
4,Adv. Jaimon Thankachan,Samajwadi Jan Parishad,287,15,302,0.23,Kerala-KADUTHURUTHY
5,Adv. Mons Joseph,Kerala Congress,57856,1810,59666,45.4,Kerala-KADUTHURUTHY
6,Vinod K Jose,Independent,2386,39,2425,1.85,Kerala-KADUTHURUTHY
7,NOTA,None of the Above,727,4,731,0.56,Kerala-KADUTHURUTHY
1,E T TAISON MASTER,Communist Party of India,71666,1495,73161,53.76,Kerala-KAIPAMANGALAM
2,THANKAMANY THARAYIL,Bahujan Samaj Party,434,8,442,0.32,Kerala-KAIPAMANGALAM
3,SOBHA SUBIN,Indian National Congress,49505,958,50463,37.08,Kerala-KAIPAMANGALAM
4,M K ASLAM,Welfare Party Of India,1630,41,1671,1.23,Kerala-KAIPAMANGALAM
5,C D SREELAL,Bharath Dharma Jana Sena,8913,153,9066,6.66,Kerala-KAIPAMANGALAM
6,M K SHAMEER,SOCIAL DEMOCRATIC PARTY OF INDIA,808,6,814,0.6,Kerala-KAIPAMANGALAM
7,NOTA,None of the Above,457,9,466,0.34,Kerala-KAIPAMANGALAM
1,ADV. V. E. ABDUL GAFOOR,Indian Union Muslim League,60829,976,61805,39.65,Kerala-KALAMASSERY
2,P. S. UNNIKRISHNAN,Bahujan Samaj Party,840,17,857,0.55,Kerala-KALAMASSERY
3,P. RAJEEVE,Communist Party of India  (Marxist),75757,1384,77141,49.49,Kerala-KALAMASSERY
4,P. S. JAYARAJ,Bharath Dharma Jana Sena,11021,158,11179,7.17,Kerala-KALAMASSERY
5,V. M. FAISAL,SOCIAL DEMOCRATIC PARTY OF INDIA,2372,13,2385,1.53,Kerala-KALAMASSERY
6,NAYANA UNNIKRISHNAN,Independent,443,9,452,0.29,Kerala-KALAMASSERY
7,P. M. K. BAVA,Independent,514,12,526,0.34,Kerala-KALAMASSERY
8,NOTA,None of the Above,1483,35,1518,0.97,Kerala-KALAMASSERY
1,ARUN KAITHAPRAM,Bharatiya Janata Party,11135,230,11365,7.81,Kerala-KALLIASSERI
2,ADV. BRIJESH KUMAR,Indian National Congress,42785,1074,43859,30.13,Kerala-KALLIASSERI
3,M VIJIN,Communist Party of India  (Marxist),85304,2948,88252,60.62,Kerala-KALLIASSERI
4,FAIZAL MADAYI,Welfare Party Of India,1141,28,1169,0.8,Kerala-KALLIASSERI
5,BRIJESHKUMAR M.  S/o AMBU,Independent,272,2,274,0.19,Kerala-KALLIASSERI
6,NOTA,None of the Above,647,19,666,0.46,Kerala-KALLIASSERI
1,ASWIN BHIMNATH,Bahujan Samaj Party,915,13,928,0.61,Kerala-KALPETTA
2,Adv.T SIDDIQU,Indian National Congress,68845,1407,70252,46.15,Kerala-KALPETTA
3,SUBEESH T M,Bharatiya Janata Party,13868,245,14113,9.27,Kerala-KALPETTA
4,M.V.SHREYAMSKUMAR,Loktantrik Janta Dal,63392,1390,64782,42.56,Kerala-KALPETTA
5,SUNIL VAIDYAR,Anna Democratic Human Rights Movement Party of India,444,11,455,0.3,Kerala-KALPETTA
6,SHYLESH.K,Independent,204,6,210,0.14,Kerala-KALPETTA
7,T.SIDIQUE S/o ABDULLA,Independent,634,7,641,0.42,Kerala-KALPETTA
8,NOTA,None of the Above,809,19,828,0.54,Kerala-KALPETTA
1,E CHANDRASHEKARAN,Communist Party of India,82189,2426,84615,50.72,Kerala-KANHANGAD
2,BALRAJ,Bharatiya Janata Party,21119,451,21570,12.93,Kerala-KANHANGAD
3,P V SURESH,Indian National Congress,56112,1364,57476,34.45,Kerala-KANHANGAD
4,ABDUL SAMAD. T S/o T KUNHAMU HAJI,SOCIAL DEMOCRATIC PARTY OF INDIA,774,1,775,0.46,Kerala-KANHANGAD
5,T ABDUL SAMAD S/o T KUNHIKOYA HAJI,Janata Dal  (United),86,1,87,0.05,Kerala-KANHANGAD
6,RESHMA KARIVEDAKAM,Anna Democratic Human Rights Movement Party of India,181,4,185,0.11,Kerala-KANHANGAD
7,AUGUSTIN,Independent,495,37,532,0.32,Kerala-KANHANGAD
8,KRISHNAN PARAPPACHAL,Independent,347,10,357,0.21,Kerala-KANHANGAD
9,MANOJ THOMAS,Independent,93,12,105,0.06,Kerala-KANHANGAD
10,SREENATH SASI. T C V,Independent,218,1,219,0.13,Kerala-KANHANGAD
11,SURESH. B C S/o CHENIYAN NAIK,Independent,276,1,277,0.17,Kerala-KANHANGAD
12,NOTA,None of the Above,620,17,637,0.38,Kerala-KANHANGAD
1,ALPHONS KANNANTHANAM,Bharatiya Janata Party,28568,589,29157,21.17,Kerala-KANJIRAPPALLY
2,ASHIK M M,Bahujan Samaj Party,720,7,727,0.53,Kerala-KANJIRAPPALLY
3,Dr.N.JAYARAJ,Kerala Congress  (M),59151,1148,60299,43.79,Kerala-KANJIRAPPALLY
4,JOSEPH VAZHACKAN,Indian National Congress,45296,1300,46596,33.84,Kerala-KANJIRAPPALLY
5,MAYAMOL K P,SOCIALIST UNITY CENTRE OF INDIA (COMMUNIST),292,8,300,0.22,Kerala-KANJIRAPPALLY
6,NOTA,None of the Above,622,2,624,0.45,Kerala-KANJIRAPPALLY
1,ARCHANA VANDICHAL,Bharatiya Janata Party,11340,241,11581,8.64,Kerala-KANNUR
2,SATHEESHAN PACHENI,Indian National Congress,56953,1615,58568,43.68,Kerala-KANNUR
3,T K GANESH BABU,New Labour Party,709,7,716,0.53,Kerala-KANNUR
4,RAMACHANDRAN KADANNAPPALLI,Congress  (Secular),58505,1808,60313,44.98,Kerala-KANNUR
5,B SHAMSUDHEEN MOULAVI,SOCIAL DEMOCRATIC PARTY OF INDIA,2061,8,2069,1.54,Kerala-KANNUR
6,RAMACHANDRAN P V,Independent,106,1,107,0.08,Kerala-KANNUR
7,SATHEESAN P,Independent,134,13,147,0.11,Kerala-KANNUR
8,N K SURENDRAN,Independent,83,1,84,0.06,Kerala-KANNUR
9,NOTA,None of the Above,475,29,504,0.38,Kerala-KANNUR
1,Bitty Sudheer,Bharatiya Janata Party,11847,297,12144,7.01,Kerala-KARUNAGAPPALLY
2,C. R Mahesh,Indian National Congress,91849,2376,94225,54.38,Kerala-KARUNAGAPPALLY
3,R. Ramachandran,Communist Party of India,62810,2207,65017,37.52,Kerala-KARUNAGAPPALLY
4,Bhargavan S,SOCIALIST UNITY CENTRE OF INDIA (COMMUNIST),275,8,283,0.16,Kerala-KARUNAGAPPALLY
5,Madhu,Anna Democratic Human Rights Movement Party of India,126,2,128,0.07,Kerala-KARUNAGAPPALLY
6,Adv. Sumayya Najeeb,SOCIAL DEMOCRATIC PARTY OF INDIA,1030,7,1037,0.6,Kerala-KARUNAGAPPALLY
7,NOTA,None of the Above,439,11,450,0.26,Kerala-KARUNAGAPPALLY
1,N A NELLIKKUNNU,Indian Union Muslim League,62824,472,63296,43.8,Kerala-KASARAGOD
2,VIJAYA K P,Bahujan Samaj Party,664,15,679,0.47,Kerala-KASARAGOD
3,ADV K SHREEKANTH,Bharatiya Janata Party,49737,658,50395,34.88,Kerala-KASARAGOD
4,RANJITH RAJ M,Anna Democratic Human Rights Movement Party of India,545,10,555,0.38,Kerala-KASARAGOD
5,M A LATHEEF,Indian National League,28028,295,28323,19.6,Kerala-KASARAGOD
6,NISHANTH KUMAR I B,Independent,412,5,417,0.29,Kerala-KASARAGOD
7,SUDHAKARAN K,Independent,192,4,196,0.14,Kerala-KASARAGOD
8,NOTA,None of the Above,629,10,639,0.44,Kerala-KASARAGOD
1,P.K KRISHNADAS,Bharatiya Janata Party,33755,787,34542,23.72,Kerala-KATTAKKADA
2,MALAYINKEEZHU VENUGOPAL,Indian National Congress,41723,1339,43062,29.57,Kerala-KATTAKKADA
3,Adv I B SATHEESH,Communist Party of India  (Marxist),64159,2134,66293,45.52,Kerala-KATTAKKADA
4,KANDALA SURESH,Bahujan Samaj Party,623,5,628,0.43,Kerala-KATTAKKADA
5,SREEKALA NADAR,Independent,256,10,266,0.18,Kerala-KATTAKKADA
6,SYRIAC DAMIAN V. P,Independent,126,3,129,0.09,Kerala-KATTAKKADA
7,NOTA,None of the Above,686,13,699,0.48,Kerala-KATTAKKADA
1,Aritha Babu,Indian National Congress,69044,2006,71050,44.06,Kerala-KAYAMKULAM
2,Adv. U. Prathibha,Communist Party of India  (Marxist),75173,2175,77348,47.97,Kerala-KAYAMKULAM
3,Pradeeplal,Bharath Dharma Jana Sena,11087,326,11413,7.08,Kerala-KAYAMKULAM
4,Myna  Gopinath,SOCIALIST UNITY CENTRE OF INDIA (COMMUNIST),145,5,150,0.09,Kerala-KAYAMKULAM
5,Geevarghese Samuel,Independent,201,4,205,0.13,Kerala-KAYAMKULAM
6,Maniyappan Achari,Independent,354,13,367,0.23,Kerala-KAYAMKULAM
7,Rajeev R,Independent,216,15,231,0.14,Kerala-KAYAMKULAM
8,Sathyanarayanan S,Independent,67,6,73,0.05,Kerala-KAYAMKULAM
9,NOTA,None of the Above,414,6,420,0.26,Kerala-KAYAMKULAM
1,Kadakampally Surendran,Communist Party of India  (Marxist),62176,1514,63690,46.04,Kerala-KAZHAKKOOTTAM
2,Kochumani,Bahujan Samaj Party,370,7,377,0.27,Kerala-KAZHAKKOOTTAM
3,Dr. S. S. Lal,Indian National Congress,32198,797,32995,23.85,Kerala-KAZHAKKOOTTAM
4,Sobha Surendran,Bharatiya Janata Party,39504,689,40193,29.06,Kerala-KAZHAKKOOTTAM
5,Lalumon,Independent,111,1,112,0.08,Kerala-KAZHAKKOOTTAM
6,V. Sasikumaran Nair,Independent,123,6,129,0.09,Kerala-KAZHAKKOOTTAM
7,Syamlal,Independent,85,0,85,0.06,Kerala-KAZHAKKOOTTAM
8,Adv. Sen A. G.,Independent,71,5,76,0.05,Kerala-KAZHAKKOOTTAM
9,NOTA,None of the Above,655,13,668,0.48,Kerala-KAZHAKKOOTTAM
1,TONY CHAMMANY,Indian National Congress,39865,688,40553,31.51,Kerala-KOCHI
2,K.J. MAXY,Communist Party of India  (Marxist),53973,659,54632,42.45,Kerala-KOCHI
3,C.G.RAJAGOPAL,Bharatiya Janata Party,10800,191,10991,8.54,Kerala-KOCHI
4,SHINY ANTONY,Twenty 20 Party,19550,126,19676,15.29,Kerala-KOCHI
5,Nipun Cherian,Independent,2123,26,2149,1.67,Kerala-KOCHI
6,RAJANEESH BABU,Independent,224,4,228,0.18,Kerala-KOCHI
7,NOTA,None of the Above,464,10,474,0.37,Kerala-KOCHI
1,M. P. JACKSON,Indian National Congress,46017,1547,47564,31.94,Kerala-KODUNGALLUR
2,REMYA MOHANAN,Bahujan Samaj Party,342,24,366,0.25,Kerala-KODUNGALLUR
3,SANTHOSH CHERAKKULAM,Bharatiya Janata Party,27600,604,28204,18.94,Kerala-KODUNGALLUR
4,Adv. V. R. SUNILKUMAR,Communist Party of India,69447,2010,71457,47.99,Kerala-KODUNGALLUR
5,O. M. SREEJA,SOCIALIST UNITY CENTRE OF INDIA (COMMUNIST),262,8,270,0.18,Kerala-KODUNGALLUR
6,RAJAN PAINAT,Independent,162,9,171,0.11,Kerala-KODUNGALLUR
7,NOTA,None of the Above,865,5,870,0.58,Kerala-KODUNGALLUR
1,T BALASOMAN,Bharatiya Janata Party,9227,271,9498,6.28,Kerala-KODUVALLY
2,DR. M.K MUNEER,Indian Union Muslim League,70193,2143,72336,47.86,Kerala-KODUVALLY
3,MUSTHAFA KOMMERI,SOCIAL DEMOCRATIC PARTY OF INDIA,1734,35,1769,1.17,Kerala-KODUVALLY
4,SHAHIN K C,Samajwadi Forward Bloc,69,5,74,0.05,Kerala-KODUVALLY
5,ABDUL MUNEER,Independent,86,0,86,0.06,Kerala-KODUVALLY
6,SALEEM NECHOLE,Independent,91,1,92,0.06,Kerala-KODUVALLY
7,ABDUL RAZAK K S/O AHMAD KUTTY,Independent,379,2,381,0.25,Kerala-KODUVALLY
8,KARAT RAZACK,Independent,64114,1878,65992,43.66,Kerala-KODUVALLY
9,ABDUL RAZAK  S/O  MUHAMMED,Independent,316,9,325,0.22,Kerala-KODUVALLY
10,MUNEER  M.K  S/O  MUHAMMED,Independent,207,21,228,0.15,Kerala-KODUVALLY
11,LAKSHMANAN.K.P.THAMARASSERY,Independent,102,2,104,0.07,Kerala-KODUVALLY
12,NOTA,None of the Above,265,4,269,0.18,Kerala-KODUVALLY
1,Adv. BINDHU KRISHNA,Indian National Congress,55035,1417,56452,43.27,Kerala-KOLLAM
2,M Mukesh,Communist Party of India  (Marxist),56898,1626,58524,44.86,Kerala-KOLLAM
3,REMANAN,Bahujan Samaj Party,282,8,290,0.22,Kerala-KOLLAM
4,Sunil M,Bharatiya Janata Party,14029,223,14252,10.93,Kerala-KOLLAM
5,BABY S,Anna Democratic Human Rights Movement Party of India,178,5,183,0.14,Kerala-KOLLAM
6,NOTA,None of the Above,733,17,750,0.57,Kerala-KOLLAM
1,T V IBRAHIM,Indian Union Muslim League,81259,1500,82759,50.42,Kerala-KONDOTTY
2,SIVADASAN T,Bahujan Samaj Party,893,15,908,0.55,Kerala-KONDOTTY
3,SHEEBA UNNIKRISHNAN,Bharatiya Janata Party,10904,210,11114,6.77,Kerala-KONDOTTY
4,Razak PALERI,Welfare Party Of India,2505,74,2579,1.57,Kerala-KONDOTTY
5,C V IBRAHIM S/o MUHAMMED,Independent,230,3,233,0.14,Kerala-KONDOTTY
6,KATTUPARUTHY SULAIMAN HAJI,Independent,64015,1078,65093,39.66,Kerala-KONDOTTY
7,SULAIMAN HAJI,Independent,893,12,905,0.55,Kerala-KONDOTTY
8,NOTA,None of the Above,552,2,554,0.34,Kerala-KONDOTTY
1,Guruvayoorappan P E,Bahujan Samaj Party,1321,30,1351,0.98,Kerala-KONGAD
2,U C Raman,Indian Union Muslim League,40046,616,40662,29.36,Kerala-KONGAD
3,Santhakumari K,Communist Party of India  (Marxist),66683,1198,67881,49.01,Kerala-KONGAD
4,Suresh Babu M,Bharatiya Janata Party,27223,438,27661,19.97,Kerala-KONGAD
5,NOTA,None of the Above,932,21,953,0.69,Kerala-KONGAD
1,Adv. K.U JENISH KUMAR,Communist Party of India  (Marxist),60166,2152,62318,41.62,Kerala-KONNI
2,K. SURENDRAN,Bharatiya Janata Party,31994,817,32811,21.91,Kerala-KONNI
3,ROBIN PETER,Indian National Congress,51859,1951,53810,35.94,Kerala-KONNI
4,RAGHU P,Anna Democratic Human Rights Movement Party of India,212,2,214,0.14,Kerala-KONNI
5,SUKU BALAN,Ambedkarite Party of India,120,2,122,0.08,Kerala-KONNI
6,MANOHARAN,Independent,72,3,75,0.05,Kerala-KONNI
7,NOTA,None of the Above,370,2,372,0.25,Kerala-KONNI
1,ANTONY JOHN,Communist Party of India  (Marxist),62425,1809,64234,46.99,Kerala-KOTHAMANGALAM
2,Dr. JOE JOSEPH,Twenty 20 Party,7795,183,7978,5.84,Kerala-KOTHAMANGALAM
3,T.M. MOOSA,SOCIAL DEMOCRATIC PARTY OF INDIA,1273,13,1286,0.94,Kerala-KOTHAMANGALAM
4,Shibu Thekkumpuram,Kerala Congress,55868,1761,57629,42.16,Kerala-KOTHAMANGALAM
5,SHINE  K KRISHNAN,Bharath Dharma Jana Sena,4532,106,4638,3.39,Kerala-KOTHAMANGALAM
6,ANTO JOHNY,Independent,121,15,136,0.1,Kerala-KOTHAMANGALAM
7,SHIBU,Independent,101,5,106,0.08,Kerala-KOTHAMANGALAM
8,Shibu Thekkan,Independent,261,15,276,0.2,Kerala-KOTHAMANGALAM
9,NOTA,None of the Above,372,42,414,0.3,Kerala-KOTHAMANGALAM
1,PROF. ABID HUSSAIN THANGAL,Indian Union Muslim League,80061,1639,81700,51.08,Kerala-KOTTAKKAL
2,P. P. GANESAN,Bharatiya Janata Party,10556,240,10796,6.75,Kerala-KOTTAKKAL
3,N. A. MUHAMMED KUTTY (MAMMUTY),Nationalist Congress Party,63739,1373,65112,40.71,Kerala-KOTTAKKAL
4,AYISHA,Independent,319,9,328,0.21,Kerala-KOTTAKKAL
5,BINDHU DEVARAJAN,Independent,477,4,481,0.3,Kerala-KOTTAKKAL
6,MOHAMED KUTTY,Independent,662,13,675,0.42,Kerala-KOTTAKKAL
7,SAINUL ABID THANGAL,Independent,160,13,173,0.11,Kerala-KOTTAKKAL
8,NOTA,None of the Above,664,4,668,0.42,Kerala-KOTTAKKAL
1,K N BALAGOPAL,Communist Party of India  (Marxist),66612,2158,68770,45.98,Kerala-KOTTARAKKARA
2,R RESMI,Indian National Congress,56127,1829,57956,38.75,Kerala-KOTTARAKKARA
3,Adv. VAYAKKAL SOMAN,Bharatiya Janata Party,20710,513,21223,14.19,Kerala-KOTTARAKKARA
4,USHA KOTTARAKKARA,Anna Democratic Human Rights Movement Party of India,453,7,460,0.31,Kerala-KOTTARAKKARA
5,E. KUNJUMON,SOCIALIST UNITY CENTRE OF INDIA (COMMUNIST),83,4,87,0.06,Kerala-KOTTARAKKARA
6,JAINEENDRAN T,Shiv Sena,57,0,57,0.04,Kerala-KOTTARAKKARA
7,V VENUGOPAL,Democratic Social Justice Party,86,10,96,0.06,Kerala-KOTTARAKKARA
8,EYYAMKODU MANIKUTTAN,Independent,81,9,90,0.06,Kerala-KOTTARAKKARA
9,MATHEWS K LUKOSE,Independent,133,3,136,0.09,Kerala-KOTTARAKKARA
10,LAL VISWAN,Independent,103,0,103,0.07,Kerala-KOTTARAKKARA
11,NOTA,None of the Above,568,6,574,0.38,Kerala-KOTTARAKKARA
1,Adv.K.ANILKUMAR,Communist Party of India  (Marxist),45974,684,46658,38.33,Kerala-KOTTAYAM
2,THIRUVANCHOOR RADHAKRISHNAN,Indian National Congress,64309,1092,65401,53.72,Kerala-KOTTAYAM
3,MINERVA MOHAN,Bharatiya Janata Party,8501,110,8611,7.07,Kerala-KOTTAYAM
4,SREEKUMAR CHAKKALA,Bahujan Samaj Party,372,2,374,0.31,Kerala-KOTTAYAM
5,ARUN MANGATTU,Akhil Bharat Hindu Mahasabha,75,2,77,0.06,Kerala-KOTTAYAM
6,M.K.SHAHAZAD,SOCIALIST UNITY CENTRE OF INDIA (COMMUNIST),138,6,144,0.12,Kerala-KOTTAYAM
7,NOTA,None of the Above,468,5,473,0.39,Kerala-KOTTAYAM
1,VISHNUPURAM CHANDRASEKHARAN,Bharatiya Janata Party,18267,397,18664,11.73,Kerala-KOVALAM
2,NEELALOHITHADASAN NADAR,Janata Dal  (Secular),61582,1724,63306,39.79,Kerala-KOVALAM
3,Adv. M. VINCENT,Indian National Congress,72676,2192,74868,47.06,Kerala-KOVALAM
4,KANCHAMPAZHINJI SASIKUMAR,Bahujan Samaj Party,635,6,641,0.4,Kerala-KOVALAM
5,AJIL R.A.,Independent,141,6,147,0.09,Kerala-KOVALAM
6,VENGANOOR ASOKAN,Independent,268,16,284,0.18,Kerala-KOVALAM
7,PRINCE V.S.,Independent,402,15,417,0.26,Kerala-KOVALAM
8,NOTA,None of the Above,758,15,773,0.49,Kerala-KOVALAM
1,K M ABHIJITH,Indian National Congress,44759,1437,46196,33.58,Kerala-KOZHIKODE NORTH
2,M T RAMESH,Bharatiya Janata Party,30241,711,30952,22.5,Kerala-KOZHIKODE NORTH
3,Thottathil Ravindran,Communist Party of India  (Marxist),57357,1767,59124,42.98,Kerala-KOZHIKODE NORTH
4,K RAHIM,SOCIALIST UNITY CENTRE OF INDIA (COMMUNIST),152,4,156,0.11,Kerala-KOZHIKODE NORTH
5,N ABHIJITH,Independent,328,0,328,0.24,Kerala-KOZHIKODE NORTH
6,V P RAMESH,Independent,84,12,96,0.07,Kerala-KOZHIKODE NORTH
7,A RAMESH,Independent,94,10,104,0.08,Kerala-KOZHIKODE NORTH
8,URANDIYIL RAVEENDRAN,Independent,75,15,90,0.07,Kerala-KOZHIKODE NORTH
9,NOTA,None of the Above,513,3,516,0.38,Kerala-KOZHIKODE NORTH
1,NAVYA HARIDAS,Bharatiya Janata Party,24314,559,24873,20.89,Kerala-KOZHIKODE SOUTH
2,ADV. NOORBEENA RASHEED,Indian Union Muslim League,39393,705,40098,33.68,Kerala-KOZHIKODE SOUTH
3,AHAMMAD DEVARKOVIL,Indian National League,51582,975,52557,44.15,Kerala-KOZHIKODE SOUTH
4,P. HAREENDRANATH,Democratic Social Justice Party,392,18,410,0.34,Kerala-KOZHIKODE SOUTH
5,ADV. MUBEENA,Independent,503,10,513,0.43,Kerala-KOZHIKODE SOUTH
6,NOTA,None of the Above,585,18,603,0.51,Kerala-KOZHIKODE SOUTH
1,J.Mercykutty Amma,Communist Party of India  (Marxist),69906,1976,71882,45.96,Kerala-KUNDARA
2,P.C.Vishnunadh,Indian National Congress,74664,1741,76405,48.85,Kerala-KUNDARA
3,R.Rahul,SOCIALIST UNITY CENTRE OF INDIA (COMMUNIST),444,13,457,0.29,Kerala-KUNDARA
4,Vanaja Vidyadharan,Bharath Dharma Jana Sena,5983,117,6100,3.9,Kerala-KUNDARA
5,Vinod Bahuleyan,Rashtriya Janata Dal,169,3,172,0.11,Kerala-KUNDARA
6,Shiju M Varghese,Democratic Social Justice Party,181,5,186,0.12,Kerala-KUNDARA
7,Sibu Karamcodu,Anna Democratic Human Rights Movement Party of India,227,2,229,0.15,Kerala-KUNDARA
8,Santhosh Adooran,Independent,252,8,260,0.17,Kerala-KUNDARA
9,NOTA,None of the Above,692,18,710,0.45,Kerala-KUNDARA
1,ADV: V.K. SAJEEVAN,Bharatiya Janata Party,27048,624,27672,14.28,Kerala-KUNNAMANGALAM
2,E. P. ANWAR SADATH,Welfare Party Of India,1026,31,1057,0.55,Kerala-KUNNAMANGALAM
3,ABDUL VAHID,SOCIAL DEMOCRATIC PARTY OF INDIA,1276,23,1299,0.67,Kerala-KUNNAMANGALAM
4,ABDUL RAHEEM P S/o. ABDUL KAREEM,Independent,210,12,222,0.11,Kerala-KUNNAMANGALAM
5,ABDUL RAHEEM S/o. HASSAN KOYA,Independent,725,13,738,0.38,Kerala-KUNNAMANGALAM
6,DINESH PERUMANNA,Independent,72998,1864,74862,38.62,Kerala-KUNNAMANGALAM
7,DINESHAN PAKKATH,Independent,972,49,1021,0.53,Kerala-KUNNAMANGALAM
8,DINESAN MUNDAKKAL,Independent,222,3,225,0.12,Kerala-KUNNAMANGALAM
9,BABU K G,Independent,715,9,724,0.37,Kerala-KUNNAMANGALAM
10,ADV. P. T. A RAHIM,Independent,82498,2640,85138,43.93,Kerala-KUNNAMANGALAM
11,NOTA,None of the Above,851,13,864,0.45,Kerala-KUNNAMANGALAM
1,Adv. K.K.ANEESHKUMAR,Bharatiya Janata Party,27479,354,27833,17.98,Kerala-KUNNAMKULAM
2,K.JAYASANKAR,Indian National Congress,47478,1423,48901,31.58,Kerala-KUNNAMKULAM
3,A.C.MOIDEEN,Communist Party of India  (Marxist),73979,1553,75532,48.78,Kerala-KUNNAMKULAM
4,V.S.ABOOBACKER,SOCIAL DEMOCRATIC PARTY OF INDIA,1229,12,1241,0.8,Kerala-KUNNAMKULAM
5,JAMES PANADAN,Independent,258,7,265,0.17,Kerala-KUNNAMKULAM
6,MOIDEEN.K.M s/o MUHAMMED,Independent,365,15,380,0.25,Kerala-KUNNAMKULAM
7,A.K.MOIDHEENKUTTY,Independent,110,10,120,0.08,Kerala-KUNNAMKULAM
8,NOTA,None of the Above,554,5,559,0.36,Kerala-KUNNAMKULAM
1,MANIKUTTAN.A.T,Bahujan Samaj Party,197,8,205,0.13,Kerala-KUNNATHUNAD
2,RENU SURESH,Bharatiya Janata Party,7056,162,7218,4.66,Kerala-KUNNATHUNAD
3,ADV. P.V.SREENIJIN,Communist Party of India  (Marxist),51180,1171,52351,33.79,Kerala-KUNNATHUNAD
4,V.P.SAJEENDRAN,Indian National Congress,48463,1173,49636,32.04,Kerala-KUNNATHUNAD
5,KRISHNAN ERANHIKAL,SOCIAL DEMOCRATIC PARTY OF INDIA,1289,5,1294,0.84,Kerala-KUNNATHUNAD
6,DR. SUJITH.P.SURENDRAN,Twenty 20 Party,41890,811,42701,27.56,Kerala-KUNNATHUNAD
7,VELAYUDHAN.V.K,Independent,165,3,168,0.11,Kerala-KUNNATHUNAD
8,SUJITH.K.SURENDRAN,Independent,761,25,786,0.51,Kerala-KUNNATHUNAD
9,NOTA,None of the Above,539,26,565,0.36,Kerala-KUNNATHUNAD
1,R.S. ANJU,Bahujan Samaj Party,920,26,946,0.59,Kerala-KUNNATHUR
2,ULLAS KOVOOR,Revolutionary Socialist Party,64326,2320,66646,41.4,Kerala-KUNNATHUR
3,RAJIPRASAD,Bharatiya Janata Party,21121,639,21760,13.52,Kerala-KUNNATHUR
4,R. SUKUMARAN,Anna Democratic Human Rights Movement Party of India,319,7,326,0.2,Kerala-KUNNATHUR
5,ARUNKUMAR S ULIYACOVIL,Independent,310,15,325,0.2,Kerala-KUNNATHUR
6,KOVOOR KUNJUMON,Independent,66807,2629,69436,43.13,Kerala-KUNNATHUR
7,MANTHARA VELAYUDHAN,Independent,612,11,623,0.39,Kerala-KUNNATHUR
8,NOTA,None of the Above,884,38,922,0.57,Kerala-KUNNATHUR
1,POTTANKANDI ABDULLA,Indian Union Muslim League,59720,1365,61085,39.23,Kerala-KUTHUPARAMBA
2,C. SADANANDAN MASTER,Bharatiya Janata Party,20795,417,21212,13.62,Kerala-KUTHUPARAMBA
3,K.P. MOHANAN,Loktantrik Janta Dal,68472,2154,70626,45.36,Kerala-KUTHUPARAMBA
4,ABDULLA PUTHIYAPARAMBATH,Independent,379,10,389,0.25,Kerala-KUTHUPARAMBA
5,MOHANAN KUNHIPARAMBATH MEETHAL,Independent,1334,26,1360,0.87,Kerala-KUTHUPARAMBA
6,MOHANAN K.P. KAITHAVECHA PARAMBATH,Independent,515,28,543,0.35,Kerala-KUTHUPARAMBA
7,NOTA,None of the Above,489,5,494,0.32,Kerala-KUTHUPARAMBA
1,THOMAS K THOMAS,Nationalist Congress Party,55532,1847,57379,45.67,Kerala-KUTTANAD
2,Adv. JACOB ABRAHAM,Kerala Congress,49876,1987,51863,41.28,Kerala-KUTTANAD
3,THAMPI METTUTHARA,Bharath Dharma Jana Sena,14551,395,14946,11.9,Kerala-KUTTANAD
4,BIJU XAVIER,SOCIALIST UNITY CENTRE OF INDIA (COMMUNIST),369,23,392,0.31,Kerala-KUTTANAD
5,Dr. VINU,Democratic Social Justice Party,514,19,533,0.42,Kerala-KUTTANAD
6,NOTA,None of the Above,513,10,523,0.42,Kerala-KUTTANAD
1,K P KUNHAMMED KUTTI MASTER,Communist Party of India  (Marxist),77265,2878,80143,47.2,Kerala-KUTTIADI
2,PARAKKAL ABDULLA,Indian Union Muslim League,77561,2249,79810,47.01,Kerala-KUTTIADI
3,P P MURALI MASTER,Bharatiya Janata Party,8919,220,9139,5.38,Kerala-KUTTIADI
4,ABDULLA S/o POKKER,Independent,75,0,75,0.04,Kerala-KUTTIADI
5,K K KUNHAMMAD KUTTY,Independent,70,10,80,0.05,Kerala-KUTTIADI
6,V P PRATHEESH,Independent,103,5,108,0.06,Kerala-KUTTIADI
7,SURESH BABU M K,Independent,125,3,128,0.08,Kerala-KUTTIADI
8,NOTA,None of the Above,282,14,296,0.17,Kerala-KUTTIADI
1,S. K. Ananthakrishnan,Indian National Congress,34611,833,35444,21.66,Kerala-MALAMPUZHA
2,KRISHNAKUMAR.C,Bharatiya Janata Party,49301,899,50200,30.68,Kerala-MALAMPUZHA
3,A. PRABHAKARAN,Communist Party of India  (Marxist),74096,1838,75934,46.41,Kerala-MALAMPUZHA
4,K.PRASAD,SOCIALIST UNITY CENTRE OF INDIA (COMMUNIST),550,5,555,0.34,Kerala-MALAMPUZHA
5,ABDUL RAHEEM. S,Independent,412,6,418,0.26,Kerala-MALAMPUZHA
6,NOTA,None of the Above,1041,13,1054,0.64,Kerala-MALAMPUZHA
1,PALOLI ABDURAHIMAN,Communist Party of India  (Marxist),56814,1144,57958,35.82,Kerala-MALAPPURAM
2,P. UBAIDULLA,Indian Union Muslim League,91470,1696,93166,57.57,Kerala-MALAPPURAM
3,PRASOBH .T,Bahujan Samaj Party,319,2,321,0.2,Kerala-MALAPPURAM
4,AREEKKAD SETHUMADHAVAN,Bharatiya Janata Party,5755,128,5883,3.64,Kerala-MALAPPURAM
5,E.C. AYISHA,Welfare Party Of India,3090,104,3194,1.97,Kerala-MALAPPURAM
6,T.K. BOSE,SOCIALIST UNITY CENTRE OF INDIA (COMMUNIST),309,0,309,0.19,Kerala-MALAPPURAM
7,NOTA,None of the Above,983,11,994,0.61,Kerala-MALAPPURAM
1,ABHAYAN.N.A,Bahujan Samaj Party,449,23,472,0.28,Kerala-MANALUR
2,MURALI,Communist Party of India  (Marxist),76339,1998,78337,46.77,Kerala-MANALUR
3,RADHAKRISHNAN,Bharatiya Janata Party,35951,615,36566,21.83,Kerala-MANALUR
4,VIJAY HARI,Indian National Congress,46607,1854,48461,28.93,Kerala-MANALUR
5,FAISAL,SOCIAL DEMOCRATIC PARTY OF INDIA,2266,28,2294,1.37,Kerala-MANALUR
6,M K DEVARAJAN,Independent,648,12,660,0.39,Kerala-MANALUR
7,NOTA,None of the Above,712,0,712,0.43,Kerala-MANALUR
1,O.R.KELU,Communist Party of India  (Marxist),70807,1729,72536,47.54,Kerala-MANANTHAVADY
2,P.K.Jayalakshmi,Indian National Congress,61741,1513,63254,41.46,Kerala-MANANTHAVADY
3,Palliyara Mukundan,Bharatiya Janata Party,12911,231,13142,8.61,Kerala-MANANTHAVADY
4,Vijaya Cheloor,Bahujan Samaj Party,188,2,190,0.12,Kerala-MANANTHAVADY
5,Babitha Sreenu,SOCIAL DEMOCRATIC PARTY OF INDIA,1966,26,1992,1.31,Kerala-MANANTHAVADY
6,Kelu K.K. S/o Kunkan,Independent,274,14,288,0.19,Kerala-MANANTHAVADY
7,Lakshmi,Independent,374,8,382,0.25,Kerala-MANANTHAVADY
8,NOTA,None of the Above,792,5,797,0.52,Kerala-MANANTHAVADY
1,NAZAR DEBONA,Communist Party of India,62881,1382,64263,40.93,Kerala-MANJERI
2,P.R. RASMIL NATH,Bharatiya Janata Party,11030,320,11350,7.23,Kerala-MANJERI
3,Adv. U.A. LATHEEF,Indian Union Muslim League,77384,1452,78836,50.22,Kerala-MANJERI
4,PALATHINGAL ABOOBACKER,Independent,1332,9,1341,0.85,Kerala-MANJERI
5,NOTA,None of the Above,1185,17,1202,0.77,Kerala-MANJERI
1,A K M ASHRAF,Indian Union Muslim League,65190,568,65758,38.14,Kerala-MANJESHWAR
2,V V RAMESHAN,Communist Party of India  (Marxist),40098,541,40639,23.57,Kerala-MANJESHWAR
3,K SURENDRAN,Bharatiya Janata Party,64000,1013,65013,37.7,Kerala-MANJESHWAR
4,PRAVEEN KUMAR S,Anna Democratic Human Rights Movement Party of India,250,1,251,0.15,Kerala-MANJESHWAR
5,JOHN D SOUZA I,Independent,180,1,181,0.1,Kerala-MANJESHWAR
6,SURENDRAN M S/o PADMAVATHI M,Independent,196,1,197,0.11,Kerala-MANJESHWAR
7,NOTA,None of the Above,387,0,387,0.22,Kerala-MANJESHWAR
1,MANJALAMKUZHI ALI,Indian Union Muslim League,81273,1958,83231,49.46,Kerala-MANKADA
2,SAJESH ELAYIL,Bharatiya Janata Party,6469,172,6641,3.95,Kerala-MANKADA
3,Adv. T.K. RASHEEDALI,Communist Party of India  (Marxist),75322,1663,76985,45.75,Kerala-MANKADA
4,ALI S/o ALAVI HAJI,Independent,193,0,193,0.11,Kerala-MANKADA
5,ALI S/o MUSTHAFA,Independent,345,5,350,0.21,Kerala-MANKADA
6,M.ALI,Independent,81,5,86,0.05,Kerala-MANKADA
7,RASHEEDALI S/o MAMMUNNI,Independent,168,15,183,0.11,Kerala-MANKADA
8,NOTA,None of the Above,590,9,599,0.36,Kerala-MANKADA
1,SIVADASAN,Bahujan Samaj Party,813,14,827,0.54,Kerala-MANNARKAD
2,ADVOCATE. N. SAMSUDHEEN,Indian Union Muslim League,70448,1209,71657,47.11,Kerala-MANNARKAD
3,K. P. SURESH RAJ,Communist Party of India,64621,1166,65787,43.25,Kerala-MANNARKAD
4,AGALI NASEEMA P,All India Anna Dravida Munnetra Kazhagam,10282,94,10376,6.82,Kerala-MANNARKAD
5,AJIKUMAR,Independent,157,2,159,0.1,Kerala-MANNARKAD
6,JAMES MASH,Independent,968,20,988,0.65,Kerala-MANNARKAD
7,SHIBU GEORGE,Independent,97,4,101,0.07,Kerala-MANNARKAD
8,SHAMSUDDEEN S/o. YUSAF,Independent,184,8,192,0.13,Kerala-MANNARKAD
9,SHAMSUDDEEN S/o. HAMZA,Independent,479,32,511,0.34,Kerala-MANNARKAD
10,SURESH,Independent,433,7,440,0.29,Kerala-MANNARKAD
11,SURESH BABU,Independent,303,1,304,0.2,Kerala-MANNARKAD
12,NOTA,None of the Above,753,7,760,0.5,Kerala-MANNARKAD
1,ILLIKKAL AUGUSTHY,Revolutionary Socialist Party,34195,971,35166,22.67,Kerala-MATTANNUR
2,BIJU ELAKKUZHI,Bharatiya Janata Party,17815,408,18223,11.75,Kerala-MATTANNUR
3,K K SHAILAJA TEACHER,Communist Party of India  (Marxist),93007,3122,96129,61.97,Kerala-MATTANNUR
4,RAFEEK KEECHERY,SOCIAL DEMOCRATIC PARTY OF INDIA,4173,28,4201,2.71,Kerala-MATTANNUR
5,AGUSTHY N A,Independent,603,16,619,0.4,Kerala-MATTANNUR
6,NOTA,None of the Above,781,15,796,0.51,Kerala-MATTANNUR
1,M S ARUN KUMAR,Communist Party of India  (Marxist),69623,2120,71743,47.61,Kerala-MAVELIKARA
2,K K SHAJU,Indian National Congress,45246,1780,47026,31.21,Kerala-MAVELIKARA
3,K SANJU,Bharatiya Janata Party,30215,740,30955,20.54,Kerala-MAVELIKARA
4,K SASIKUMAR,SOCIALIST UNITY CENTRE OF INDIA (COMMUNIST),147,4,151,0.1,Kerala-MAVELIKARA
5,SURESH NOORANAD,Ambedkarite Party of India,158,7,165,0.11,Kerala-MAVELIKARA
6,B SUBHASH,Independent,128,3,131,0.09,Kerala-MAVELIKARA
7,NOTA,None of the Above,513,6,519,0.34,Kerala-MAVELIKARA
1,ELDHO ABRAHAM,Communist Party of India,56949,1315,58264,40.36,Kerala-MUVATTUPUZHA
2,JIJI JOSEPH,Bharatiya Janata Party,7335,192,7527,5.21,Kerala-MUVATTUPUZHA
3,Dr. MATHEW KUZHALNADAN,Indian National Congress,62417,2008,64425,44.63,Kerala-MUVATTUPUZHA
4,C. K. THAMPI,SOCIALIST UNITY CENTRE OF INDIA (COMMUNIST),170,6,176,0.12,Kerala-MUVATTUPUZHA
5,Adv. C.N. PRAKASH,Twenty 20 Party,13308,227,13535,9.38,Kerala-MUVATTUPUZHA
6,NOTA,None of the Above,421,6,427,0.3,Kerala-MUVATTUPUZHA
1,ADV. K. PRAVEEN KUMAR,Indian National Congress,77103,2155,79258,45.16,Kerala-NADAPURAM
2,M. P. RAJAN,Bharatiya Janata Party,10320,217,10537,6,Kerala-NADAPURAM
3,E. K. VIJAYAN,Communist Party of India,80571,2722,83293,47.46,Kerala-NADAPURAM
4,K. K. NASAR MASTER,SOCIAL DEMOCRATIC PARTY OF INDIA,1654,22,1676,0.95,Kerala-NADAPURAM
5,SREEDHARAN K K,National Labour Party,163,2,165,0.09,Kerala-NADAPURAM
6,T.PRAVEEN KUMAR S/O KANNAN,Independent,256,2,258,0.15,Kerala-NADAPURAM
7,NOTA,None of the Above,307,9,316,0.18,Kerala-NADAPURAM
1,C C MUKUNDHAN,Communist Party of India,71297,1633,72930,47.49,Kerala-NATTIKA
2,LOJANAN AMBATT,Bharatiya Janata Party,33190,526,33716,21.96,Kerala-NATTIKA
3,VIMAL MALLIKA VIJAYAN,Bahujan Samaj Party,357,10,367,0.24,Kerala-NATTIKA
4,ADV. SUNIL LALOOR,Indian National Congress,43379,1120,44499,28.98,Kerala-NATTIKA
5,C S JITHESHKUMAR,Independent,604,13,617,0.4,Kerala-NATTIKA
6,SIVARATHNAN ALATHI,Independent,585,10,595,0.39,Kerala-NATTIKA
7,NOTA,None of the Above,815,15,830,0.54,Kerala-NATTIKA
1,Adv. G. R. ANIL,Communist Party of India,70245,2497,72742,47.54,Kerala-NEDUMANGAD
2,Adv. J. R. PADMAKUMAR,Bharatiya Janata Party,26242,619,26861,17.56,Kerala-NEDUMANGAD
3,P. S. PRASANTH,Indian National Congress,47877,1556,49433,32.31,Kerala-NEDUMANGAD
4,BIPIN PALLIPURAM,Bahujan Samaj Party,553,10,563,0.37,Kerala-NEDUMANGAD
5,IRSHAD KANYAKULANGARA,SOCIAL DEMOCRATIC PARTY OF INDIA,1867,17,1884,1.23,Kerala-NEDUMANGAD
6,EBINU. S,Independent,132,14,146,0.1,Kerala-NEDUMANGAD
7,THATHANKODU KANNAN,Independent,165,5,170,0.11,Kerala-NEDUMANGAD
8,PRASANTH. C S/o CHANDRAN. K,Independent,145,15,160,0.1,Kerala-NEDUMANGAD
9,HARI VELLANADU,Independent,126,0,126,0.08,Kerala-NEDUMANGAD
10,NOTA,None of the Above,903,14,917,0.6,Kerala-NEDUMANGAD
1,Kummanam Rajasekharan,Bharatiya Janata Party,50856,1032,51888,35.54,Kerala-NEMOM
2,K.Muraleedharan,Indian National Congress,35532,992,36524,25.01,Kerala-NEMOM
3,D.Vijayan,Bahujan Samaj Party,352,4,356,0.24,Kerala-NEMOM
4,V.Sivankutty,Communist Party of India  (Marxist),54452,1385,55837,38.24,Kerala-NEMOM
5,Jain Wilson,Independent,164,1,165,0.11,Kerala-NEMOM
6,Balachandran Valkannadi,Independent,84,1,85,0.06,Kerala-NEMOM
7,Muraleedharan Nair,Independent,46,2,48,0.03,Kerala-NEMOM
8,Rajasekharan,Independent,46,4,50,0.03,Kerala-NEMOM
9,Arampally Vijayaraj,Independent,136,2,138,0.09,Kerala-NEMOM
10,Shine Raj.B,Independent,65,5,70,0.05,Kerala-NEMOM
11,L Sathyan Nadar,Independent,100,0,100,0.07,Kerala-NEMOM
12,NOTA,None of the Above,749,7,756,0.52,Kerala-NEMOM
1,Prakash.C,Bahujan Samaj Party,1302,48,1350,0.89,Kerala-NENMARA
2,K. Babu,Communist Party of India  (Marxist),77887,2258,80145,52.89,Kerala-NENMARA
3,Anurag .A.N,Bharath Dharma Jana Sena,16388,278,16666,11,Kerala-NENMARA
4,C.N.Vijayakrishnan,Communist Marxist Party Kerala State Committee,50491,950,51441,33.95,Kerala-NENMARA
5,Babu S/o Kunchu,Independent,841,22,863,0.57,Kerala-NENMARA
6,NOTA,None of the Above,1049,21,1070,0.71,Kerala-NENMARA
1,K. ANSALAN,Communist Party of India  (Marxist),63345,2152,65497,47.02,Kerala-NEYYATTINKARA
2,PREMAKUMAR. T. R,Bahujan Samaj Party,626,17,643,0.46,Kerala-NEYYATTINKARA
3,CHENKAL. S. RAJASEKHARAN NAIR,Bharatiya Janata Party,20475,534,21009,15.08,Kerala-NEYYATTINKARA
4,SELVARAJ. R,Indian National Congress,49451,1784,51235,36.78,Kerala-NEYYATTINKARA
5,NOTA,None of the Above,892,15,907,0.65,Kerala-NEYYATTINKARA
1,ADV. T. K ASHOKKUMAR,Bharatiya Janata Party,8440,155,8595,4.96,Kerala-NILAMBUR
2,ADV: V.V. PRAKASH,Indian National Congress,76713,1814,78527,45.34,Kerala-NILAMBUR
3,ANILA MATHEW,Indian Christian Secular Party,501,8,509,0.29,Kerala-NILAMBUR
4,K. BABU MANI,SOCIAL DEMOCRATIC PARTY OF INDIA,3249,32,3281,1.89,Kerala-NILAMBUR
5,P.V. ANVAR,Independent,79505,1722,81227,46.9,Kerala-NILAMBUR
6,SAJADURAHMAN.C.P,Independent,554,5,559,0.32,Kerala-NILAMBUR
7,NOTA,None of the Above,499,8,507,0.29,Kerala-NILAMBUR
1,Adv. B Gopalakrishnan,Bharatiya Janata Party,22065,230,22295,14.28,Kerala-OLLUR
2,Jose Valloor,Indian National Congress,54100,1051,55151,35.31,Kerala-OLLUR
3,K Rajan,Communist Party of India,75357,1300,76657,49.09,Kerala-OLLUR
4,P K Subramanian,Bahujan Samaj Party,276,6,282,0.18,Kerala-OLLUR
5,K K GEORGE KAKKASSERY,Independent,621,7,628,0.4,Kerala-OLLUR
6,Benny Kodiyatil,Independent,330,1,331,0.21,Kerala-OLLUR
7,NOTA,None of the Above,814,13,827,0.53,Kerala-OLLUR
1,Adv. K. PREMKUMAR,Communist Party of India  (Marxist),72977,1882,74859,46.45,Kerala-OTTAPALAM
2,P. VENUGOPALAN,Bharatiya Janata Party,24516,540,25056,15.55,Kerala-OTTAPALAM
3,P.P. SIVAN,Bahujan Samaj Party,654,18,672,0.42,Kerala-OTTAPALAM
4,DOCTOR P. SARIN,Indian National Congress,58399,1308,59707,37.05,Kerala-OTTAPALAM
5,NOTA,None of the Above,852,15,867,0.54,Kerala-OTTAPALAM
1,JOY THOMAS VAZHAMATTOM,Bahujan Samaj Party,355,13,368,0.27,Kerala-PALA
2,JOSE K. MANI,Kerala Congress  (M),52697,1729,54426,39.32,Kerala-PALA
3,PRAMEELADEVI .J,Bharatiya Janata Party,10533,336,10869,7.85,Kerala-PALA
4,ALBIN MATHEW,Independent,118,3,121,0.09,Kerala-PALA
5,C. V. JOHN,Independent,243,6,249,0.18,Kerala-PALA
6,THOMAS J. NIDIRY,Independent,158,2,160,0.12,Kerala-PALA
7,MANI C KAPPEN,Independent,67638,2166,69804,50.43,Kerala-PALA
8,MANI C. KURIAKOSE,Independent,1065,33,1098,0.79,Kerala-PALA
9,SREEJITH V S,Independent,191,4,195,0.14,Kerala-PALA
10,SANTHOSH PULICKAL,Independent,439,5,444,0.32,Kerala-PALA
11,SUNIL ALANCHERIL,Independent,88,5,93,0.07,Kerala-PALA
12,NOTA,None of the Above,597,7,604,0.44,Kerala-PALA
1,Adv.  C.P. PROMOD,Communist Party of India  (Marxist),35622,811,36433,25.64,Kerala-PALAKKAD
2,E.T.K. VALSAN,Bahujan Samaj Party,348,11,359,0.25,Kerala-PALAKKAD
3,E. SREEDHARAN,Bharatiya Janata Party,49155,1065,50220,35.34,Kerala-PALAKKAD
4,SHAFI PARAMBIL,Indian National Congress,53080,999,54079,38.06,Kerala-PALAKKAD
5,JAYAPRAKASH. J,Samajwadi Forward Bloc,217,4,221,0.16,Kerala-PALAKKAD
6,K. RAJESH,Akhil Bharat Hindu Mahasabha,104,1,105,0.07,Kerala-PALAKKAD
7,V. SACHIDANANDAN,Independent,152,7,159,0.11,Kerala-PALAKKAD
8,NOTA,None of the Above,514,14,528,0.37,Kerala-PALAKKAD
1,AN SAJITHA RESSAL.R.K,Indian National Congress,51273,1447,52720,32.33,Kerala-PARASSALA
2,J.R.JAYAKUMAR,Bahujan Samaj Party,775,3,778,0.48,Kerala-PARASSALA
3,KARAMANA JAYAN,Bharatiya Janata Party,29195,655,29850,18.3,Kerala-PARASSALA
4,C.K.HAREENDRAN,Communist Party of India  (Marxist),76302,2246,78548,48.16,Kerala-PARASSALA
5,SHAJU PALIYODU,Independent,400,2,402,0.25,Kerala-PARASSALA
6,SELVARAJ.J.R,Independent,159,3,162,0.1,Kerala-PARASSALA
7,NOTA,None of the Above,623,7,630,0.39,Kerala-PARASSALA
1,M.T. NIXON,Communist Party of India,59675,1288,60963,38.44,Kerala-PARAVUR
2,N.K.BIJU,Bahujan Samaj Party,708,16,724,0.46,Kerala-PARAVUR
3,V.D. SATHEESAN,Indian National Congress,80463,1801,82264,51.87,Kerala-PARAVUR
4,A.B. JAYAPRAKASH,Bharath Dharma Jana Sena,12818,146,12964,8.17,Kerala-PARAVUR
5,PRASANTH,Independent,276,3,279,0.18,Kerala-PARAVUR
6,SATHYANESAN EZHIKKARA,Independent,283,4,287,0.18,Kerala-PARAVUR
7,NOTA,None of the Above,1093,20,1113,0.7,Kerala-PARAVUR
1,V.S. JITHIN DEV,Bharatiya Janata Party,12096,302,12398,9.05,Kerala-PATHANAPURAM
2,JYOTHIKUMAR CHAMAKKALA,Indian National Congress,51350,1590,52940,38.63,Kerala-PATHANAPURAM
3,P. KRISHNAMMAL,Marxist Communist Party of India (United),2062,29,2091,1.53,Kerala-PATHANAPURAM
4,K.B. GANESH KUMAR,Kerala Congress (B),65304,1972,67276,49.09,Kerala-PATHANAPURAM
5,ADV. FAIZY. M. PASHA,SOCIAL DEMOCRATIC PARTY OF INDIA,1179,13,1192,0.87,Kerala-PATHANAPURAM
6,BAIJU PATHANAPURAM,Anna Democratic Human Rights Movement Party of India,395,16,411,0.3,Kerala-PATHANAPURAM
7,AJI KADASSERY,Independent,247,7,254,0.19,Kerala-PATHANAPURAM
8,NOTA,None of the Above,442,32,474,0.35,Kerala-PATHANAPURAM
1,Narayanan. T.P,Bahujan Samaj Party,504,13,517,0.34,Kerala-PATTAMBI
2,Muhammed Muhassin,Communist Party of India,73761,1550,75311,49.58,Kerala-PATTAMBI
3,K.M.Haridas,Bharatiya Janata Party,14231,347,14578,9.6,Kerala-PATTAMBI
4,Riyas Mukkoli,Indian National Congress,56480,857,57337,37.74,Kerala-PATTAMBI
5,Ameer Ali .S.P,SOCIAL DEMOCRATIC PARTY OF INDIA,2946,29,2975,1.96,Kerala-PATTAMBI
6,S. Mujeeb Rehman,Welfare Party Of India,776,25,801,0.53,Kerala-PATTAMBI
7,NOTA,None of the Above,378,12,390,0.26,Kerala-PATTAMBI
1,M PRADEEP KUMAR,Indian National Congress,42723,1192,43915,29.29,Kerala-PAYYANNUR
2,T  I MADHUSOODANAN,Communist Party of India  (Marxist),89909,3786,93695,62.49,Kerala-PAYYANNUR
3,Adv  K K SREEDHARAN,Bharatiya Janata Party,11048,260,11308,7.54,Kerala-PAYYANNUR
4,ABHILASH K V,Independent,334,7,341,0.23,Kerala-PAYYANNUR
5,NOTA,None of the Above,653,33,686,0.46,Kerala-PAYYANNUR
1,BIJU MATTAPPALLY,Bahujan Samaj Party,812,6,818,0.64,Kerala-PEERUMADE
2,VAZHOOR SOMAN,Communist Party of India,59518,623,60141,47.25,Kerala-PEERUMADE
3,SREENAGARI RAJAN,Bharatiya Janata Party,7085,41,7126,5.6,Kerala-PEERUMADE
4,Adv.SYRIAC THOMAS,Indian National Congress,57601,705,58306,45.81,Kerala-PEERUMADE
5,P.K GOPALAKRISHNAN,Independent,249,2,251,0.2,Kerala-PEERUMADE
6,SOMAN,Independent,247,1,248,0.19,Kerala-PEERUMADE
7,NOTA,None of the Above,400,1,401,0.32,Kerala-PEERUMADE
1,T.P.  RAMAKRISHNAN,Communist Party of India  (Marxist),82691,3332,86023,52.54,Kerala-PERAMBRA
2,ADV. K V SUDHEER,Bharatiya Janata Party,10834,331,11165,6.82,Kerala-PERAMBRA
3,ISMAIL KAMMANA,SOCIAL DEMOCRATIC PARTY OF INDIA,1441,24,1465,0.89,Kerala-PERAMBRA
4,C H EBRAHIMKUTTY S/O KUNJAMMED,Independent,61530,1901,63431,38.74,Kerala-PERAMBRA
5,IBRAHIMKUTTY M  S/O  POKKER,Independent,900,15,915,0.56,Kerala-PERAMBRA
6,V K CHANDRAN,Independent,275,5,280,0.17,Kerala-PERAMBRA
7,NOTA,None of the Above,449,9,458,0.28,Kerala-PERAMBRA
1,K V Sakkeer Hussain,Communist Party of India  (Marxist),61942,1592,63534,44.7,Kerala-PERAVOOR
2,Adv. Sunny Joseph,Indian National Congress,64784,1922,66706,46.93,Kerala-PERAVOOR
3,Smitha Jayamohan,Bharatiya Janata Party,8956,199,9155,6.44,Kerala-PERAVOOR
4,A C Jalaluddeen,SOCIAL DEMOCRATIC PARTY OF INDIA,1530,11,1541,1.08,Kerala-PERAVOOR
5,John Pallikkamalil,Secular Democratic Congress,88,4,92,0.06,Kerala-PERAVOOR
6,P K Saji,New Labour Party,104,2,106,0.07,Kerala-PERAVOOR
7,Narayanakumar,Independent,55,5,60,0.04,Kerala-PERAVOOR
8,Sakkeer E K   S/o Asiya,Independent,101,15,116,0.08,Kerala-PERAVOOR
9,Sakkeer Hussain S/o Hamsa,Independent,240,3,243,0.17,Kerala-PERAVOOR
10,Sunny Muthukulathel,Independent,60,0,60,0.04,Kerala-PERAVOOR
11,Sunny Vazhakkamalayil,Independent,121,0,121,0.09,Kerala-PERAVOOR
12,NOTA,None of the Above,392,12,404,0.28,Kerala-PERAVOOR
1,NAJEEB KANTHAPURAM,Indian Union Muslim League,75264,1266,76530,46.21,Kerala-PERINTHALMANNA
2,SUCHITHRA,Bharatiya Janata Party,7846,175,8021,4.84,Kerala-PERINTHALMANNA
3,ADV ABDUL AFSAL P T,Independent,897,9,906,0.55,Kerala-PERINTHALMANNA
4,NAJEEB KUTTEERI,Independent,822,6,828,0.5,Kerala-PERINTHALMANNA
5,MUSTHAFA  S/o MUHAMMED,Independent,469,2,471,0.28,Kerala-PERINTHALMANNA
6,MUSTHAFA P K   S/o SAIDALAVI,Independent,738,12,750,0.45,Kerala-PERINTHALMANNA
7,MUHAMMED MUSTHAFA K P,Independent,747,4,751,0.45,Kerala-PERINTHALMANNA
8,K P M MUSTHAFA   S/o MUHAMMEDALI HAJI,Independent,75067,1425,76492,46.19,Kerala-PERINTHALMANNA
9,NOTA,None of the Above,856,11,867,0.52,Kerala-PERINTHALMANNA
1,Adv ELDOSE P KUNNAPILLIL,Indian National Congress,52055,1429,53484,37.1,Kerala-PERUMBAVOOR
2,BABU JOSEPH PERUMBAVOOR,Kerala Congress  (M),49438,1147,50585,35.09,Kerala-PERUMBAVOOR
3,Adv.T P SINDHUMOL,Bharatiya Janata Party,14813,322,15135,10.5,Kerala-PERUMBAVOOR
4,AJMAL K MUJEEB,SOCIAL DEMOCRATIC PARTY OF INDIA,2483,11,2494,1.73,Kerala-PERUMBAVOOR
5,ARSHAD K M,Welfare Party Of India,1029,9,1038,0.72,Kerala-PERUMBAVOOR
6,Chithra Sukumaran,Twenty 20 Party,20153,383,20536,14.24,Kerala-PERUMBAVOOR
7,BABU JOSEPH ERUMALA,Independent,188,8,196,0.14,Kerala-PERUMBAVOOR
8,NOTA,None of the Above,686,17,703,0.49,Kerala-PERUMBAVOOR
1,M ASHISH,Bharatiya Janata Party,10782,239,11021,6.97,Kerala-PIRAVOM
2,Dr. SINDHUMOL JACOB,Kerala Congress  (M),58041,1651,59692,37.76,Kerala-PIRAVOM
3,ANOOP JACOB,Kerala Congress  (Jacob),82436,2620,85056,53.8,Kerala-PIRAVOM
4,C N MUKUNDAN,SOCIALIST UNITY CENTRE OF INDIA (COMMUNIST),440,14,454,0.29,Kerala-PIRAVOM
5,RENJU P B,Independent,200,2,202,0.13,Kerala-PIRAVOM
6,SINDHUMOL C,Independent,551,12,563,0.36,Kerala-PIRAVOM
7,NOTA,None of the Above,1085,24,1109,0.7,Kerala-PIRAVOM
1,P NANDAKUMAR,Communist Party of India  (Marxist),73331,1337,74668,51.35,Kerala-PONNANI
2,Adv. A.M. ROHITH,Indian National Congress,56694,931,57625,39.63,Kerala-PONNANI
3,ANVAR PAZHANJI,SOCIAL DEMOCRATIC PARTY OF INDIA,3041,24,3065,2.11,Kerala-PONNANI
4,GANESH VADERI,Welfare Party Of India,1820,43,1863,1.28,Kerala-PONNANI
5,SUBRAMANNIAN CHUNKAPPALLII,Bharath Dharma Jana Sena,7302,117,7419,5.1,Kerala-PONNANI
6,Adv. ROSHITH. M.P.,Independent,147,21,168,0.12,Kerala-PONNANI
7,K SADANANDAN,Independent,144,3,147,0.1,Kerala-PONNANI
8,NOTA,None of the Above,462,5,467,0.32,Kerala-PONNANI
1,Ancy George,Bahujan Samaj Party,590,6,596,0.43,Kerala-POONJAR
2,Adv. Tomy Kallany,Indian National Congress,33694,939,34633,24.76,Kerala-POONJAR
3,Adv. Sebastian Kulathunkal,Kerala Congress  (M),57630,1038,58668,41.94,Kerala-POONJAR
4,Abdu Samad,Kerala Janatha Party,253,6,259,0.19,Kerala-POONJAR
5,P.C.George Plathottam,"Kerala Janapaksham (Secular),",41049,802,41851,29.92,Kerala-POONJAR
6,M. P. Sen,Bharath Dharma Jana Sena,2928,37,2965,2.12,Kerala-POONJAR
7,Albin Mathew,Independent,201,4,205,0.15,Kerala-POONJAR
8,M. V. George,Independent,264,14,278,0.2,Kerala-POONJAR
9,Tomy Chemarapallil,Independent,91,3,94,0.07,Kerala-POONJAR
10,NOTA,None of the Above,332,13,345,0.25,Kerala-POONJAR
1,ABDURAHIMAN RANDATHANI,Indian Union Muslim League,42448,923,43371,29.66,Kerala-PUNALUR
2,AYOOR MURALI,Bharatiya Janata Party,19692,377,20069,13.72,Kerala-PUNALUR
3,P S SUPAL,Communist Party of India,78323,2105,80428,54.99,Kerala-PUNALUR
4,PRAKASH ANCHAL,Anna Democratic Human Rights Movement Party of India,397,10,407,0.28,Kerala-PUNALUR
5,K MAHESH,SOCIALIST UNITY CENTRE OF INDIA (COMMUNIST),390,17,407,0.28,Kerala-PUNALUR
6,THENMALA NAGARAJAN,Independent,254,10,264,0.18,Kerala-PUNALUR
7,SHIBU M SKARIA,Independent,594,23,617,0.42,Kerala-PUNALUR
8,NOTA,None of the Above,672,16,688,0.47,Kerala-PUNALUR
1,A. Nagesh (Parameswaran.A),Bharatiya Janata Party,34200,693,34893,22.33,Kerala-PUTHUKKAD
2,P.C. Pushpakaran,Bahujan Samaj Party,440,15,455,0.29,Kerala-PUTHUKKAD
3,K.K. Ramachandran,Communist Party of India  (Marxist),71250,2115,73365,46.94,Kerala-PUTHUKKAD
4,Sunil Anthikkad (Sunilkumar. P.V),Indian National Congress,44530,1482,46012,29.44,Kerala-PUTHUKKAD
5,Rajesh Appatt,Communist Party of India (Marxist-Leninist) Red Star,475,14,489,0.31,Kerala-PUTHUKKAD
6,NOTA,None of the Above,1053,16,1069,0.68,Kerala-PUTHUKKAD
1,ABHILASH P P,Bahujan Samaj Party,751,12,763,0.58,Kerala-PUTHUPPALLY
2,OOMMEN CHANDY,Indian National Congress,61606,1766,63372,48.08,Kerala-PUTHUPPALLY
3,JAICK C THOMAS,Communist Party of India  (Marxist),53379,949,54328,41.22,Kerala-PUTHUPPALLY
4,N HARI,Bharatiya Janata Party,11495,199,11694,8.87,Kerala-PUTHUPPALLY
5,M V CHERIAN,SOCIALIST UNITY CENTRE OF INDIA (COMMUNIST),141,5,146,0.11,Kerala-PUTHUPPALLY
6,GEORGE JOSEPH VATHAPPALLY,Independent,988,9,997,0.76,Kerala-PUTHUPPALLY
7,NOTA,None of the Above,483,14,497,0.38,Kerala-PUTHUPPALLY
1,Kanathil Jameela,Communist Party of India  (Marxist),73406,2222,75628,46.66,Kerala-QUILANDY
2,N.P. Radhakrishnan,Bharatiya Janata Party,17213,342,17555,10.83,Kerala-QUILANDY
3,N. Subramaniyan,Indian National Congress,65807,1349,67156,41.43,Kerala-QUILANDY
4,Praveen Cheruvath,SOCIALIST UNITY CENTRE OF INDIA (COMMUNIST),221,0,221,0.14,Kerala-QUILANDY
5,Jameela. P.P.,Independent,646,5,651,0.4,Kerala-QUILANDY
6,Subrahmanyan Kanaran,Independent,380,1,381,0.24,Kerala-QUILANDY
7,NOTA,None of the Above,482,10,492,0.3,Kerala-QUILANDY
1,Adv. Anumol N.,Bahujan Samaj Party,1132,27,1159,0.91,Kerala-RANNI
2,Adv. Pramod Narayan,Kerala Congress  (M),51111,1558,52669,41.22,Kerala-RANNI
3,Rinku Cherian,Indian National Congress,49398,1986,51384,40.21,Kerala-RANNI
4,Asharaf Pezhumkattil,SOCIAL DEMOCRATIC PARTY OF INDIA,875,11,886,0.69,Kerala-RANNI
5,Jomon Kochethu,Rashtriya Janata Dal,336,3,339,0.27,Kerala-RANNI
6,K. Padmakumar,Bharath Dharma Jana Sena,19043,544,19587,15.33,Kerala-RANNI
7,Aji B. Ranni,Independent,269,13,282,0.22,Kerala-RANNI
8,Benny Puthenparampil (Thomas Mathew),Independent,818,24,842,0.66,Kerala-RANNI
9,Adv. Manju K. Nair (Kottarathil),Independent,194,4,198,0.15,Kerala-RANNI
10,NOTA,None of the Above,422,9,431,0.34,Kerala-RANNI
1,AYYAPPAN KUTTY. T.C.,Bahujan Samaj Party,875,8,883,0.58,Kerala-SHORNUR
2,FIROZ BABU.T.H,Indian National Congress,36940,786,37726,24.83,Kerala-SHORNUR
3,P. MAMMIKUTTY,Communist Party of India  (Marxist),72641,1759,74400,48.98,Kerala-SHORNUR
4,SANDEEP VARIER,Bharatiya Janata Party,36317,656,36973,24.34,Kerala-SHORNUR
5,MUHAMMAD MUSTHAFA,SOCIAL DEMOCRATIC PARTY OF INDIA,1242,9,1251,0.82,Kerala-SHORNUR
6,NOTA,None of the Above,668,10,678,0.45,Kerala-SHORNUR
1,C.K JANU,Bharatiya Janata Party,14934,264,15198,9.08,Kerala-SULTHANBATHERY
2,I.C BALAKRISHNAN,Indian National Congress,79152,1925,81077,48.42,Kerala-SULTHANBATHERY
3,M.S VISWANATHAN,Communist Party of India  (Marxist),67616,1639,69255,41.36,Kerala-SULTHANBATHERY
4,ONDAN PANIYAN,Independent,730,12,742,0.44,Kerala-SULTHANBATHERY
5,NOTA,None of the Above,1142,18,1160,0.69,Kerala-SULTHANBATHERY
1,M V GOVINDAN MASTER,Communist Party of India  (Marxist),89248,3622,92870,52.14,Kerala-TALIPARAMBA
2,A P GANGADHARAN,Bharatiya Janata Party,12737,321,13058,7.33,Kerala-TALIPARAMBA
3,ADV. V P ABDUL RASHEED,Indian National Congress,68539,1642,70181,39.4,Kerala-TALIPARAMBA
4,ABDUL RASHEED  S/o ISMAIL,Independent,364,1,365,0.2,Kerala-TALIPARAMBA
5,GOVINDAN KARAYAPATH,Independent,138,12,150,0.08,Kerala-TALIPARAMBA
6,C BALAKRISHNAN YADAV,Independent,186,5,191,0.11,Kerala-TALIPARAMBA
7,SHIJITH K O P,Independent,497,11,508,0.29,Kerala-TALIPARAMBA
8,NOTA,None of the Above,773,16,789,0.44,Kerala-TALIPARAMBA
1,K.NARAYANAN MASTER,Bharatiya Janata Party,10371,219,10590,6.94,Kerala-TANUR
2,P.K.FIROS,Indian Union Muslim League,68810,909,69719,45.7,Kerala-TANUR
3,MUEENUDHEEN,Bahujan Samaj Party,183,0,183,0.12,Kerala-TANUR
4,V.ABDURAHIMAN,National Secular Conference,69633,1071,70704,46.34,Kerala-TANUR
5,ABDURAHIMAN.V S/o Alavi Haji,Independent,177,2,179,0.12,Kerala-TANUR
6,V.ABDURAHIMAN S/o Kathiyamu,Independent,220,4,224,0.15,Kerala-TANUR
7,ABDURAHIMAN.V S/o Muhammed,Independent,100,2,102,0.07,Kerala-TANUR
8,KUNHI MOHAMED MUTHANIKKAD BAPPUTTY,Independent,207,6,213,0.14,Kerala-TANUR
9,FIROZ S/o Avarankutty,Independent,72,1,73,0.05,Kerala-TANUR
10,FIROZ S/o Kunhumarakkar,Independent,244,3,247,0.16,Kerala-TANUR
11,NOTA,None of the Above,328,8,336,0.22,Kerala-TANUR
1,JAYAPRAKASAN K.P.,Bharatiya Janata Party,18237,228,18465,14.06,Kerala-TARUR
2,K.A.SHEEBA,Indian National Congress,42271,942,43213,32.9,Kerala-TARUR
3,P.P.SUMOD,Communist Party of India  (Marxist),66560,1184,67744,51.58,Kerala-TARUR
4,C.A.USHAKUMARI,Welfare Party Of India,956,29,985,0.75,Kerala-TARUR
5,NOTA,None of the Above,928,12,940,0.72,Kerala-TARUR
1,M. P. ARAVINDAKSHAN,Indian National Congress,43811,1198,45009,33.84,Kerala-THALASSERY
2,Adv. A. N. SHAMSEER,Communist Party of India  (Marxist),79628,2182,81810,61.52,Kerala-THALASSERY
3,SHAMSEER IBRAHIM,Welfare Party Of India,1945,18,1963,1.48,Kerala-THALASSERY
4,ARAVINDHAKSHAN S/o KAUSU,Independent,522,11,533,0.4,Kerala-THALASSERY
5,C. O. T. NASEER,Independent,1127,36,1163,0.87,Kerala-THALASSERY
6,HARIDASAN,Independent,189,9,198,0.15,Kerala-THALASSERY
7,NOTA,None of the Above,2283,30,2313,1.74,Kerala-THALASSERY
1,FIROS KUNNAMPARAMBIL,Indian National Congress,66750,1044,67794,44.77,Kerala-THAVANUR
2,HASSAN CHIYANOOR,SOCIAL DEMOCRATIC PARTY OF INDIA,1738,9,1747,1.15,Kerala-THAVANUR
3,RAMESH KOTTAYAPURATH,Bharath Dharma Jana Sena,9756,158,9914,6.55,Kerala-THAVANUR
4,DR.K.T.JALEEL,Independent,68935,1423,70358,46.46,Kerala-THAVANUR
5,JALEEL S/O. MUHAMMAD KUTTY,Independent,306,2,308,0.2,Kerala-THAVANUR
6,FIROS KUNNATHPARAMBIL,Independent,191,3,194,0.13,Kerala-THAVANUR
7,FIROS NELLAMKUNNATH,Independent,75,4,79,0.05,Kerala-THAVANUR
8,FIROS PARUVINGAL,Independent,173,2,175,0.12,Kerala-THAVANUR
9,MOHAMMED FIROS NURUKKUPRAMBIL,Independent,148,4,152,0.1,Kerala-THAVANUR
10,VELLARIKKAT MOHAMMED RAFI,Independent,220,7,227,0.15,Kerala-THAVANUR
11,NOTA,None of the Above,471,7,478,0.32,Kerala-THAVANUR
1,ASHOKAN KULANADA,Bharatiya Janata Party,21954,720,22674,16.25,Kerala-THIRUVALLA
2,Adv. MATHEW T THOMAS,Janata Dal  (Secular),60036,2142,62178,44.56,Kerala-THIRUVALLA
3,RAJENDRADAS,Bahujan Samaj Party,1049,25,1074,0.77,Kerala-THIRUVALLA
4,KUNJU KOSHY PAUL,Kerala Congress,48665,2092,50757,36.37,Kerala-THIRUVALLA
5,VINOD KUMAR,Democratic Social Justice Party,377,3,380,0.27,Kerala-THIRUVALLA
6,Adv. THOMAS MATHEW (ROY),Independent,1423,38,1461,1.05,Kerala-THIRUVALLA
7,K .P YESUDAS,Independent,180,16,196,0.14,Kerala-THIRUVALLA
8,SURENDRAN KOTTOORATHIL,Independent,212,4,216,0.15,Kerala-THIRUVALLA
9,NOTA,None of the Above,570,38,608,0.44,Kerala-THIRUVALLA
1,C. P. Cheriya Muhammed,Indian Union Muslim League,61469,1755,63224,44.21,Kerala-THIRUVAMBADY
2,Baby Ambattu,Bharatiya Janata Party,7632,162,7794,5.45,Kerala-THIRUVAMBADY
3,Linto Joseph,Communist Party of India  (Marxist),66017,1850,67867,47.46,Kerala-THIRUVAMBADY
4,K. P. Cheriya Muhammed S/o Kunhoyi,Independent,1100,21,1121,0.78,Kerala-THIRUVAMBADY
5,Prof.George Mathew Thottathimyalil,Independent,74,4,78,0.05,Kerala-THIRUVAMBADY
6,Linto Joseph S/o Sali,Independent,550,29,579,0.4,Kerala-THIRUVAMBADY
7,Lenilal. T. D.,Independent,78,2,80,0.06,Kerala-THIRUVAMBADY
8,Sunny. V. Joseph,Independent,1800,47,1847,1.29,Kerala-THIRUVAMBADY
9,NOTA,None of the Above,413,6,419,0.29,Kerala-THIRUVAMBADY
1,KRISHNAKUMAR G,Bharatiya Janata Party,34371,625,34996,27.29,Kerala-THIRUVANANTHAPURAM
2,V .S .Sivakumar,Indian National Congress,40804,855,41659,32.49,Kerala-THIRUVANANTHAPURAM
3,Adv.ANTONY RAJU,Janadhipathiya Kerala Congress,47950,798,48748,38.01,Kerala-THIRUVANANTHAPURAM
4,A .Saboora,SOCIALIST UNITY CENTRE OF INDIA (COMMUNIST),356,10,366,0.29,Kerala-THIRUVANANTHAPURAM
5,ABHILASH VADAKKAN,Independent,433,3,436,0.34,Kerala-THIRUVANANTHAPURAM
6,ANTONY RAJU S/o Raju,Independent,185,5,190,0.15,Kerala-THIRUVANANTHAPURAM
7,KRISHNAKUMAR T .S S/o Sankarankutty,Independent,87,2,89,0.07,Kerala-THIRUVANANTHAPURAM
8,CHALA MOHANAN D,Independent,238,7,245,0.19,Kerala-THIRUVANANTHAPURAM
9,RAJU ANTONY,Independent,281,8,289,0.23,Kerala-THIRUVANANTHAPURAM
10,SIVAKUMAR. K S/o Kumara Swamy,Independent,161,3,164,0.13,Kerala-THIRUVANANTHAPURAM
11,NOTA,None of the Above,1034,20,1054,0.82,Kerala-THIRUVANANTHAPURAM
1,Prof. K I ANTONY,Kerala Congress  (M),45762,1474,47236,34.03,Kerala-THODUPUZHA
2,LEETHESH P T,Bahujan Samaj Party,928,6,934,0.67,Kerala-THODUPUZHA
3,SHYAMRAJ P,Bharatiya Janata Party,20758,505,21263,15.32,Kerala-THODUPUZHA
4,P J JOSEPH,Kerala Congress,64895,2600,67495,48.63,Kerala-THODUPUZHA
5,T R SREEDHARAN,SOCIALIST UNITY CENTRE OF INDIA (COMMUNIST),263,10,273,0.2,Kerala-THODUPUZHA
6,M T THOMAS,Independent,556,6,562,0.4,Kerala-THODUPUZHA
7,PARTHASARADHI K,Independent,365,5,370,0.27,Kerala-THODUPUZHA
8,NOTA,None of the Above,640,34,674,0.49,Kerala-THODUPUZHA
1,Adv.P.T.THOMAS,Indian National Congress,58707,1132,59839,43.82,Kerala-THRIKKAKARA
2,P.M.SHIBU,Bahujan Samaj Party,322,9,331,0.24,Kerala-THRIKKAKARA
3,S SAJI,Bharatiya Janata Party,15218,265,15483,11.34,Kerala-THRIKKAKARA
4,KRISHNAPRASAD,Democratic Social Justice Party,174,7,181,0.13,Kerala-THRIKKAKARA
5,Dr.TERRY THOMAS,Twenty 20 Party,13773,124,13897,10.18,Kerala-THRIKKAKARA
6,JINU,Independent,143,0,143,0.1,Kerala-THRIKKAKARA
7,Dr.J.JACOB,Independent,44894,616,45510,33.32,Kerala-THRIKKAKARA
8,BINOJ,Independent,130,4,134,0.1,Kerala-THRIKKAKARA
9,SUBIN,Independent,55,4,59,0.04,Kerala-THRIKKAKARA
10,RIYAS YUSUF,Independent,294,4,298,0.22,Kerala-THRIKKAKARA
11,NOTA,None of the Above,688,7,695,0.51,Kerala-THRIKKAKARA
1,K. BABU,Indian National Congress,65355,520,65875,42.14,Kerala-THRIPUNITHURA
2,Dr. K. S. RADHAKRISHNAN,Bharatiya Janata Party,23578,178,23756,15.2,Kerala-THRIPUNITHURA
3,Adv. M. SWARAJ,Communist Party of India  (Marxist),64325,558,64883,41.51,Kerala-THRIPUNITHURA
4,ARUN BABU. P. C.,Shiv Sena,231,1,232,0.15,Kerala-THRIPUNITHURA
5,C. B. ASHOKAN,SOCIALIST UNITY CENTRE OF INDIA (COMMUNIST),172,1,173,0.11,Kerala-THRIPUNITHURA
6,K. P. AYAPPEN,Independent,88,0,88,0.06,Kerala-THRIPUNITHURA
7,RAJESH PAIROAD,Independent,200,1,201,0.13,Kerala-THRIPUNITHURA
8,NOTA,None of the Above,1089,10,1099,0.7,Kerala-THRIPUNITHURA
1,PADMAJA VENUGOPAL,Indian National Congress,41996,1321,43317,33.52,Kerala-THRISSUR
2,P BALACHANDRAN,Communist Party of India,43048,1215,44263,34.25,Kerala-THRISSUR
3,SURESH GOPI,Bharatiya Janata Party,39616,841,40457,31.3,Kerala-THRISSUR
4,THRISSUR MUKUNDAN,Indian Gandhiyan Party,217,8,225,0.17,Kerala-THRISSUR
5,AJITH MENON PONNEMKATTIL,Independent,243,9,252,0.19,Kerala-THRISSUR
6,NOTA,None of the Above,712,11,723,0.56,Kerala-THRISSUR
1,V .T BALRAM,Indian National Congress,65629,1169,66798,43.86,Kerala-THRITHALA
2,RAJAGOPAL THRITHALA,Bahujan Samaj Party,326,7,333,0.22,Kerala-THRITHALA
3,M. B RAJESH,Communist Party of India  (Marxist),68468,1346,69814,45.84,Kerala-THRITHALA
4,ADV:SANKU T DAS,Bharatiya Janata Party,12645,206,12851,8.44,Kerala-THRITHALA
5,ABDUL NAZAR M K,SOCIAL DEMOCRATIC PARTY OF INDIA,1572,10,1582,1.04,Kerala-THRITHALA
6,NOORUDHEEN E V,Independent,69,1,70,0.05,Kerala-THRITHALA
7,BALARAMAN  K            S/O KUNJUNNI,Independent,49,8,57,0.04,Kerala-THRITHALA
8,T .T BALARAMAN     S/O KRISHNAN NAIR,Independent,42,3,45,0.03,Kerala-THRITHALA
9,RAJESH             S/O RAMAN E,Independent,83,8,91,0.06,Kerala-THRITHALA
10,SREENIVAS KURUPPATH,Independent,136,0,136,0.09,Kerala-THRITHALA
11,HUSSAIN THATTATHAZHATH,Independent,106,1,107,0.07,Kerala-THRITHALA
12,NOTA,None of the Above,422,5,427,0.28,Kerala-THRITHALA
1,Dr. ABDUL SALAM M,Bharatiya Janata Party,8933,164,9097,5.33,Kerala-TIRUR
2,Adv. GAFOOR P LILLIS,Communist Party of India  (Marxist),73947,1153,75100,43.98,Kerala-TIRUR
3,KURUKKOLI MOIDEEN,Indian Union Muslim League,80906,1408,82314,48.21,Kerala-TIRUR
4,ASHRAF,SOCIAL DEMOCRATIC PARTY OF INDIA,2699,13,2712,1.59,Kerala-TIRUR
5,ABOOBACKER SIDHEEK,Independent,233,7,240,0.14,Kerala-TIRUR
6,ABDUL GAFOOR PULIKKAL,Independent,68,0,68,0.04,Kerala-TIRUR
7,ABDUL GAFOOR VALIYA PEEDIKAKKAL,Independent,33,4,37,0.02,Kerala-TIRUR
8,ABDUL MAHROOF A.K,Independent,105,6,111,0.07,Kerala-TIRUR
9,MOIDEEN MEENTHRATHAKATH,Independent,472,5,477,0.28,Kerala-TIRUR
10,MOIDEEN VALIYAKATH,Independent,167,2,169,0.1,Kerala-TIRUR
11,NOTA,None of the Above,416,1,417,0.24,Kerala-TIRUR
1,K P A MAJEED,Indian Union Muslim League,72579,920,73499,49.74,Kerala-TIRURANGADI
2,ABDUL MAJEED PANAKKAL,Bahujan Samaj Party,300,3,303,0.21,Kerala-TIRURANGADI
3,KALLIYATH SATHAR HAJI,Bharatiya Janata Party,8128,186,8314,5.63,Kerala-TIRURANGADI
4,MOOSA JARATHINGAL,Swaraj India,269,5,274,0.19,Kerala-TIRURANGADI
5,ABDURAHIM NAHA,Independent,119,1,120,0.08,Kerala-TIRURANGADI
6,CHANDRAN,Independent,129,3,132,0.09,Kerala-TIRURANGADI
7,NIYAS,Independent,480,7,487,0.33,Kerala-TIRURANGADI
8,NIYAS PULIKKALAKATH,Independent,63159,762,63921,43.26,Kerala-TIRURANGADI
9,NOTA,None of the Above,715,6,721,0.49,Kerala-TIRURANGADI
1,M RAJAGOPALAN,Communist Party of India  (Marxist),82556,3595,86151,53.71,Kerala-TRIKARIPUR
2,SHIBIN T V,Bharatiya Janata Party,10621,340,10961,6.83,Kerala-TRIKARIPUR
3,M P JOSEPH,Kerala Congress,58200,1814,60014,37.41,Kerala-TRIKARIPUR
4,T MAHESH MASTER,Welfare Party Of India,799,18,817,0.51,Kerala-TRIKARIPUR
5,LIYAKATHALI P,SOCIAL DEMOCRATIC PARTY OF INDIA,1188,23,1211,0.75,Kerala-TRIKARIPUR
6,SUDHAN VELLARIKKUND,Anna Democratic Human Rights Movement Party of India,104,12,116,0.07,Kerala-TRIKARIPUR
7,JOY JOHN,Independent,352,10,362,0.23,Kerala-TRIKARIPUR
8,M V JOSEPH,Independent,192,26,218,0.14,Kerala-TRIKARIPUR
9,NOTA,None of the Above,521,37,558,0.35,Kerala-TRIKARIPUR
1,C H KUNHAMBU,Communist Party of India  (Marxist),76733,1931,78664,47.58,Kerala-UDMA
2,BALAKRISHNAN PERIYE,Indian National Congress,64117,1225,65342,39.52,Kerala-UDMA
3,A VELAYUDHAN,Bharatiya Janata Party,19978,382,20360,12.31,Kerala-UDMA
4,GOVINDAN B ALINTHAZE,Ambedkarite Party of India,189,5,194,0.12,Kerala-UDMA
5,KUNHAMBU K  S/o Kuttappan K C,Independent,134,6,140,0.08,Kerala-UDMA
6,RAMESHAN K,Independent,204,3,207,0.13,Kerala-UDMA
7,NOTA,None of the Above,430,4,434,0.26,Kerala-UDMA
1,ADV. E.M. AUGUSTHY,Indian National Congress,38207,869,39076,31.21,Kerala-UDUMBANCHOLA
2,A C BIJU,Bahujan Samaj Party,858,9,867,0.69,Kerala-UDUMBANCHOLA
3,M. M. MANI,Communist Party of India  (Marxist),75938,1443,77381,61.8,Kerala-UDUMBANCHOLA
4,SANTHOSH MADHAVAN,Bharath Dharma Jana Sena,7121,87,7208,5.76,Kerala-UDUMBANCHOLA
5,NOTA,None of the Above,679,8,687,0.55,Kerala-UDUMBANCHOLA
1,ADVOCATE M. RAJESH KUMAR,Bharatiya Janata Party,10033,192,10225,7.48,Kerala-VADAKARA
2,MANAYATH CHANDRAN,Loktantrik Janta Dal,55672,1930,57602,42.15,Kerala-VADAKARA
3,MUSTHAFA PALERI,SOCIAL DEMOCRATIC PARTY OF INDIA,2820,16,2836,2.08,Kerala-VADAKARA
4,K.K.REMA,Revolutionary Marxist Party of India,63418,1675,65093,47.63,Kerala-VADAKARA
5,GANGADHARAN MADAPPALLY,Independent,182,4,186,0.14,Kerala-VADAKARA
6,VELLUPARAMBATH CHANDRAN,Independent,60,3,63,0.05,Kerala-VADAKARA
7,RAMA KUNIYIL,Independent,112,14,126,0.09,Kerala-VADAKARA
8,RAMA CHERIYA KAYYIL,Independent,50,2,52,0.04,Kerala-VADAKARA
9,K.T.K RAMA PADANNAYIL,Independent,128,9,137,0.1,Kerala-VADAKARA
10,NOTA,None of the Above,347,6,353,0.26,Kerala-VADAKARA
1,Akhiljith Kallara,Bahujan Samaj Party,704,22,726,0.57,Kerala-VAIKOM
2,C.K Asha,Communist Party of India,69483,1905,71388,55.96,Kerala-VAIKOM
3,Dr.P.R Sona,Indian National Congress,41108,1158,42266,33.13,Kerala-VAIKOM
4,Ajitha Sabu,Bharath Dharma Jana Sena,11708,245,11953,9.37,Kerala-VAIKOM
5,Bindu,Bahujan Dravida Party,251,7,258,0.2,Kerala-VAIKOM
6,T.K Sabu,SOCIALIST UNITY CENTRE OF INDIA (COMMUNIST),140,12,152,0.12,Kerala-VAIKOM
7,Kuttan Kattachira,Independent,150,13,163,0.13,Kerala-VAIKOM
8,NOTA,None of the Above,657,13,670,0.53,Kerala-VAIKOM
1,ABDUL HAMEED MASTER,Indian Union Muslim League,70342,1481,71823,47.43,Kerala-VALLIKKUNNU
2,PEETHAMBARAN PALAT,Bharatiya Janata Party,19304,549,19853,13.11,Kerala-VALLIKKUNNU
3,SASI KIZHAKKAN,Bahujan Samaj Party,845,36,881,0.58,Kerala-VALLIKKUNNU
4,Prof. A.P. ABDUL VAHAB,Indian National League,56401,1306,57707,38.11,Kerala-VALLIKKUNNU
5,NOTA,None of the Above,1141,9,1150,0.76,Kerala-VALLIKKUNNU
1,Anad Jayan,Indian National Congress,61071,1824,62895,42.92,Kerala-VAMANAPURAM
2,Adv. D. K. Murali,Communist Party of India  (Marxist),70468,2669,73137,49.91,Kerala-VAMANAPURAM
3,Santhosh T.,Bahujan Samaj Party,542,10,552,0.38,Kerala-VAMANAPURAM
4,Ajmal Ismail,SOCIAL DEMOCRATIC PARTY OF INDIA,2314,11,2325,1.59,Kerala-VAMANAPURAM
5,Ashokan T.  Vamanapuram,Ambedkarite Party of India,294,7,301,0.21,Kerala-VAMANAPURAM
6,Thazhava Sahadevan,Bharath Dharma Jana Sena,5511,92,5603,3.82,Kerala-VAMANAPURAM
7,Attukal Aji,Independent,397,23,420,0.29,Kerala-VAMANAPURAM
8,Navas C. M.,Independent,101,33,134,0.09,Kerala-VAMANAPURAM
9,Bharathanoor Maniraj,Independent,129,3,132,0.09,Kerala-VAMANAPURAM
10,R. Murali,Independent,293,17,310,0.21,Kerala-VAMANAPURAM
11,NOTA,None of the Above,695,21,716,0.49,Kerala-VAMANAPURAM
1,Anu M.C,Bahujan Samaj Party,1920,28,1948,1.44,Kerala-VARKALA
2,Adv. V Joy,Communist Party of India  (Marxist),66874,1942,68816,50.89,Kerala-VARKALA
3,Adv. BRM Shafeer,Indian National Congress,49849,1146,50995,37.71,Kerala-VARKALA
4,Aji S,Bharath Dharma Jana Sena,10957,257,11214,8.29,Kerala-VARKALA
5,Anilkumar P,Democratic Human Rights Movement Party,455,5,460,0.34,Kerala-VARKALA
6,Prince,Independent,615,43,658,0.49,Kerala-VARKALA
7,Shefeer,Independent,313,10,323,0.24,Kerala-VARKALA
8,NOTA,None of the Above,801,14,815,0.6,Kerala-VARKALA
1,Adv.V.K.PRASANTH,Communist Party of India  (Marxist),59193,1918,61111,44.4,Kerala-VATTIYOORKAVU
2,N.MURALI,Bahujan Samaj Party,413,6,419,0.3,Kerala-VATTIYOORKAVU
3,Adv.V.V.RAJESH,Bharatiya Janata Party,38558,1038,39596,28.77,Kerala-VATTIYOORKAVU
4,Adv.VEENA.S.NAIR,Indian National Congress,34292,1163,35455,25.76,Kerala-VATTIYOORKAVU
5,A.SHYJU,SOCIALIST UNITY CENTRE OF INDIA (COMMUNIST),200,1,201,0.15,Kerala-VATTIYOORKAVU
6,NOTA,None of the Above,844,10,854,0.62,Kerala-VATTIYOORKAVU
1,KEERAN,Bahujan Samaj Party,1057,3,1060,0.81,Kerala-VENGARA
2,P.K KUNJHALIKUTTY,Indian Union Muslim League,69283,1098,70381,53.5,Kerala-VENGARA
3,P. JIJI,Communist Party of India  (Marxist),39150,635,39785,30.24,Kerala-VENGARA
4,PREMAN MASTER,Bharatiya Janata Party,5853,115,5968,4.54,Kerala-VENGARA
5,ANANNYAHKUMARI ALEX,Democratic Social Justice Party,132,3,135,0.1,Kerala-VENGARA
6,E.K. KUNHAHAMEDKUTTY MASTER,Welfare Party Of India,1984,67,2051,1.56,Kerala-VENGARA
7,ADIL ABDURAHIMAN THANGAL,Independent,124,5,129,0.1,Kerala-VENGARA
8,SABAH KUNDUPUZHAKKAL,Independent,11149,106,11255,8.56,Kerala-VENGARA
9,NOTA,None of the Above,779,8,787,0.6,Kerala-VENGARA
1,K.N. Unnikrishnan,Communist Party of India  (Marxist),52712,1146,53858,41.24,Kerala-VYPEN
2,Deepak Joy,Indian National Congress,44710,947,45657,34.96,Kerala-VYPEN
3,Adv.K.S. Shaiju,Bharatiya Janata Party,13385,155,13540,10.37,Kerala-VYPEN
4,Dr.Job Chakalakal,Twenty 20 Party,16540,167,16707,12.79,Kerala-VYPEN
5,Dr.M.K. Mukundan,Independent,304,5,309,0.24,Kerala-VYPEN
6,NOTA,None of the Above,518,7,525,0.4,Kerala-VYPEN
1,Anil Akkara,Indian National Congress,64089,1769,65858,38.77,Kerala-WADAKKANCHERY
2,T.S Ullas Babu,Bharatiya Janata Party,21408,339,21747,12.8,Kerala-WADAKKANCHERY
3,Xavier Chittilappilly,Communist Party of India  (Marxist),79216,1810,81026,47.7,Kerala-WADAKKANCHERY
4,Haji Aboobaker Kundukadan,Independent,378,10,388,0.23,Kerala-WADAKKANCHERY
5,NOTA,None of the Above,829,13,842,0.5,Kerala-WADAKKANCHERY
1,A P ANILKUMAR,Indian National Congress,85776,1639,87415,51.44,Kerala-WANDOOR
2,MIDHUNA P,Communist Party of India  (Marxist),70548,1304,71852,42.28,Kerala-WANDOOR
3,Dr. P C VIJAYAN,Bharatiya Janata Party,6929,128,7057,4.15,Kerala-WANDOOR
4,KRISHNAN C,Welfare Party Of India,2843,100,2943,1.73,Kerala-WANDOOR
5,NOTA,None of the Above,660,4,664,0.39,Kerala-WANDOOR
1,R. BASKAR @ DATCHANAMOURTTY,All India N.R. Congress,17439,419,17858,54.32,Puducherry-ARIANKUPPAM
2,T. DJEAMOURTHY,Indian National Congress,11209,231,11440,34.8,Puducherry-ARIANKUPPAM
3,V INDUMATHY,Indiya Jananayaka Katchi,52,0,52,0.16,Puducherry-ARIANKUPPAM
4,SUNDARAVADIVELU,Naam Tamilar Katchi,1086,8,1094,3.33,Puducherry-ARIANKUPPAM
5,A MOHAMAD KASSIM,SOCIAL DEMOCRATIC PARTY OF INDIA,67,1,68,0.21,Puducherry-ARIANKUPPAM
6,V RUTHRAKUMARAN,Makkal Needhi Maiam,1026,29,1055,3.21,Puducherry-ARIANKUPPAM
7,LOURDUSAMY,Desiya Murpokku Dravida Kazhagam,53,2,55,0.17,Puducherry-ARIANKUPPAM
8,R KARTHICK,Independent,46,1,47,0.14,Puducherry-ARIANKUPPAM
9,S KUMARAVELU,Independent,818,5,823,2.5,Puducherry-ARIANKUPPAM
10,NOTA,None of the Above,374,8,382,1.16,Puducherry-ARIANKUPPAM
1,R SENTHILKUMAR,Dravida Munnetra Kazhagam,11589,200,11789,44.56,Puducherry-BAHOUR
2,N DHANAVELOU,All India N.R. Congress,11311,267,11578,43.76,Puducherry-BAHOUR
3,S GNANAPRAGASH,Naam Tamilar Katchi,443,6,449,1.7,Puducherry-BAHOUR
4,A THIYAGU,Indiya Jananayaka Katchi,14,0,14,0.05,Puducherry-BAHOUR
5,C DINESH,Makkal Needhi Maiam,125,1,126,0.48,Puducherry-BAHOUR
6,S BASKARAN,Puducherry Development  Party,19,1,20,0.08,Puducherry-BAHOUR
7,P VELMURUGAN,Amma Makkal Munnettra Kazagam,1390,18,1408,5.32,Puducherry-BAHOUR
8,P VELU,Desiya Murpokku Dravida Kazhagam,79,4,83,0.31,Puducherry-BAHOUR
9,T PALANISAMY,Independent,60,1,61,0.23,Puducherry-BAHOUR
10,N PONNAMMAL,Independent,72,2,74,0.28,Puducherry-BAHOUR
11,A MURUGAN,Independent,25,1,26,0.1,Puducherry-BAHOUR
12,RAMALINGAM V,Independent,62,2,64,0.24,Puducherry-BAHOUR
13,V RUTHIRAMOORTHY,Independent,461,9,470,1.78,Puducherry-BAHOUR
14,NOTA,None of the Above,293,1,294,1.11,Puducherry-BAHOUR
1,D. ARVINDHAN,Bahujan Samaj Party,89,1,90,0.29,Puducherry-EMBALAM
2,M CANDASSAMY,Indian National Congress,13172,212,13384,43.56,Puducherry-EMBALAM
3,U LAKSHMIKANDHAN,All India N.R. Congress,15371,253,15624,50.85,Puducherry-EMBALAM
4,N SUTHA,Naam Tamilar Katchi,583,7,590,1.92,Puducherry-EMBALAM
5,N SOMANATHAN,Makkal Needhi Maiam,608,10,618,2.01,Puducherry-EMBALAM
6,P. VAITHILINGAM,Indiya Jananayaka Katchi,23,0,23,0.07,Puducherry-EMBALAM
7,S. STEEBAN,Desiya Murpokku Dravida Kazhagam,120,0,120,0.39,Puducherry-EMBALAM
8,A MURUGAIYAN,Independent,79,2,81,0.26,Puducherry-EMBALAM
9,NOTA,None of the Above,189,4,193,0.63,Puducherry-EMBALAM
1,V. AROUMOUGAME @ AKD,All India N.R. Congress,21223,618,21841,74.77,Puducherry-INDIRA NAGAR
2,M. Kannan,Indian National Congress,3239,71,3310,11.33,Puducherry-INDIRA NAGAR
3,K. Ezhumalai,Desiya Murpokku Dravida Kazhagam,153,3,156,0.53,Puducherry-INDIRA NAGAR
4,D. Ejoumale,Indiya Jananayaka Katchi,147,5,152,0.52,Puducherry-INDIRA NAGAR
5,P. SAKTHIVEL,Makkal Needhi Maiam,1199,19,1218,4.17,Puducherry-INDIRA NAGAR
6,T. Devika,Naam Tamilar Katchi,1758,16,1774,6.07,Puducherry-INDIRA NAGAR
7,D. Mohan,Amma Makkal Munnettra Kazagam,81,2,83,0.28,Puducherry-INDIRA NAGAR
8,S. Karthigayan,Independent,109,0,109,0.37,Puducherry-INDIRA NAGAR
9,NOTA,None of the Above,560,9,569,1.95,Puducherry-INDIRA NAGAR
1,P. Selvanadane,Indian National Congress,5409,120,5529,20.47,Puducherry-KADIRGAMAM
2,K.S.P @ S. RAMESH,All India N.R. Congress,17359,416,17775,65.82,Puducherry-KADIRGAMAM
3,S. Ganesan,Amma Makkal Munnettra Kazagam,181,3,184,0.68,Puducherry-KADIRGAMAM
4,S. Sathiyavel,Indiya Jananayaka Katchi,148,2,150,0.56,Puducherry-KADIRGAMAM
5,Subasri,Naam Tamilar Katchi,2227,39,2266,8.39,Puducherry-KADIRGAMAM
6,S. Motcharajan,Desiya Murpokku Dravida Kazhagam,220,1,221,0.82,Puducherry-KADIRGAMAM
7,NOTA,None of the Above,859,21,880,3.26,Puducherry-KADIRGAMAM
1,P.M.L. KALYANASUNDARAM,Bharatiya Janata Party,13052,225,13277,44.63,Puducherry-KALAPET
2,S. MOUTTOUVEL,Dravida Munnetra Kazhagam,3670,99,3769,12.67,Puducherry-KALAPET
3,P. KALIAMURTHY,Amma Makkal Munnettra Kazagam,37,2,39,0.13,Puducherry-KALAPET
4,K. KAMARAJ,Naam Tamilar Katchi,1296,25,1321,4.44,Puducherry-KALAPET
5,R. CHANDRAMOHAN,Makkal Needhi Maiam,673,12,685,2.3,Puducherry-KALAPET
6,S. HARIHARAN,Desiya Murpokku Dravida Kazhagam,156,1,157,0.53,Puducherry-KALAPET
7,C. ASOKUMAR @ RAJKUMAR,Independent,96,1,97,0.33,Puducherry-KALAPET
8,L. SUBBULAKSHMI,Independent,31,0,31,0.1,Puducherry-KALAPET
9,BALASOUBREMANIANE. A,Independent,36,0,36,0.12,Puducherry-KALAPET
10,A. SENTHIL @ RAMESH,Independent,9652,117,9769,32.84,Puducherry-KALAPET
11,E. VIGNESH,Independent,63,0,63,0.21,Puducherry-KALAPET
12,S. VENGADESSAPEROUMAL,Independent,54,0,54,0.18,Puducherry-KALAPET
13,NOTA,None of the Above,441,12,453,1.52,Puducherry-KALAPET
1,A. JOHNKUMAR,Bharatiya Janata Party,16303,384,16687,56.11,Puducherry-KAMARAJ NAGAR
2,M.O.H.F. SHAJAHAN,Indian National Congress,9208,250,9458,31.8,Puducherry-KAMARAJ NAGAR
3,N. NADARAJAN @ SELVA,Desiya Murpokku Dravida Kazhagam,117,2,119,0.4,Puducherry-KAMARAJ NAGAR
4,L. MUNISAMY,Amma Makkal Munnettra Kazagam,430,16,446,1.5,Puducherry-KAMARAJ NAGAR
5,N. SHARMILA BEGUM,Naam Tamilar Katchi,1955,27,1982,6.66,Puducherry-KAMARAJ NAGAR
6,ANANDARAJ,Independent,119,2,121,0.41,Puducherry-KAMARAJ NAGAR
7,SIVA. ILANGO,Independent,81,4,85,0.29,Puducherry-KAMARAJ NAGAR
8,S. SAGAYARAJ,Independent,70,0,70,0.24,Puducherry-KAMARAJ NAGAR
9,VPR. SELVAM,Independent,113,2,115,0.39,Puducherry-KAMARAJ NAGAR
10,NOTA,None of the Above,636,22,658,2.21,Puducherry-KAMARAJ NAGAR
1,A.V. SUBRAMANIAN,Indian National Congress,12215,354,12569,44.38,Puducherry-KARAIKAL NORTH
2,P.R.N. THIRUMURUGAN,All India N.R. Congress,12362,342,12704,44.85,Puducherry-KARAIKAL NORTH
3,P. ARULANANDHAM,Indiya Jananayaka Katchi,55,0,55,0.19,Puducherry-KARAIKAL NORTH
4,ANUSUYA,Naam Tamilar Katchi,1203,11,1214,4.29,Puducherry-KARAIKAL NORTH
5,K. SURESH,Makkal Needhi Maiam,354,5,359,1.27,Puducherry-KARAIKAL NORTH
6,MOHAMED THAMEEM  KANI,SOCIAL DEMOCRATIC PARTY OF INDIA,184,1,185,0.65,Puducherry-KARAIKAL NORTH
7,A. VELUSAMY,Desiya Murpokku Dravida Kazhagam,72,0,72,0.25,Puducherry-KARAIKAL NORTH
8,S. MURALI,Independent,85,1,86,0.3,Puducherry-KARAIKAL NORTH
9,B. RAJENDRAN,Independent,32,0,32,0.11,Puducherry-KARAIKAL NORTH
10,A. Vengadesh,Independent,757,9,766,2.7,Puducherry-KARAIKAL NORTH
11,NOTA,None of the Above,275,7,282,1,Puducherry-KARAIKAL NORTH
1,K.A.U.ASSANA MARECAR,All India Anna Dravida Munnetra Kazhagam,5271,96,5367,21.95,Puducherry-KARAIKAL SOUTH
2,A.M.H. NAZIM,Dravida Munnetra Kazhagam,17042,359,17401,71.15,Puducherry-KARAIKAL SOUTH
3,A NEPOLIEAN,Indiya Jananayaka Katchi,66,1,67,0.27,Puducherry-KARAIKAL SOUTH
4,S MARIE ANTHUVAN,Naam Tamilar Katchi,697,2,699,2.86,Puducherry-KARAIKAL SOUTH
5,S MOHAMED SEEDIQUE,Amma Makkal Munnettra Kazagam,132,0,132,0.54,Puducherry-KARAIKAL SOUTH
6,R JAGATEESAN,Desiya Murpokku Dravida Kazhagam,38,1,39,0.16,Puducherry-KARAIKAL SOUTH
7,V MURUGAIA RAJENDIRAN,Independent,93,2,95,0.39,Puducherry-KARAIKAL SOUTH
8,A RAMPRASAD,Independent,433,2,435,1.78,Puducherry-KARAIKAL SOUTH
9,NOTA,None of the Above,217,4,221,0.9,Puducherry-KARAIKAL SOUTH
1,V. SAMINATHAN,Bharatiya Janata Party,8712,179,8891,33.88,Puducherry-LAWSPET
2,M. VAITHIANATHAN,Indian National Congress,14281,311,14592,55.6,Puducherry-LAWSPET
3,N. CAMATCHY,Amma Makkal Munnettra Kazagam,70,1,71,0.27,Puducherry-LAWSPET
4,P.V. GOPI KANNAN,Indiya Jananayaka Katchi,32,1,33,0.13,Puducherry-LAWSPET
5,D. SATHIYAMOORTHY,Makkal Needhi Maiam,812,13,825,3.14,Puducherry-LAWSPET
6,NIRMAL SINGH,Naam Tamilar Katchi,1148,20,1168,4.45,Puducherry-LAWSPET
7,A. BOOPALAN,Desiya Murpokku Dravida Kazhagam,72,1,73,0.28,Puducherry-LAWSPET
8,ANNA DURAI. M,Independent,20,0,20,0.08,Puducherry-LAWSPET
9,KARUNAKARAN,Independent,20,0,20,0.08,Puducherry-LAWSPET
10,P. SENTHIL KUMAR,Independent,67,2,69,0.26,Puducherry-LAWSPET
11,C. PANDIAN,Independent,59,1,60,0.23,Puducherry-LAWSPET
12,NOTA,None of the Above,402,21,423,1.61,Puducherry-LAWSPET
1,ADV. V.P. ABDUL RAHMAN,All India N.R. Congress,3476,56,3532,15.09,Puducherry-MAHE
2,RAMESH PARAMBATH,Indian National Congress,9460,284,9744,41.63,Puducherry-MAHE
3,JANAKY TEACHER,Desiya Murpokku Dravida Kazhagam,83,3,86,0.37,Puducherry-MAHE
4,C.K. UMMER MASTER,SOCIAL DEMOCRATIC PARTY OF INDIA,315,4,319,1.36,Puducherry-MAHE
5,SARATH S UNNITHAN,Independent,57,5,62,0.26,Puducherry-MAHE
6,N. HARIDASAN MASTER,Independent,9240,204,9444,40.35,Puducherry-MAHE
7,NOTA,None of the Above,215,6,221,0.94,Puducherry-MAHE
1,R. K. R. ANANTHARAMAN,Indian National Congress,8929,164,9093,30.37,Puducherry-MANAVELY
2,EMBALAM SELVAM @ R.SELVAM,Bharatiya Janata Party,16901,324,17225,57.54,Puducherry-MANAVELY
3,THAMIZHARASAN,Bahujan Samaj Party,252,8,260,0.87,Puducherry-MANAVELY
4,M S ELANGOVAN,Naam Tamilar Katchi,1539,16,1555,5.19,Puducherry-MANAVELY
5,SUNDARAMBAL @ MALARVIZHI,Makkal Needhi Maiam,412,14,426,1.42,Puducherry-MANAVELY
6,V THIRUNAVUKARASU,Desiya Murpokku Dravida Kazhagam,84,0,84,0.28,Puducherry-MANAVELY
7,J VEERASEKARAN,Indiya Jananayaka Katchi,33,2,35,0.12,Puducherry-MANAVELY
8,VEERAPUTHIRAN,Amma Makkal Munnettra Kazagam,62,0,62,0.21,Puducherry-MANAVELY
9,T ANANDAN,Independent,595,18,613,2.05,Puducherry-MANAVELY
10,DHORAPADIAR @ V.VELUSAMY,Independent,177,1,178,0.59,Puducherry-MANAVELY
11,NOTA,None of the Above,394,11,405,1.35,Puducherry-MANAVELY
1,SUN. KUMARAVEL,Dravida Munnetra Kazhagam,14047,174,14221,42.64,Puducherry-MANGALAM
2,A. Pathimaraj,Bahujan Samaj Party,104,0,104,0.31,Puducherry-MANGALAM
3,DJEACOUMAR .C,All India N.R. Congress,16600,372,16972,50.89,Puducherry-MANGALAM
4,M. Ganapathy,Amma Makkal Munnettra Kazagam,189,6,195,0.58,Puducherry-MANGALAM
5,M. SUBRAMANI,Makkal Needhi Maiam,278,1,279,0.84,Puducherry-MANGALAM
6,S. Patchaiappan,Desiya Murpokku Dravida Kazhagam,84,1,85,0.25,Puducherry-MANGALAM
7,B. BHARATHKALAI,Naam Tamilar Katchi,829,9,838,2.51,Puducherry-MANGALAM
8,Manavalan,Indiya Jananayaka Katchi,17,0,17,0.05,Puducherry-MANGALAM
9,A EGAMBARAM,Independent,37,0,37,0.11,Puducherry-MANGALAM
10,P. CANNANE,Independent,205,1,206,0.62,Puducherry-MANGALAM
11,M. Karthick,Independent,32,0,32,0.1,Puducherry-MANGALAM
12,NOTA,None of the Above,364,3,367,1.1,Puducherry-MANGALAM
1,A. KRISHNAN @ A.K. KUMAR,Dravida Munnetra Kazhagam,12016,173,12189,42.28,Puducherry-MANNADIPET
2,"K.K. MATHIVADHANAN, M.B.A., M.Phil.,",Bahujan Samaj Party,99,1,100,0.35,Puducherry-MANNADIPET
3,A. NAMASSIVAYAM,Bharatiya Janata Party,14692,247,14939,51.82,Puducherry-MANNADIPET
4,P. GOPALAKRISHNAN,Makkal Needhi Maiam,235,3,238,0.83,Puducherry-MANNADIPET
5,CHITRA,Naam Tamilar Katchi,480,5,485,1.68,Puducherry-MANNADIPET
6,C. DHANAVELU,Amma Makkal Munnettra Kazagam,56,1,57,0.2,Puducherry-MANNADIPET
7,S. MANIKANDAN,Desiya Murpokku Dravida Kazhagam,64,0,64,0.22,Puducherry-MANNADIPET
8,CHAMSOUDINE,Independent,12,0,12,0.04,Puducherry-MANNADIPET
9,SIVAKUMAR. R.M,Independent,8,0,8,0.03,Puducherry-MANNADIPET
10,SUBBURUMANI,Independent,23,2,25,0.09,Puducherry-MANNADIPET
11,BRIGHTMOON V. MURUGANANDHAM,Independent,42,1,43,0.15,Puducherry-MANNADIPET
12,VEERAPPAN,Independent,175,7,182,0.63,Puducherry-MANNADIPET
13,S. JAYABALL ALIAS SENGENI,Independent,55,0,55,0.19,Puducherry-MANNADIPET
14,NOTA,None of the Above,428,5,433,1.5,Puducherry-MANNADIPET
1,L. SAMBATH,Dravida Munnetra Kazhagam,14785,366,15151,51.3,Puducherry-MUDALIARPET
2,A. BASKAR,All India Anna Dravida Munnetra Kazhagam,10747,225,10972,37.15,Puducherry-MUDALIARPET
3,M. ARIKRISHNAN,Makkal Needhi Maiam,1293,28,1321,4.47,Puducherry-MUDALIARPET
4,M. MANIKANDAN,Amma Makkal Munnettra Kazagam,101,4,105,0.36,Puducherry-MUDALIARPET
5,M. VELAVAN,Naam Tamilar Katchi,1274,30,1304,4.41,Puducherry-MUDALIARPET
6,E. JEGANADHANE,Indiya Jananayaka Katchi,26,0,26,0.09,Puducherry-MUDALIARPET
7,K. KADIRVANAN,Independent,16,1,17,0.06,Puducherry-MUDALIARPET
8,G. SANTHOSH KUMAR,Independent,13,0,13,0.04,Puducherry-MUDALIARPET
9,E. THAMIZHARASAN,Independent,24,0,24,0.08,Puducherry-MUDALIARPET
10,S. NATARAJAN,Independent,75,3,78,0.26,Puducherry-MUDALIARPET
11,V. MANIKANDAN,Independent,18,0,18,0.06,Puducherry-MUDALIARPET
12,S. VETRIVELU,Independent,54,1,55,0.19,Puducherry-MUDALIARPET
13,NOTA,None of the Above,441,11,452,1.53,Puducherry-MUDALIARPET
1,R. SARAVANAN,Communist Party of India  (Marxist),312,9,321,1.37,Puducherry-MUTHIALPET
2,S. SENTHIL KUMARAN,Indian National Congress,4288,114,4402,18.79,Puducherry-MUTHIALPET
3,BALAMURUGAN,Bahujan Samaj Party,82,3,85,0.36,Puducherry-MUTHIALPET
4,VAIYAPURI MANIKANDAN,All India Anna Dravida Munnetra Kazhagam,7658,186,7844,33.49,Puducherry-MUTHIALPET
5,A. ARUNAGIRI,Desiya Murpokku Dravida Kazhagam,85,1,86,0.37,Puducherry-MUTHIALPET
6,K. SARAVANAN,Makkal Needhi Maiam,728,4,732,3.13,Puducherry-MUTHIALPET
7,M. FARITHA BEGUM,Naam Tamilar Katchi,762,16,778,3.32,Puducherry-MUTHIALPET
8,K. MURUGAN,Amma Makkal Munnettra Kazagam,51,0,51,0.22,Puducherry-MUTHIALPET
9,S. KALA,Independent,34,0,34,0.15,Puducherry-MUTHIALPET
10,J. PRAKASH KUMAR,Independent,8655,123,8778,37.48,Puducherry-MUTHIALPET
11,G. MAGESH,Independent,48,0,48,0.2,Puducherry-MUTHIALPET
12,NOTA,None of the Above,254,10,264,1.13,Puducherry-MUTHIALPET
1,A. ARULPRAKASH,Bahujan Samaj Party,84,0,84,0.31,Puducherry-NEDUNGADU
2,CHANDIRA PRIYANGA,All India N.R. Congress,10410,364,10774,40.2,Puducherry-NEDUNGADU
3,A. MARIMUTHU,Indian National Congress,8376,184,8560,31.94,Puducherry-NEDUNGADU
4,V. GEETHA,Naam Tamilar Katchi,779,9,788,2.94,Puducherry-NEDUNGADU
5,A. GNANASEGARAN,Desiya Murpokku Dravida Kazhagam,243,3,246,0.92,Puducherry-NEDUNGADU
6,T. RAJENDIRAN,Amma Makkal Munnettra Kazagam,147,6,153,0.57,Puducherry-NEDUNGADU
7,T. NARASIMHAN,Independent,81,0,81,0.3,Puducherry-NEDUNGADU
8,ANDOOR MATHI,Independent,248,4,252,0.94,Puducherry-NEDUNGADU
9,DR. V. VIGNESWARAN,Independent,5535,71,5606,20.92,Puducherry-NEDUNGADU
10,NOTA,None of the Above,251,3,254,0.95,Puducherry-NEDUNGADU
1,V. CARTIGUEYANE,Dravida Munnetra Kazhagam,11117,144,11261,40.47,Puducherry-NELLITHOPE
2,RICHARDS JOHNKUMAR,Bharatiya Janata Party,11563,194,11757,42.26,Puducherry-NELLITHOPE
3,D ARIVUMANI,My India Party,141,4,145,0.52,Puducherry-NELLITHOPE
4,R ANIFA,SOCIAL DEMOCRATIC PARTY OF INDIA,139,0,139,0.5,Puducherry-NELLITHOPE
5,R ARUMUGAM @ SARAVANAN,Janata Dal  (United),16,0,16,0.06,Puducherry-NELLITHOPE
6,S SASI KUMAR,Naam Tamilar Katchi,1506,15,1521,5.47,Puducherry-NELLITHOPE
7,R PASUPATHY,Indiya Jananayaka Katchi,18,0,18,0.06,Puducherry-NELLITHOPE
8,APR @ A. POOVARAGAVAN,Desiya Murpokku Dravida Kazhagam,99,2,101,0.36,Puducherry-NELLITHOPE
9,P MURUGESAN,Makkal Needhi Maiam,1621,38,1659,5.96,Puducherry-NELLITHOPE
10,D JENOVIA,Puducherry Development  Party,44,2,46,0.17,Puducherry-NELLITHOPE
11,ARUN @ MURUGAN,Independent,140,2,142,0.51,Puducherry-NELLITHOPE
12,E IRUDHAYARAJ,Independent,122,2,124,0.45,Puducherry-NELLITHOPE
13,"S ELUMALAI, M.A",Independent,82,1,83,0.3,Puducherry-NELLITHOPE
14,P SHIVA SANTHOSH,Independent,11,0,11,0.04,Puducherry-NELLITHOPE
15,N DELHI BABU,Independent,85,0,85,0.31,Puducherry-NELLITHOPE
16,S PRITHIVIRAJAN,Independent,177,1,178,0.64,Puducherry-NELLITHOPE
17,NOTA,None of the Above,527,10,537,1.93,Puducherry-NELLITHOPE
1,M.NAGATHIYAGARAJAN,Dravida Munnetra Kazhagam,14116,380,14496,55.74,Puducherry-NERAVY-T.R.PATTINAM
2,V.M.C.S.MANOHAREN,Bharatiya Janata Party,8788,197,8985,34.55,Puducherry-NERAVY-T.R.PATTINAM
3,A.ARULRAJU,Desiya Murpokku Dravida Kazhagam,55,0,55,0.21,Puducherry-NERAVY-T.R.PATTINAM
4,S.SELLAMUTHU,Indiya Jananayaka Katchi,35,0,35,0.13,Puducherry-NERAVY-T.R.PATTINAM
5,BALADHANDAYUDHABANI.C,Amma Makkal Munnettra Kazagam,41,4,45,0.17,Puducherry-NERAVY-T.R.PATTINAM
6,A MOHAMED YOUSUF,Naam Tamilar Katchi,468,3,471,1.81,Puducherry-NERAVY-T.R.PATTINAM
7,GEETHA ANANDAN,Independent,1474,21,1495,5.75,Puducherry-NERAVY-T.R.PATTINAM
8,V. M. C. S RAJAGANAPATHY,Independent,96,2,98,0.38,Puducherry-NERAVY-T.R.PATTINAM
9,S.SRIDHAR,Independent,139,1,140,0.54,Puducherry-NERAVY-T.R.PATTINAM
10,NOTA,None of the Above,177,9,186,0.72,Puducherry-NERAVY-T.R.PATTINAM
1,M PARANTHAMAN,Bahujan Samaj Party,130,3,133,0.47,Puducherry-NETTAPAKKAM
2,P RAJAVELU,All India N.R. Congress,15755,223,15978,56.82,Puducherry-NETTAPAKKAM
3,V VIZEAVENY,Indian National Congress,9211,129,9340,33.21,Puducherry-NETTAPAKKAM
4,T KALYANASUNDARAM,Janata Dal  (United),81,2,83,0.3,Puducherry-NETTAPAKKAM
5,D GOVURY,Naam Tamilar Katchi,645,4,649,2.31,Puducherry-NETTAPAKKAM
6,M SELVAM,Amma Makkal Munnettra Kazagam,249,4,253,0.9,Puducherry-NETTAPAKKAM
7,B GNANAOLY,Makkal Needhi Maiam,240,1,241,0.86,Puducherry-NETTAPAKKAM
8,A VELU,Indiya Jananayaka Katchi,89,4,93,0.33,Puducherry-NETTAPAKKAM
9,C KRISHNAGOPAL,Independent,597,2,599,2.13,Puducherry-NETTAPAKKAM
10,S THIRUNAVUKKARASU,Independent,460,10,470,1.67,Puducherry-NETTAPAKKAM
11,NOTA,None of the Above,276,6,282,1,Puducherry-NETTAPAKKAM
1,OMSAKTHISEKAR,All India Anna Dravida Munnetra Kazhagam,1743,44,1787,8.82,Puducherry-ORLEAMPETH
2,S. GOPAL,Dravida Munnetra Kazhagam,7367,120,7487,36.96,Puducherry-ORLEAMPETH
3,R. CADIRESSAN,Desiya Murpokku Dravida Kazhagam,49,1,50,0.25,Puducherry-ORLEAMPETH
4,KARUNANITHI,Naam Tamilar Katchi,497,10,507,2.5,Puducherry-ORLEAMPETH
5,A. SIRAJ @ KANIMOHAMED,Amma Makkal Munnettra Kazagam,26,0,26,0.13,Puducherry-ORLEAMPETH
6,S. SAKTIVEL,Makkal Needhi Maiam,363,1,364,1.8,Puducherry-ORLEAMPETH
7,K. PURUSHOTHAMAN,Indiya Jananayaka Katchi,6,0,6,0.03,Puducherry-ORLEAMPETH
8,J. RAVI @ PURUSHOTHAMAN,Puratchi Bharatham,59,1,60,0.3,Puducherry-ORLEAMPETH
9,R. RAJA,Independent,14,0,14,0.07,Puducherry-ORLEAMPETH
10,G. GOPAL,Independent,4,1,5,0.02,Puducherry-ORLEAMPETH
11,P. GOPALAKRISHNAN,Independent,11,0,11,0.05,Puducherry-ORLEAMPETH
12,GOPALAKRISHNAN .M,Independent,10,0,10,0.05,Puducherry-ORLEAMPETH
13,M. SANKAR,Independent,56,0,56,0.28,Puducherry-ORLEAMPETH
14,G. NEHRU @ KUPPUSAMY,Independent,9410,170,9580,47.29,Puducherry-ORLEAMPETH
15,V. HARIHARANE,Independent,111,2,113,0.56,Puducherry-ORLEAMPETH
16,NOTA,None of the Above,177,4,181,0.89,Puducherry-ORLEAMPETH
1,A. ANBALAGAN,All India Anna Dravida Munnetra Kazhagam,8501,152,8653,36.48,Puducherry-OUPALAM
2,ANNIBAL KENNEDY,Dravida Munnetra Kazhagam,13227,206,13433,56.64,Puducherry-OUPALAM
3,JAYAKUMAR,Bahujan Samaj Party,55,1,56,0.24,Puducherry-OUPALAM
4,M. KILLIVALAVAN,Indiya Jananayaka Katchi,10,0,10,0.04,Puducherry-OUPALAM
5,V. SASIKUMAR,Desiya Murpokku Dravida Kazhagam,22,2,24,0.1,Puducherry-OUPALAM
6,SANTHOSH KUMAR,Makkal Needhi Maiam,621,8,629,2.65,Puducherry-OUPALAM
7,V. DEVIPRIYA,Naam Tamilar Katchi,559,5,564,2.38,Puducherry-OUPALAM
8,P.M.BASKAR,Amma Makkal Munnettra Kazagam,43,0,43,0.18,Puducherry-OUPALAM
9,MOHAMED SALEEM,Independent,24,1,25,0.11,Puducherry-OUPALAM
10,K. REYAZ AHAMED,Independent,22,1,23,0.1,Puducherry-OUPALAM
11,SAMIYAR @ VIJAYAKUMAR BASTE,Independent,37,1,38,0.16,Puducherry-OUPALAM
12,NOTA,None of the Above,216,3,219,0.92,Puducherry-OUPALAM
1,P. KARTHIKEYAN,Indian National Congress,12145,96,12241,42.29,Puducherry-OUSSUDU
2,AK SAI J SARAVANAN KUMAR,Bharatiya Janata Party,13903,218,14121,48.78,Puducherry-OUSSUDU
3,GEETHA PRIYA,Naam Tamilar Katchi,736,4,740,2.56,Puducherry-OUSSUDU
4,K. SANKAR,Makkal Needhi Maiam,291,2,293,1.01,Puducherry-OUSSUDU
5,R. BABOU,Desiya Murpokku Dravida Kazhagam,77,0,77,0.27,Puducherry-OUSSUDU
6,M. RAMESH,Indiya Jananayaka Katchi,14,0,14,0.05,Puducherry-OUSSUDU
7,MUTHALU VENGADESAN,Amma Makkal Munnettra Kazagam,489,7,496,1.71,Puducherry-OUSSUDU
8,ABIMANNAN,Independent,20,4,24,0.08,Puducherry-OUSSUDU
9,N. AMBIGAPATHY,Independent,314,6,320,1.11,Puducherry-OUSSUDU
10,S. SANJIV GANTHI,Independent,46,1,47,0.16,Puducherry-OUSSUDU
11,A. MURALI,Independent,164,1,165,0.57,Puducherry-OUSSUDU
12,NOTA,None of the Above,406,3,409,1.41,Puducherry-OUSSUDU
1,R. Sheeshapillai,Bahujan Samaj Party,87,0,87,0.27,Puducherry-OZHUKARAI
2,N.G. PANNIR SELVAM,All India N.R. Congress,10775,346,11121,34,Puducherry-OZHUKARAI
3,Angalane @ Deva Pozhilan,Viduthalai Chiruthaigal Katchi,5479,154,5633,17.22,Puducherry-OZHUKARAI
4,EJOUMALE,Amma Makkal Munnettra Kazagam,144,3,147,0.45,Puducherry-OZHUKARAI
5,S. CHITRAKALA,Janata Dal  (United),22,0,22,0.07,Puducherry-OZHUKARAI
6,V. THANGAMANI,Puducherry Development  Party,51,1,52,0.16,Puducherry-OZHUKARAI
7,S. Datchanamoorthy,Indiya Jananayaka Katchi,20,0,20,0.06,Puducherry-OZHUKARAI
8,R. Pazhanivelan,Makkal Needhi Maiam,1159,26,1185,3.62,Puducherry-OZHUKARAI
9,S. PRIYA,Naam Tamilar Katchi,1144,13,1157,3.54,Puducherry-OZHUKARAI
10,MOTHILAL .S,Communist Party of India  (Marxist-Leninist)  (Liberation),154,4,158,0.48,Puducherry-OZHUKARAI
11,Gilbert,Desiya Murpokku Dravida Kazhagam,72,7,79,0.24,Puducherry-OZHUKARAI
12,A. Santhi,Independent,99,1,100,0.31,Puducherry-OZHUKARAI
13,M. Sivasankar,Independent,11794,146,11940,36.5,Puducherry-OZHUKARAI
14,Sivasankaran,Independent,279,3,282,0.86,Puducherry-OZHUKARAI
15,A S Ramesh,Independent,95,0,95,0.29,Puducherry-OZHUKARAI
16,N. JEEVANANDAM,Independent,183,5,188,0.57,Puducherry-OZHUKARAI
17,NOTA,None of the Above,432,12,444,1.36,Puducherry-OZHUKARAI
1,S.P. SIVAKUMAR,Dravida Munnetra Kazhagam,6247,117,6364,32.69,Puducherry-RAJ BHAVAN
2,K. LAKSHMINARAYANAN,All India N.R. Congress,9919,177,10096,51.86,Puducherry-RAJ BHAVAN
3,ANTHONY SHARMILA,Naam Tamilar Katchi,964,11,975,5.01,Puducherry-RAJ BHAVAN
4,G. SATHISHKUMAR,Amma Makkal Munnettra Kazagam,39,0,39,0.2,Puducherry-RAJ BHAVAN
5,S. PARUVADHAVARDHNIE,Makkal Needhi Maiam,1449,13,1462,7.51,Puducherry-RAJ BHAVAN
6,M. SATHIYAN @ VIMALAN,Independent,22,0,22,0.11,Puducherry-RAJ BHAVAN
7,S.K. SUBRAMANIAN,Independent,141,3,144,0.74,Puducherry-RAJ BHAVAN
8,N. MOHAN,Independent,61,0,61,0.31,Puducherry-RAJ BHAVAN
9,NOTA,None of the Above,295,8,303,1.56,Puducherry-RAJ BHAVAN
1,K. SETHU @ SETHU SELVAM,Communist Party of India,7355,167,7522,31.89,Puducherry-THATTANCHAVADY
2,N. Rangasamy,All India N.R. Congress,12646,332,12978,55.02,Puducherry-THATTANCHAVADY
3,R. Shanmugam,Indiya Jananayaka Katchi,41,1,42,0.18,Puducherry-THATTANCHAVADY
4,S.T. NARASSINGAM,Desiya Murpokku Dravida Kazhagam,101,2,103,0.44,Puducherry-THATTANCHAVADY
5,D. Ramesh,Naam Tamilar Katchi,1167,16,1183,5.02,Puducherry-THATTANCHAVADY
6,R. Rajendhiran,Makkal Needhi Maiam,1013,16,1029,4.36,Puducherry-THATTANCHAVADY
7,VIMALA SREE. B.,Amma Makkal Munnettra Kazagam,60,1,61,0.26,Puducherry-THATTANCHAVADY
8,C. ANUSUYA,Independent,124,4,128,0.54,Puducherry-THATTANCHAVADY
9,L. MANIKANDAN,Independent,46,2,48,0.2,Puducherry-THATTANCHAVADY
10,K. MURUGAN,Independent,52,2,54,0.23,Puducherry-THATTANCHAVADY
11,NOTA,None of the Above,417,21,438,1.86,Puducherry-THATTANCHAVADY
1,"T. UDAYAKUMAR, MLIS",Bahujan Samaj Party,77,3,80,0.28,Puducherry-THIRUBHUVANAI
2,B. KOBIGA,All India N.R. Congress,8084,154,8238,28.6,Puducherry-THIRUBHUVANAI
3,A. MUHILAN,Dravida Munnetra Kazhagam,7588,56,7644,26.53,Puducherry-THIRUBHUVANAI
4,Dr.K. SILAMBARASAN,Amma Makkal Munnettra Kazagam,229,0,229,0.79,Puducherry-THIRUBHUVANAI
5,V. SIVARAMAN,Indiya Jananayaka Katchi,115,2,117,0.41,Puducherry-THIRUBHUVANAI
6,K. RANJIT,Naam Tamilar Katchi,584,4,588,2.04,Puducherry-THIRUBHUVANAI
7,DURAI RAMESH,Makkal Needhi Maiam,481,1,482,1.67,Puducherry-THIRUBHUVANAI
8,T. VINAYAGAMOORTHY,Desiya Murpokku Dravida Kazhagam,118,1,119,0.41,Puducherry-THIRUBHUVANAI
9,P. ANGALANE,Independent,10473,124,10597,36.78,Puducherry-THIRUBHUVANAI
10,S.T. PARAMASIVAM @ CALE,Independent,180,2,182,0.63,Puducherry-THIRUBHUVANAI
11,M. SHANTHI,Independent,78,7,85,0.3,Puducherry-THIRUBHUVANAI
12,S. NADARAJAN,Independent,83,1,84,0.29,Puducherry-THIRUBHUVANAI
13,M. MANIVANNAN,Independent,79,0,79,0.27,Puducherry-THIRUBHUVANAI
14,NOTA,None of the Above,280,4,284,0.99,Puducherry-THIRUBHUVANAI
1,R. KAMALAKKANNAN,Indian National Congress,7486,245,7731,28.77,Puducherry-THIRUNALLAR
2,S. RAJASEKARAN,Bharatiya Janata Party,8274,142,8416,31.32,Puducherry-THIRUNALLAR
3,K. GURU @ SINTHA,Desiya Murpokku Dravida Kazhagam,125,2,127,0.47,Puducherry-THIRUNALLAR
4,M. SIKKANTHAR  BATSHA,Naam Tamilar Katchi,344,3,347,1.29,Puducherry-THIRUNALLAR
5,DHARPARANIYAM,Amma Makkal Munnettra Kazagam,58,0,58,0.22,Puducherry-THIRUNALLAR
6,PR. SIVA,Independent,9551,245,9796,36.45,Puducherry-THIRUNALLAR
7,P. SIMONRAJ,Independent,66,1,67,0.25,Puducherry-THIRUNALLAR
8,M. MARIAPPANE,Independent,84,4,88,0.33,Puducherry-THIRUNALLAR
9,S. VINOTH,Independent,71,0,71,0.26,Puducherry-THIRUNALLAR
10,NOTA,None of the Above,168,5,173,0.64,Puducherry-THIRUNALLAR
1,R. SIVA,Dravida Munnetra Kazhagam,19316,337,19653,55.73,Puducherry-VILLIANUR
2,S.V. SUGUMARAN,All India N.R. Congress,12370,333,12703,36.02,Puducherry-VILLIANUR
3,R. ARUMUGAM @ SARAVANAN,Janata Dal  (United),20,0,20,0.06,Puducherry-VILLIANUR
4,KUMARAVEL,Amma Makkal Munnettra Kazagam,160,2,162,0.46,Puducherry-VILLIANUR
5,THIAGU,Indiya Jananayaka Katchi,16,1,17,0.05,Puducherry-VILLIANUR
6,A. FAZIL,Desiya Murpokku Dravida Kazhagam,43,0,43,0.12,Puducherry-VILLIANUR
7,A. BANUMATHI,Makkal Needhi Maiam,600,9,609,1.73,Puducherry-VILLIANUR
8,PRAVEENA,Naam Tamilar Katchi,1172,10,1182,3.35,Puducherry-VILLIANUR
9,R. RAMPRASATH,Puducherry Development  Party,77,4,81,0.23,Puducherry-VILLIANUR
10,C. GUEDJENDIRANE,Independent,27,3,30,0.09,Puducherry-VILLIANUR
11,S. SHANMUGASUNDARAM,Independent,67,1,68,0.19,Puducherry-VILLIANUR
12,P. THANAMOUTTOU,Independent,73,0,73,0.21,Puducherry-VILLIANUR
13,A. MATHIVANAN,Independent,19,1,20,0.06,Puducherry-VILLIANUR
14,V. MARAN,Independent,35,0,35,0.1,Puducherry-VILLIANUR
15,N. DJEAMOURTHY,Independent,92,0,92,0.26,Puducherry-VILLIANUR
16,NOTA,None of the Above,470,8,478,1.36,Puducherry-VILLIANUR
1,SUNKARA KARTHIK,Bahujan Samaj Party,89,1,90,0.26,Puducherry-YANAM
2,N.RANGASAMY,All India N.R. Congress,16228,249,16477,47.2,Puducherry-YANAM
3,PEDAPATI RAMESH BABU,Amma Makkal Munnettra Kazagam,92,0,92,0.26,Puducherry-YANAM
4,MALLADI UDAYA LAKSHMI,Independent,53,0,53,0.15,Puducherry-YANAM
5,DURGAA PRASAAHD PEMMADI,Independent,93,2,95,0.27,Puducherry-YANAM
6,GOLUGULA PRABHAVATHI,Independent,13,0,13,0.04,Puducherry-YANAM
7,NATI BURIYYA,Independent,21,0,21,0.06,Puducherry-YANAM
8,GOLLAPALLI BHARATHI,Independent,10,0,10,0.03,Puducherry-YANAM
9,SABBATI LOKESWARA RAO,Independent,12,1,13,0.04,Puducherry-YANAM
10,DAVULURY VEERA VRATHA PATHI,Independent,318,2,320,0.92,Puducherry-YANAM
11,KALLA VENKATA RATNAM,Independent,23,2,25,0.07,Puducherry-YANAM
12,TEKUMUDI VENKATA RAO,Independent,210,0,210,0.6,Puducherry-YANAM
13,GOLLAPALLI SRINIVAS ASHOK,Independent,16874,258,17132,49.07,Puducherry-YANAM
14,SURIMILLI SUBBA RAO,Independent,100,2,102,0.29,Puducherry-YANAM
15,TALATAM SURYA CHANDRA SEKHARA RAO,Independent,139,0,139,0.4,Puducherry-YANAM
16,NOTA,None of the Above,115,3,118,0.34,Puducherry-YANAM
1,T.M.Anbarasan,Dravida Munnetra Kazhagam,115777,1008,116785,49.12,Tamil Nadu-Alandur
2,B.Valarmathi,All India Anna Dravida Munnetra Kazhagam,75634,580,76214,32.06,Tamil Nadu-Alandur
3,N.Raja,Desiya Makkal Sakthi Katchi,261,4,265,0.11,Tamil Nadu-Alandur
4,G Kamalakannan,Tamil Nadu Ilangyar Katchi,1096,9,1105,0.46,Tamil Nadu-Alandur
5,Dr.R.Karthikeyan,Naam Tamilar Katchi,16453,53,16506,6.94,Tamil Nadu-Alandur
6,Sarathbabu,Makkal Needhi Maiam,21045,72,21117,8.88,Tamil Nadu-Alandur
7,Subashree,Anaithu Makkal Arasiyal Katchi,187,0,187,0.08,Tamil Nadu-Alandur
8,Dr.R.Suresh,Bhartiya Manavadhikaar Federal Party,63,0,63,0.03,Tamil Nadu-Alandur
9,M Mohammed Thameem Ansari,SOCIAL DEMOCRATIC PARTY OF INDIA,1750,11,1761,0.74,Tamil Nadu-Alandur
10,Rajesh Chinnadurai,National Democratic Party of South India,54,6,60,0.03,Tamil Nadu-Alandur
11,J.Vincent,Republican Party of India (Athawale),36,10,46,0.02,Tamil Nadu-Alandur
12,E.Anbarasu,Independent,199,3,202,0.08,Tamil Nadu-Alandur
13,S.Anbarasu,Independent,84,0,84,0.04,Tamil Nadu-Alandur
14,M Anbarasu,Independent,108,0,108,0.05,Tamil Nadu-Alandur
15,M.Ashok Kumar,Independent,73,1,74,0.03,Tamil Nadu-Alandur
16,Ali Mohamed,Independent,219,1,220,0.09,Tamil Nadu-Alandur
17,A.Abrahamlincon,Independent,260,0,260,0.11,Tamil Nadu-Alandur
18,P.Sathiyaraj,Independent,140,0,140,0.06,Tamil Nadu-Alandur
19,K Saravanan,Independent,40,0,40,0.02,Tamil Nadu-Alandur
20,C Saravanan,Independent,39,1,40,0.02,Tamil Nadu-Alandur
21,S.V.Saravanan,Independent,56,0,56,0.02,Tamil Nadu-Alandur
22,Nithyanandham S,Independent,106,1,107,0.05,Tamil Nadu-Alandur
23,B Raji,Independent,28,0,28,0.01,Tamil Nadu-Alandur
24,M.Valarmathi,Independent,229,10,239,0.1,Tamil Nadu-Alandur
25,S.Sridhar,Independent,156,0,156,0.07,Tamil Nadu-Alandur
26,NOTA,None of the Above,1878,10,1888,0.79,Tamil Nadu-Alandur
1,M.CHINNADURAI,Bahujan Samaj Party,442,2,444,0.26,Tamil Nadu-Alangudi
2,DHARMA THANGAVEL,All India Anna Dravida Munnetra Kazhagam,61918,170,62088,36.13,Tamil Nadu-Alangudi
3,SIVA.V.MEYYANATHAN,Dravida Munnetra Kazhagam,86743,1192,87935,51.17,Tamil Nadu-Alangudi
4,C.THIRUCHELVAM,Naam Tamilar Katchi,15403,74,15477,9.01,Tamil Nadu-Alangudi
5,P.BALAMURUGAN,My India Party,179,1,180,0.1,Tamil Nadu-Alangudi
6,G.MANIMEGALAI,Communist Party of India  (Marxist-Leninist)  (Liberation),163,2,165,0.1,Tamil Nadu-Alangudi
7,D.VIDANGAR,Amma Makkal Munnettra Kazagam,2899,25,2924,1.7,Tamil Nadu-Alangudi
8,N.VAIRAVAN,Makkal Needhi Maiam,1221,9,1230,0.72,Tamil Nadu-Alangudi
9,C.JAYA,Anaithu Makkal Puratchi Katchi,154,1,155,0.09,Tamil Nadu-Alangudi
10,V.KANNADASAN,Independent,343,0,343,0.2,Tamil Nadu-Alangudi
11,T.VINAYAGAMOORTHY,Independent,199,0,199,0.12,Tamil Nadu-Alangudi
12,NOTA,None of the Above,699,3,702,0.41,Tamil Nadu-Alangudi
1,PAUL MANOJ PANDIAN,All India Anna Dravida Munnetra Kazhagam,73846,307,74153,36.44,Tamil Nadu-Alangulam
2,DR.POONGOTHAI ALADI ARUNA,Dravida Munnetra Kazhagam,69325,1289,70614,34.7,Tamil Nadu-Alangulam
3,RAJENDRANATHAN,Desiya Murpokku Dravida Kazhagam,2797,19,2816,1.38,Tamil Nadu-Alangulam
4,A.UDHAYAKUMAR,Puthiya Tamilagam,1098,7,1105,0.54,Tamil Nadu-Alangulam
5,M.SANGEETHA ESAK,Naam Tamilar Katchi,12396,123,12519,6.15,Tamil Nadu-Alangulam
6,S.SELVAKUMAR,Makkal Needhi Maiam,1439,15,1454,0.71,Tamil Nadu-Alangulam
7,ARUNKUMAR.K,Independent,492,0,492,0.24,Tamil Nadu-Alangulam
8,S.SANKAR GANESH YADAV,Independent,375,1,376,0.18,Tamil Nadu-Alangulam
9,K.SIVARAM,Independent,435,1,436,0.21,Tamil Nadu-Alangulam
10,HARI NADAR.A,Independent,37603,124,37727,18.54,Tamil Nadu-Alangulam
11,NOTA,None of the Above,1772,14,1786,0.88,Tamil Nadu-Alangulam
1,R.AVUDAIAPPAN,Dravida Munnetra Kazhagam,67267,1029,68296,38.44,Tamil Nadu-Ambasamudram
2,E.SUBAYA,All India Anna Dravida Munnetra Kazhagam,84665,546,85211,47.96,Tamil Nadu-Ambasamudram
3,MANIMARAN,Bahujan Samaj Party,505,4,509,0.29,Tamil Nadu-Ambasamudram
4,C.GANESAN,Makkal Needhi Maiam,2765,42,2807,1.58,Tamil Nadu-Ambasamudram
5,SHENBAGA VALLI,Naam Tamilar Katchi,13599,136,13735,7.73,Tamil Nadu-Ambasamudram
6,C.RANI RANJITHAM,Amma Makkal Munnettra Kazagam,4146,48,4194,2.36,Tamil Nadu-Ambasamudram
7,S. LAKSHMANAN,Veerath Thiyagi Viswanathadoss Thozhilalarkal Katchi,178,0,178,0.1,Tamil Nadu-Ambasamudram
8,ABDUL MAJEETH,Independent,88,0,88,0.05,Tamil Nadu-Ambasamudram
9,ARUNACHALAM,Independent,117,2,119,0.07,Tamil Nadu-Ambasamudram
10,S.GANESAN,Independent,166,0,166,0.09,Tamil Nadu-Ambasamudram
11,M.GAVASKAR,Independent,310,5,315,0.18,Tamil Nadu-Ambasamudram
12,J.RAJESH DHARMASINGH PANDIAN,Independent,390,0,390,0.22,Tamil Nadu-Ambasamudram
13,NOTA,None of the Above,1665,8,1673,0.94,Tamil Nadu-Ambasamudram
1,V ALEXANDER,All India Anna Dravida Munnetra Kazhagam,71908,500,72408,30.13,Tamil Nadu-Ambattur
2,R Radha,Nationalist Congress Party,613,2,615,0.26,Tamil Nadu-Ambattur
3,JOSEPH SAMUEL,Dravida Munnetra Kazhagam,113371,1183,114554,47.67,Tamil Nadu-Ambattur
4,R ANBU THENARASAN,Naam Tamilar Katchi,22638,63,22701,9.45,Tamil Nadu-Ambattur
5,S Veena,Anaithu Makkal Arasiyal Katchi,231,2,233,0.1,Tamil Nadu-Ambattur
6,S VEDHACHALAM,Amma Makkal Munnettra Kazagam,2616,15,2631,1.09,Tamil Nadu-Ambattur
7,S VAITHESWARAN,Makkal Needhi Maiam,22286,84,22370,9.31,Tamil Nadu-Ambattur
8,M S ARUMUGAM,Independent,141,1,142,0.06,Tamil Nadu-Ambattur
9,N Ganesan,Independent,55,0,55,0.02,Tamil Nadu-Ambattur
10,A S Kesavan,Independent,59,0,59,0.02,Tamil Nadu-Ambattur
11,G Srinivasan,Independent,56,1,57,0.02,Tamil Nadu-Ambattur
12,G Soma Sundaram,Independent,80,0,80,0.03,Tamil Nadu-Ambattur
13,P Dhanraj,Independent,52,3,55,0.02,Tamil Nadu-Ambattur
14,NARMADA NANDHAKUMAR,Independent,176,1,177,0.07,Tamil Nadu-Ambattur
15,Bharadan,Independent,111,0,111,0.05,Tamil Nadu-Ambattur
16,K Bharathi,Independent,801,6,807,0.34,Tamil Nadu-Ambattur
17,S Praveen,Independent,251,0,251,0.1,Tamil Nadu-Ambattur
18,A R MURUGAVEL,Independent,94,1,95,0.04,Tamil Nadu-Ambattur
19,T MUNIANDI,Independent,156,0,156,0.06,Tamil Nadu-Ambattur
20,Ravi,Independent,44,0,44,0.02,Tamil Nadu-Ambattur
21,C RAGHUL,Independent,138,1,139,0.06,Tamil Nadu-Ambattur
22,G Vijayakumar,Independent,39,0,39,0.02,Tamil Nadu-Ambattur
23,T Joseph Samuvel SanthaKumar,Independent,162,0,162,0.07,Tamil Nadu-Ambattur
24,NOTA,None of the Above,2332,26,2358,0.98,Tamil Nadu-Ambattur
1,NAZAR MOHAMED.K,All India Anna Dravida Munnetra Kazhagam,69903,341,70244,39.49,Tamil Nadu-Ambur
2,WAZEER AHMED.J,Bahujan Samaj Party,678,3,681,0.38,Tamil Nadu-Ambur
3,VILWANATHAN.A.C,Dravida Munnetra Kazhagam,89561,915,90476,50.86,Tamil Nadu-Ambur
4,ASHOK KUMAR.C,Anaithu Makkal Puratchi Katchi,316,3,319,0.18,Tamil Nadu-Ambur
5,UMAR FAROOK.ASA,SOCIAL DEMOCRATIC PARTY OF INDIA,1787,6,1793,1.01,Tamil Nadu-Ambur
6,KAREEM BASHA.A,Rashtriya Ulama Council,81,1,82,0.05,Tamil Nadu-Ambur
7,PARTHIBAN.V,All India Youth Development Party,101,0,101,0.06,Tamil Nadu-Ambur
8,MANI.S.P,All Pensionerâ€™s Party,358,5,363,0.2,Tamil Nadu-Ambur
9,MAHARUNNISHA,Naam Tamilar Katchi,10102,48,10150,5.71,Tamil Nadu-Ambur
10,RAJA.S,Makkal Needhi Maiam,1629,9,1638,0.92,Tamil Nadu-Ambur
11,MURUGAN.L,Independent,199,2,201,0.11,Tamil Nadu-Ambur
12,RAJINIKANTH.P,Independent,252,1,253,0.14,Tamil Nadu-Ambur
13,GEORGE.V.A.,Independent,159,1,160,0.09,Tamil Nadu-Ambur
14,NOTA,None of the Above,1410,7,1417,0.8,Tamil Nadu-Ambur
1,A.P.Nandakumar,Dravida Munnetra Kazhagam,94084,1075,95159,48.11,Tamil Nadu-Anaikattu
2,D.Velazhagan,All India Anna Dravida Munnetra Kazhagam,88031,768,88799,44.89,Tamil Nadu-Anaikattu
3,V.D.Sathish Kumar,Amma Makkal Munnettra Kazagam,1125,15,1140,0.58,Tamil Nadu-Anaikattu
4,A.Sumithra,Naam Tamilar Katchi,7974,151,8125,4.11,Tamil Nadu-Anaikattu
5,K.Rajasekar,Indiya Jananayaka Katchi,323,5,328,0.17,Tamil Nadu-Anaikattu
6,M.Arun,Independent,42,2,44,0.02,Tamil Nadu-Anaikattu
7,R Karunamoorthy,Independent,61,1,62,0.03,Tamil Nadu-Anaikattu
8,N.Kirubakaran,Independent,104,5,109,0.06,Tamil Nadu-Anaikattu
9,M.Senthil Kumar,Independent,1335,22,1357,0.69,Tamil Nadu-Anaikattu
10,K.Naveenkumar,Independent,93,1,94,0.05,Tamil Nadu-Anaikattu
11,T.Mathan Kumar,Independent,149,1,150,0.08,Tamil Nadu-Anaikattu
12,M RajBabu,Independent,179,0,179,0.09,Tamil Nadu-Anaikattu
13,P Venkatesan,Independent,468,0,468,0.24,Tamil Nadu-Anaikattu
14,NOTA,None of the Above,1768,23,1791,0.91,Tamil Nadu-Anaikattu
1,S.KAMATCHI,Bahujan Samaj Party,387,5,392,0.19,Tamil Nadu-Andipatti
2,A.MAHARAJAN,Dravida Munnetra Kazhagam,92057,1484,93541,44.64,Tamil Nadu-Andipatti
3,A.LOGIRAJAN,All India Anna Dravida Munnetra Kazhagam,84542,461,85003,40.57,Tamil Nadu-Andipatti
4,C.KANIVEL,Anaithu Makkal Puratchi Katchi,650,0,650,0.31,Tamil Nadu-Andipatti
5,S.GUNASEKARAN,Makkal Needhi Maiam,2958,52,3010,1.44,Tamil Nadu-Andipatti
6,M.KUMARAN,My India Party,105,4,109,0.05,Tamil Nadu-Andipatti
7,S.GOVINDHARAJ,All India MGR Makkal Munnetra Kazhagam,112,3,115,0.05,Tamil Nadu-Andipatti
8,BALAMURUGAN,National Democratic Party of South India,122,5,127,0.06,Tamil Nadu-Andipatti
9,A.VELUCHAMY,Anna Puratchi Thalaivar Amma Dravida Munnetra Kazhagam,114,1,115,0.05,Tamil Nadu-Andipatti
10,JEYAKUMAR,Naam Tamilar Katchi,11034,182,11216,5.35,Tamil Nadu-Andipatti
11,R.JEYAKUMAR,Amma Makkal Munnettra Kazagam,11746,150,11896,5.68,Tamil Nadu-Andipatti
12,M.EASWARAN,Independent,125,2,127,0.06,Tamil Nadu-Andipatti
13,K.KASENDRAN @ GAJENDRAN,Independent,84,1,85,0.04,Tamil Nadu-Andipatti
14,M.DIVAKAR,Independent,115,0,115,0.05,Tamil Nadu-Andipatti
15,P.PANIVURAJA,Independent,155,1,156,0.07,Tamil Nadu-Andipatti
16,P.PANDIDURAI,Independent,226,1,227,0.11,Tamil Nadu-Andipatti
17,MARIYAMMAL,Independent,148,1,149,0.07,Tamil Nadu-Andipatti
18,M.RAGHUNATHAN,Independent,457,0,457,0.22,Tamil Nadu-Andipatti
19,VELMANI,Independent,566,6,572,0.27,Tamil Nadu-Andipatti
20,V.JEYAKODI,Independent,141,4,145,0.07,Tamil Nadu-Andipatti
21,NOTA,None of the Above,1308,25,1333,0.64,Tamil Nadu-Andipatti
1,S. Gokula Indira,All India Anna Dravida Munnetra Kazhagam,52297,312,52609,31.87,Tamil Nadu-Anna Nagar
2,M.K. Mohan,Dravida Munnetra Kazhagam,79356,698,80054,48.49,Tamil Nadu-Anna Nagar
3,D. JeevithKumar,Bahujan Samaj Party,220,0,220,0.13,Tamil Nadu-Anna Nagar
4,Ansar Ahamed,Anaithu Makkal Arasiyal Katchi,69,0,69,0.04,Tamil Nadu-Anna Nagar
5,K.N. Gunasekaran,Amma Makkal Munnettra Kazagam,1163,6,1169,0.71,Tamil Nadu-Anna Nagar
6,S. Shankar,Naam Tamilar Katchi,10361,45,10406,6.3,Tamil Nadu-Anna Nagar
7,P. Dhanasekar,Nam India Naam Indiyar Katchi,59,0,59,0.04,Tamil Nadu-Anna Nagar
8,J. Nagaraj,New Generation Peopleâ€™s Party,53,0,53,0.03,Tamil Nadu-Anna Nagar
9,V. Paulraj Guna,Republican Party of India (Athawale),73,0,73,0.04,Tamil Nadu-Anna Nagar
10,S.D. Prabhakar,Tamil Nadu Ilangyar Katchi,406,2,408,0.25,Tamil Nadu-Anna Nagar
11,V. Ponraj,Makkal Needhi Maiam,17434,88,17522,10.61,Tamil Nadu-Anna Nagar
12,S. Yuvaraja,Veerath Thiyagi Viswanathadoss Thozhilalarkal Katchi,56,0,56,0.03,Tamil Nadu-Anna Nagar
13,M. Veriyandi,Anna MGR Dravida Makkal Kalgam,32,0,32,0.02,Tamil Nadu-Anna Nagar
14,L. Kasinathan,Independent,74,0,74,0.04,Tamil Nadu-Anna Nagar
15,P.E. Gopinath,Independent,62,0,62,0.04,Tamil Nadu-Anna Nagar
16,S. Sathyanarayanan,Independent,158,0,158,0.1,Tamil Nadu-Anna Nagar
17,K. Sathish Kumar,Independent,125,0,125,0.08,Tamil Nadu-Anna Nagar
18,R. Saravanan,Independent,122,0,122,0.07,Tamil Nadu-Anna Nagar
19,V.M. Nagarajan,Independent,84,2,86,0.05,Tamil Nadu-Anna Nagar
20,P. Manimaran,Independent,13,0,13,0.01,Tamil Nadu-Anna Nagar
21,M. Manokaran,Independent,27,0,27,0.02,Tamil Nadu-Anna Nagar
22,A. Jayaprakash,Independent,12,0,12,0.01,Tamil Nadu-Anna Nagar
23,Hari Shankar,Independent,141,1,142,0.09,Tamil Nadu-Anna Nagar
24,NOTA,None of the Above,1529,16,1545,0.94,Tamil Nadu-Anna Nagar
1,SHANMUGAVEL.K.S,All India Anna Dravida Munnetra Kazhagam,77474,347,77821,44.12,Tamil Nadu-Anthiyur
2,PATTAN.G,Bahujan Samaj Party,956,1,957,0.54,Tamil Nadu-Anthiyur
3,VENKATACHALAM.A.G,Dravida Munnetra Kazhagam,78038,1058,79096,44.84,Tamil Nadu-Anthiyur
4,GURUNATHAN.M,Makkal Needhi Maiam,2466,8,2474,1.4,Tamil Nadu-Anthiyur
5,SARAVANAN.M,Naam Tamilar Katchi,8162,68,8230,4.67,Tamil Nadu-Anthiyur
6,SELVAM.S.R,Amma Makkal Munnettra Kazagam,1207,5,1212,0.69,Tamil Nadu-Anthiyur
7,BAKKIYAM.M,India Dravida Makkal Munnetra Katchi,103,0,103,0.06,Tamil Nadu-Anthiyur
8,PRATHABAN.A,Ahimsa Socialist Party,2035,10,2045,1.16,Tamil Nadu-Anthiyur
9,RAJENDRAN.K,Ganasangam Party of India,229,0,229,0.13,Tamil Nadu-Anthiyur
10,ANBALAGAN.K,Independent,198,1,199,0.11,Tamil Nadu-Anthiyur
11,KARTHIKEYAN.R,Independent,130,2,132,0.07,Tamil Nadu-Anthiyur
12,GEETHA.M,Independent,151,1,152,0.09,Tamil Nadu-Anthiyur
13,KUMARASAMY.R,Independent,224,1,225,0.13,Tamil Nadu-Anthiyur
14,SHANMUGAM.K,Independent,503,0,503,0.29,Tamil Nadu-Anthiyur
15,SENGUTTUVAN.M.R,Independent,183,1,184,0.1,Tamil Nadu-Anthiyur
16,THANGAVEL.M,Independent,543,0,543,0.31,Tamil Nadu-Anthiyur
17,POORNACHANDRAN.S,Independent,567,0,567,0.32,Tamil Nadu-Anthiyur
18,PERIYASAMY.T,Independent,146,1,147,0.08,Tamil Nadu-Anthiyur
19,MUTHUSAMY.M,Independent,428,0,428,0.24,Tamil Nadu-Anthiyur
20,SHEIKDAVOOD.A.M,Independent,110,1,111,0.06,Tamil Nadu-Anthiyur
21,NOTA,None of the Above,1017,10,1027,0.58,Tamil Nadu-Anthiyur
1,P.SUDHAKAR,Bahujan Samaj Party,1816,9,1825,1.06,Tamil Nadu-Arakkonam
2,S.RAVI,All India Anna Dravida Munnetra Kazhagam,85057,342,85399,49.82,Tamil Nadu-Arakkonam
3,E.ABIRAMI,Naam Tamilar Katchi,14561,70,14631,8.54,Tamil Nadu-Arakkonam
4,GOWTHAMA SANNAH.J,Viduthalai Chiruthaigal Katchi,57345,885,58230,33.97,Tamil Nadu-Arakkonam
5,S.BASKARAN,Makkal Needhi Maiam,3522,21,3543,2.07,Tamil Nadu-Arakkonam
6,K.C.MANIVANNAN,Amma Makkal Munnettra Kazagam,4747,30,4777,2.79,Tamil Nadu-Arakkonam
7,V.RAVI,Independent,96,1,97,0.06,Tamil Nadu-Arakkonam
8,A.GAUTHAMAN,Independent,109,3,112,0.07,Tamil Nadu-Arakkonam
9,C.M.GOWTHAMAN,Independent,284,1,285,0.17,Tamil Nadu-Arakkonam
10,M.MANIKANDAN,Independent,111,2,113,0.07,Tamil Nadu-Arakkonam
11,M.MADHANRAJ,Independent,184,0,184,0.11,Tamil Nadu-Arakkonam
12,C.MOHAN,Independent,128,0,128,0.07,Tamil Nadu-Arakkonam
13,P.RAVI,Independent,432,0,432,0.25,Tamil Nadu-Arakkonam
14,NOTA,None of the Above,1648,8,1656,0.97,Tamil Nadu-Arakkonam
1,S.S.ANBALAGAN,Dravida Munnetra Kazhagam,98386,1447,99833,45.09,Tamil Nadu-Arani
2,K.ANBU,Bahujan Samaj Party,330,2,332,0.15,Tamil Nadu-Arani
3,G.BASKARAN,Desiya Murpokku Dravida Kazhagam,1852,9,1861,0.84,Tamil Nadu-Arani
4,S.RAMACHANDRAN,All India Anna Dravida Munnetra Kazhagam,102225,736,102961,46.5,Tamil Nadu-Arani
5,S.THANIGAIVEL,Veerath Thiyagi Viswanathadoss Thozhilalarkal Katchi,506,3,509,0.23,Tamil Nadu-Arani
6,D.PRAKALATHA,Naam Tamilar Katchi,10373,118,10491,4.74,Tamil Nadu-Arani
7,V.MANIGANDAN,Makkal Needhi Maiam,2196,17,2213,1,Tamil Nadu-Arani
8,A.ARUNKUMAR,Independent,217,5,222,0.1,Tamil Nadu-Arani
9,K.ANBALAGAN,Independent,56,19,75,0.03,Tamil Nadu-Arani
10,M.ANBALAGAN,Independent,78,2,80,0.04,Tamil Nadu-Arani
11,N.KARTHIKEYAN,Independent,395,2,397,0.18,Tamil Nadu-Arani
12,S.SAKTHIVEL,Independent,165,13,178,0.08,Tamil Nadu-Arani
13,R.DHAKSHANAMOORTHY,Independent,313,0,313,0.14,Tamil Nadu-Arani
14,S.MURALI,Independent,133,0,133,0.06,Tamil Nadu-Arani
15,S.RAMACHANDRAN,Independent,133,1,134,0.06,Tamil Nadu-Arani
16,NOTA,None of the Above,1666,24,1690,0.76,Tamil Nadu-Arani
1,RAMACHANDRAN T,Indian National Congress,80902,933,81835,48.7,Tamil Nadu-Aranthangi
2,RAJANAYAGAM M,All India Anna Dravida Munnetra Kazhagam,50655,287,50942,30.31,Tamil Nadu-Aranthangi
3,JEEVA A,Bahujan Samaj Party,633,3,636,0.38,Tamil Nadu-Aranthangi
4,AMALADOSS SANDHIYAGU,Puthiya Tamilagam,599,13,612,0.36,Tamil Nadu-Aranthangi
5,RAMALINGASWAMI ADIHITHAN. PPC,Akhila India Jananayaka Makkal Katchi (Dr. Isaac),167,1,168,0.1,Tamil Nadu-Aranthangi
6,KUMARAPPAN B,My India Party,125,0,125,0.07,Tamil Nadu-Aranthangi
7,SAKTHIVEL K,Tamizhaga Murpokku Makkal Katchi,162,0,162,0.1,Tamil Nadu-Aranthangi
8,SIVASHANMUGAM K,Amma Makkal Munnettra Kazagam,4678,21,4699,2.8,Tamil Nadu-Aranthangi
9,SHAIK MOHAMED B,Makkal Needhi Maiam,960,6,966,0.57,Tamil Nadu-Aranthangi
10,HUMAYUN KABIR M I,Naam Tamilar Katchi,18398,62,18460,10.98,Tamil Nadu-Aranthangi
11,ARJUNAN R,Independent,140,0,140,0.08,Tamil Nadu-Aranthangi
12,SYED SULTHAN IBRAHIM A,Independent,201,1,202,0.12,Tamil Nadu-Aranthangi
13,SELVAKUMAR K,Independent,391,0,391,0.23,Tamil Nadu-Aranthangi
14,TILLAINATHAN R,Independent,179,1,180,0.11,Tamil Nadu-Aranthangi
15,"DHETCHENA MOORTHY, Dr. S",Independent,1064,16,1080,0.64,Tamil Nadu-Aranthangi
16,PANDIYAN V,Independent,505,0,505,0.3,Tamil Nadu-Aranthangi
17,MAHENDRAN K,Independent,493,0,493,0.29,Tamil Nadu-Aranthangi
18,MUTHUKKARUPPAIAH K,Independent,334,0,334,0.2,Tamil Nadu-Aranthangi
19,MUTHUSELVAM V,Independent,2159,5,2164,1.29,Tamil Nadu-Aranthangi
20,RAMASAMY R S,Independent,212,0,212,0.13,Tamil Nadu-Aranthangi
21,VELRAJ. K P,Independent,3150,14,3164,1.88,Tamil Nadu-Aranthangi
22,JEGADEESAN R,Independent,54,0,54,0.03,Tamil Nadu-Aranthangi
23,NOTA,None of the Above,524,0,524,0.31,Tamil Nadu-Aranthangi
1,ANNAMALAI. K,Bharatiya Janata Party,67915,638,68553,38.71,Tamil Nadu-Aravakurichi
2,ELANGO. R,Dravida Munnetra Kazhagam,92215,1154,93369,52.72,Tamil Nadu-Aravakurichi
3,SUNDARARAJ. R,Bahujan Samaj Party,328,0,328,0.19,Tamil Nadu-Aravakurichi
4,ANITHA PARVEEN. M,Naam Tamilar Katchi,7156,32,7188,4.06,Tamil Nadu-Aravakurichi
5,THANGAVEL.  P. S. N,Amma Makkal Munnettra Kazagam,1593,6,1599,0.9,Tamil Nadu-Aravakurichi
6,MOHAMMED HANEEF SHAHIL. K. S,Makkal Needhi Maiam,1375,7,1382,0.78,Tamil Nadu-Aravakurichi
7,MOHANRAJ. C,Samaniya Makkal Nala Katchi,21,1,22,0.01,Tamil Nadu-Aravakurichi
8,RAJKUMAR. R,Tamil Nadu Ilangyar Katchi,375,2,377,0.21,Tamil Nadu-Aravakurichi
9,ARIVALAGAN. T,Independent,53,0,53,0.03,Tamil Nadu-Aravakurichi
10,ARUMUGAM. R,Independent,29,0,29,0.02,Tamil Nadu-Aravakurichi
11,KARTHIKEYAN. R,Independent,63,0,63,0.04,Tamil Nadu-Aravakurichi
12,KARTHIK. D,Independent,45,0,45,0.03,Tamil Nadu-Aravakurichi
13,KIRUBANANTH. S,Independent,41,0,41,0.02,Tamil Nadu-Aravakurichi
14,SAKUNTHALA. N,Independent,79,0,79,0.04,Tamil Nadu-Aravakurichi
15,SATHEESHKUMAR. T,Independent,336,0,336,0.19,Tamil Nadu-Aravakurichi
16,SARAVANAN. P,Independent,1236,0,1236,0.7,Tamil Nadu-Aravakurichi
17,CHITHAMBARAM. A,Independent,240,0,240,0.14,Tamil Nadu-Aravakurichi
18,SILAMBARASAN. P,Independent,129,0,129,0.07,Tamil Nadu-Aravakurichi
19,SIVAKUMAR. A,Independent,28,0,28,0.02,Tamil Nadu-Aravakurichi
20,SURESH. M,Independent,19,0,19,0.01,Tamil Nadu-Aravakurichi
21,SURESHBABU. S,Independent,24,0,24,0.01,Tamil Nadu-Aravakurichi
22,SELVAKUMAR. R,Independent,19,0,19,0.01,Tamil Nadu-Aravakurichi
23,THANEGASALAM. R. V,Independent,20,1,21,0.01,Tamil Nadu-Aravakurichi
24,BASKARAN. N,Independent,24,1,25,0.01,Tamil Nadu-Aravakurichi
25,PITCHAIMUTHU. T,Independent,24,0,24,0.01,Tamil Nadu-Aravakurichi
26,PRAKASH. P,Independent,16,0,16,0.01,Tamil Nadu-Aravakurichi
27,PRABAKARAN. T,Independent,20,1,21,0.01,Tamil Nadu-Aravakurichi
28,PRABHU. G,Independent,16,0,16,0.01,Tamil Nadu-Aravakurichi
29,BOOPATHY. S,Independent,27,0,27,0.02,Tamil Nadu-Aravakurichi
30,PERIYASAMY. M. R,Independent,40,0,40,0.02,Tamil Nadu-Aravakurichi
31,MAHESHMANI. T,Independent,104,0,104,0.06,Tamil Nadu-Aravakurichi
32,MATHIYALAGAN. P,Independent,161,0,161,0.09,Tamil Nadu-Aravakurichi
33,MANOJPANDIYAN. J. M,Independent,290,0,290,0.16,Tamil Nadu-Aravakurichi
34,MURUGESAN. M. S,Independent,174,0,174,0.1,Tamil Nadu-Aravakurichi
35,RAGUNATH. P,Independent,23,0,23,0.01,Tamil Nadu-Aravakurichi
36,RANJITH. I,Independent,21,0,21,0.01,Tamil Nadu-Aravakurichi
37,RAMAGURU. R,Independent,19,1,20,0.01,Tamil Nadu-Aravakurichi
38,RAJENDIRAN. M,Independent,44,0,44,0.02,Tamil Nadu-Aravakurichi
39,VIVEKANANTHAN. V,Independent,13,0,13,0.01,Tamil Nadu-Aravakurichi
40,VAIRASEEMAN. G,Independent,46,0,46,0.03,Tamil Nadu-Aravakurichi
41,NOTA,None of the Above,866,3,869,0.49,Tamil Nadu-Aravakurichi
1,J.L.Eswarappan,Dravida Munnetra Kazhagam,102667,1218,103885,49.52,Tamil Nadu-Arcot
2,A.C.Kesavan,Bahujan Samaj Party,771,11,782,0.37,Tamil Nadu-Arcot
3,Elavazagan.K.L,Pattali Makkal Katchi,83410,517,83927,40.01,Tamil Nadu-Arcot
4,R.Kathiravan,Naam Tamilar Katchi,11977,111,12088,5.76,Tamil Nadu-Arcot
5,H.Mohamed Ghouse,Tipu Sultan Party,392,5,397,0.19,Tamil Nadu-Arcot
6,A.R.Mohamed Raffi,Makkal Needhi Maiam,2846,14,2860,1.36,Tamil Nadu-Arcot
7,Munivel.S,National Democratic Party of South India,180,4,184,0.09,Tamil Nadu-Arcot
8,N.Janarthanan,Amma Makkal Munnettra Kazagam,2159,31,2190,1.04,Tamil Nadu-Arcot
9,P.Eswaran,Independent,155,0,155,0.07,Tamil Nadu-Arcot
10,T.D.Shanmugam,Independent,231,0,231,0.11,Tamil Nadu-Arcot
11,K.Manigandan,Independent,453,4,457,0.22,Tamil Nadu-Arcot
12,Vasanthakumar,Independent,380,2,382,0.18,Tamil Nadu-Arcot
13,NOTA,None of the Above,2238,15,2253,1.07,Tamil Nadu-Arcot
1,SAVARIANANDHAM V,Bahujan Samaj Party,483,3,486,0.22,Tamil Nadu-Ariyalur
2,CHINNAPPA K,Dravida Munnetra Kazhagam,102964,1011,103975,46.16,Tamil Nadu-Ariyalur
3,RAJENDRAN S,All India Anna Dravida Munnetra Kazhagam,100436,305,100741,44.73,Tamil Nadu-Ariyalur
4,THANGA. SHANMUGA SUNDARAM,New Generation Peopleâ€™s Party,1028,9,1037,0.46,Tamil Nadu-Ariyalur
5,SUGUNA KUMAR,Naam Tamilar Katchi,12285,61,12346,5.48,Tamil Nadu-Ariyalur
6,DURAI.MANIVEL,Amma Makkal Munnettra Kazagam,2040,4,2044,0.91,Tamil Nadu-Ariyalur
7,JAWAHAR P,Indiya Jananayaka Katchi,896,9,905,0.4,Tamil Nadu-Ariyalur
8,KUMAR J,Independent,73,1,74,0.03,Tamil Nadu-Ariyalur
9,SIVATHASAN V,Independent,159,0,159,0.07,Tamil Nadu-Ariyalur
10,DEVA P,Independent,127,6,133,0.06,Tamil Nadu-Ariyalur
11,MANIKANNAN M,Independent,539,1,540,0.24,Tamil Nadu-Ariyalur
12,RAMESH K,Independent,766,1,767,0.34,Tamil Nadu-Ariyalur
13,RAVICHANDRAN S,Independent,630,2,632,0.28,Tamil Nadu-Ariyalur
14,NOTA,None of the Above,1383,3,1386,0.62,Tamil Nadu-Ariyalur
1,K.K.S.S.R.RAMACHANDRAN,Dravida Munnetra Kazhagam,88928,2112,91040,53.18,Tamil Nadu-Aruppukkottai
2,G.SUBBURAJ,Bahujan Samaj Party,270,2,272,0.16,Tamil Nadu-Aruppukkottai
3,R.RAMESH,Desiya Murpokku Dravida Kazhagam,2505,27,2532,1.48,Tamil Nadu-Aruppukkottai
4,VAIGAICHELVAN,All India Anna Dravida Munnetra Kazhagam,51614,392,52006,30.38,Tamil Nadu-Aruppukkottai
5,UMA,Naam Tamilar Katchi,12271,121,12392,7.24,Tamil Nadu-Aruppukkottai
6,V.UMADEVI,Makkal Needhi Maiam,7550,88,7638,4.46,Tamil Nadu-Aruppukkottai
7,M.KARUPPASAMY,Puthiya Tamilagam,460,18,478,0.28,Tamil Nadu-Aruppukkottai
8,S.DEENATHAYALAN,Anaithu Makkal Puratchi Katchi,58,0,58,0.03,Tamil Nadu-Aruppukkottai
9,S.PANDIYAN,Bahujan Dravida Party,48,0,48,0.03,Tamil Nadu-Aruppukkottai
10,A.P.S.JOHNSON,My India Party,55,2,57,0.03,Tamil Nadu-Aruppukkottai
11,G.RANJITH,Independent,57,0,57,0.03,Tamil Nadu-Aruppukkottai
12,R.S.RAMACHANDRAN,Independent,67,0,67,0.04,Tamil Nadu-Aruppukkottai
13,THANGAPANDIAN,Independent,425,1,426,0.25,Tamil Nadu-Aruppukkottai
14,THANGA VADIVEL.A.N,Independent,61,1,62,0.04,Tamil Nadu-Aruppukkottai
15,DHANASEKARAPANDIAN,Independent,76,0,76,0.04,Tamil Nadu-Aruppukkottai
16,P.PRASANTH,Independent,436,0,436,0.25,Tamil Nadu-Aruppukkottai
17,K. BOOMINATHAN,Independent,630,0,630,0.37,Tamil Nadu-Aruppukkottai
18,V. POORNISHA,Independent,217,2,219,0.13,Tamil Nadu-Aruppukkottai
19,Ponmuniasamy,Independent,118,0,118,0.07,Tamil Nadu-Aruppukkottai
20,S.MANIVANNAN,Independent,190,0,190,0.11,Tamil Nadu-Aruppukkottai
21,M MUTHUMARIAPPAN,Independent,128,0,128,0.07,Tamil Nadu-Aruppukkottai
22,E.RAMACHANDRAN,Independent,72,0,72,0.04,Tamil Nadu-Aruppukkottai
23,G.RAMACHANDRAN,Independent,60,0,60,0.04,Tamil Nadu-Aruppukkottai
24,S.RAMACHANDRAN,Independent,189,0,189,0.11,Tamil Nadu-Aruppukkottai
25,T.RAMACHANDRAN,Independent,39,0,39,0.02,Tamil Nadu-Aruppukkottai
26,R.RAMACHANDRAN,Independent,71,0,71,0.04,Tamil Nadu-Aruppukkottai
27,LINGAPANDI,Independent,419,0,419,0.24,Tamil Nadu-Aruppukkottai
28,VIJAYAKUMAR,Independent,60,0,60,0.04,Tamil Nadu-Aruppukkottai
29,VENKATESAN,Independent,38,0,38,0.02,Tamil Nadu-Aruppukkottai
30,NOTA,None of the Above,1316,7,1323,0.77,Tamil Nadu-Aruppukkottai
1,KARTHIGAISELVAN K,Bahujan Samaj Party,740,9,749,0.33,Tamil Nadu-Athoor
2,PERIYASAMY I,Dravida Munnetra Kazhagam,164169,1640,165809,72.11,Tamil Nadu-Athoor
3,SILAMBARASAN M,Puthiya Tamilagam,878,2,880,0.38,Tamil Nadu-Athoor
4,SIVASAKTHIVEL P,Makkal Needhi Maiam,3211,30,3241,1.41,Tamil Nadu-Athoor
5,SELVAKUMAR P,Amma Makkal Munnettra Kazagam,2991,26,3017,1.31,Tamil Nadu-Athoor
6,SIMON JUSTIN A,Naam Tamilar Katchi,17017,151,17168,7.47,Tamil Nadu-Athoor
7,THILAGABAMA M,Pattali Makkal Katchi,30018,220,30238,13.15,Tamil Nadu-Athoor
8,MUTHULAKSHMI R,Anna Puratchi Thalaivar Amma Dravida Munnetra Kazhagam,1178,2,1180,0.51,Tamil Nadu-Athoor
9,RAGUPATHI P,Anaithu Makkal Puratchi Katchi,87,0,87,0.04,Tamil Nadu-Athoor
10,JEYASEKARAN R,My India Party,87,1,88,0.04,Tamil Nadu-Athoor
11,ANBU AS,Independent,534,1,535,0.23,Tamil Nadu-Athoor
12,KARTHI M,Independent,321,1,322,0.14,Tamil Nadu-Athoor
13,SANKAR D,Independent,700,0,700,0.3,Tamil Nadu-Athoor
14,SAVADAMUTHU A,Independent,1706,16,1722,0.75,Tamil Nadu-Athoor
15,SILAMBARASAN P,Independent,486,0,486,0.21,Tamil Nadu-Athoor
16,THILAGAVATHY S,Independent,347,2,349,0.15,Tamil Nadu-Athoor
17,BALAMURUGAN A,Independent,190,0,190,0.08,Tamil Nadu-Athoor
18,PALRAJ R,Independent,1352,5,1357,0.59,Tamil Nadu-Athoor
19,MURUGANANTHAM C,Independent,125,0,125,0.05,Tamil Nadu-Athoor
20,VEERAMALAI S,Independent,133,0,133,0.06,Tamil Nadu-Athoor
21,NOTA,None of the Above,1543,21,1564,0.68,Tamil Nadu-Athoor
1,"CHINNADURAI, K.",Dravida Munnetra Kazhagam,85243,1808,87051,43.58,Tamil Nadu-Attur
2,"PERIYANNAN, M.",Bahujan Samaj Party,492,2,494,0.25,Tamil Nadu-Attur
3,"JAYASANKARAN, A.P.",All India Anna Dravida Munnetra Kazhagam,94262,1046,95308,47.72,Tamil Nadu-Attur
4,"KRISHNAVENI, S.",Naam Tamilar Katchi,10141,92,10233,5.12,Tamil Nadu-Attur
5,"SADHA SIVAM, R.",Ambedkarite Party of India,240,1,241,0.12,Tamil Nadu-Attur
6,"SIVAKUMAR, P.",Makkal Needhi Maiam,1937,22,1959,0.98,Tamil Nadu-Attur
7,"MADHESWARAN, S.",Amma Makkal Munnettra Kazagam,1675,24,1699,0.85,Tamil Nadu-Attur
8,"MATHESWARI, K.K.",Anna Dravidar Kazhagam,117,3,120,0.06,Tamil Nadu-Attur
9,"JANARTHANAM, A.",Dhesiya Makkal Kazhagam,215,0,215,0.11,Tamil Nadu-Attur
10,"ARUMUGAM, D.",Independent,367,0,367,0.18,Tamil Nadu-Attur
11,"SILAMBARASAN, J.",Independent,222,0,222,0.11,Tamil Nadu-Attur
12,NOTA,None of the Above,1817,17,1834,0.92,Tamil Nadu-Attur
1,Sankar N M,Desiya Murpokku Dravida Kazhagam,1895,16,1911,0.64,Tamil Nadu-Avadi
2,CHARLES S,Bahujan Samaj Party,763,10,773,0.26,Tamil Nadu-Avadi
3,Nasar S M,Dravida Munnetra Kazhagam,148845,1442,150287,49.94,Tamil Nadu-Avadi
4,Pandiarajan K,All India Anna Dravida Munnetra Kazhagam,94331,681,95012,31.57,Tamil Nadu-Avadi
5,Udhayakumar V,Makkal Needhi Maiam,16982,110,17092,5.68,Tamil Nadu-Avadi
6,Balasubramanian M,Tamil Nadu Ilangyar Katchi,1251,12,1263,0.42,Tamil Nadu-Avadi
7,Banumathi,My India Party,126,1,127,0.04,Tamil Nadu-Avadi
8,Raman N,Tamilnadu Makkal Nalvazhvu Periyakkam,120,0,120,0.04,Tamil Nadu-Avadi
9,VIJAYALAKSHMI G,Naam Tamilar Katchi,29953,134,30087,10,Tamil Nadu-Avadi
10,Viswanathan R,MGR Makkal Katchi,108,0,108,0.04,Tamil Nadu-Avadi
11,Akilan T.M.,Independent,72,0,72,0.02,Tamil Nadu-Avadi
12,Chandrasekar.A,Independent,105,0,105,0.03,Tamil Nadu-Avadi
13,Sugumar M,Independent,143,0,143,0.05,Tamil Nadu-Avadi
14,Dharani K,Independent,184,3,187,0.06,Tamil Nadu-Avadi
15,Durgaprasad G,Independent,73,2,75,0.02,Tamil Nadu-Avadi
16,Nagaraj M,Independent,198,0,198,0.07,Tamil Nadu-Avadi
17,Pandiarajan G,Independent,359,1,360,0.12,Tamil Nadu-Avadi
18,Venkatesan M,Independent,95,0,95,0.03,Tamil Nadu-Avadi
19,Jayakumar P,Independent,299,1,300,0.1,Tamil Nadu-Avadi
20,Shanavas Khan J,Independent,231,0,231,0.08,Tamil Nadu-Avadi
21,NOTA,None of the Above,2361,20,2381,0.79,Tamil Nadu-Avadi
1,ATHIYAMAAN RAJU,Dravida Munnetra Kazhagam,65453,929,66382,31.22,Tamil Nadu-Avanashi
2,"DHANAPAL, P",All India Anna Dravida Munnetra Kazhagam,116674,610,117284,55.16,Tamil Nadu-Avanashi
3,"DURAISAMY, P",Bahujan Samaj Party,831,2,833,0.39,Tamil Nadu-Avanashi
4,"MEERA, K",Desiya Murpokku Dravida Kazhagam,2554,23,2577,1.21,Tamil Nadu-Avanashi
5,"SUBRAMANI, K",India Dravida Makkal Munnetra Katchi,137,2,139,0.07,Tamil Nadu-Avanashi
6,SHOBA,Naam Tamilar Katchi,13211,45,13256,6.23,Tamil Nadu-Avanashi
7,"VENKATESWARAN, A",Makkal Needhi Maiam,8318,61,8379,3.94,Tamil Nadu-Avanashi
8,ANNAMALAI,Independent,150,4,154,0.07,Tamil Nadu-Avanashi
9,"ARUMUGAM, P",Independent,171,2,173,0.08,Tamil Nadu-Avanashi
10,"SAKUNTHALA, T",Independent,178,1,179,0.08,Tamil Nadu-Avanashi
11,"MURUGESAN, R",Independent,379,0,379,0.18,Tamil Nadu-Avanashi
12,"RANGASAMY, P",Independent,520,0,520,0.24,Tamil Nadu-Avanashi
13,NOTA,None of the Above,2352,20,2372,1.12,Tamil Nadu-Avanashi
1,KRISHNAN A,All India Anna Dravida Munnetra Kazhagam,84177,465,84642,42.8,Tamil Nadu-Bargur
2,NIRMALA A,National People's Party,701,9,710,0.36,Tamil Nadu-Bargur
3,MATHIAZHAGAN D,Dravida Munnetra Kazhagam,95852,1404,97256,49.17,Tamil Nadu-Bargur
4,MURALI M,Bahujan Samaj Party,442,1,443,0.22,Tamil Nadu-Bargur
5,ARUN GOWTHAM R,Indiya Jananayaka Katchi,337,8,345,0.17,Tamil Nadu-Bargur
6,AANDI A,Veerath Thiyagi Viswanathadoss Thozhilalarkal Katchi,120,1,121,0.06,Tamil Nadu-Bargur
7,GANESA KUMAR S,Amma Makkal Munnettra Kazagam,1058,6,1064,0.54,Tamil Nadu-Bargur
8,KARUNAKARAN K,Naam Tamilar Katchi,10019,94,10113,5.11,Tamil Nadu-Bargur
9,VASANTHARAJ P,Anna Puratchi Thalaivar Amma Dravida Munnetra Kazhagam,181,3,184,0.09,Tamil Nadu-Bargur
10,KALPANA D,Independent,115,4,119,0.06,Tamil Nadu-Bargur
11,KRISHNAN A,Independent,106,1,107,0.05,Tamil Nadu-Bargur
12,SANTHAMOORTHI K,Independent,223,0,223,0.11,Tamil Nadu-Bargur
13,MANJUNATHAN M,Independent,622,1,623,0.31,Tamil Nadu-Bargur
14,MANI K,Independent,327,0,327,0.17,Tamil Nadu-Bargur
15,NOTA,None of the Above,1496,11,1507,0.76,Tamil Nadu-Bargur
1,KARUPPANAN.K.C,All India Anna Dravida Munnetra Kazhagam,100285,630,100915,50.11,Tamil Nadu-Bhavani
2,GOPAL.M,Bahujan Samaj Party,868,2,870,0.43,Tamil Nadu-Bhavani
3,DURAIRAJ.K.P,Dravida Munnetra Kazhagam,77079,1313,78392,38.93,Tamil Nadu-Bhavani
4,AMMASAI.K,Kongu  Desa  Marumalarchi  Makkal  Katchi,936,7,943,0.47,Tamil Nadu-Bhavani
5,SADHANANDHAM.K,Makkal Needhi Maiam,4186,35,4221,2.1,Tamil Nadu-Bhavani
6,SATHYA.M,Naam Tamilar Katchi,10410,61,10471,5.2,Tamil Nadu-Bhavani
7,RADHAKRISHNAN.M,Amma Makkal Munnettra Kazagam,953,3,956,0.47,Tamil Nadu-Bhavani
8,JANARTHANAM.R.P,Tamilaga Makkal Thannurimai Katchi,320,2,322,0.16,Tamil Nadu-Bhavani
9,ABDUL KADHER.A,Independent,107,0,107,0.05,Tamil Nadu-Bhavani
10,APPICHI.T.K,Independent,99,0,99,0.05,Tamil Nadu-Bhavani
11,KARTHIKEYAN.P,Independent,121,1,122,0.06,Tamil Nadu-Bhavani
12,SATHEESH KUMAR.P,Independent,1221,3,1224,0.61,Tamil Nadu-Bhavani
13,PERUMAL.V.M,Independent,419,0,419,0.21,Tamil Nadu-Bhavani
14,STANLEY.G,Independent,244,1,245,0.12,Tamil Nadu-Bhavani
15,NOTA,None of the Above,2070,9,2079,1.03,Tamil Nadu-Bhavani
1,G.SAKTHIVEL,Bahujan Samaj Party,1194,3,1197,0.6,Tamil Nadu-Bhavanisagar
2,P.L SUNDARAM,Communist Party of India,82200,973,83173,41.47,Tamil Nadu-Bhavanisagar
3,A.Bannari,All India Anna Dravida Munnetra Kazhagam,98934,247,99181,49.45,Tamil Nadu-Bhavanisagar
4,RAMESH.G,Desiya Murpokku Dravida Kazhagam,2193,4,2197,1.1,Tamil Nadu-Bhavanisagar
5,KARTHIKKUMAR.K,Makkal Needhi Maiam,4280,17,4297,2.14,Tamil Nadu-Bhavanisagar
6,V.SANGEETHA,Naam Tamilar Katchi,8479,38,8517,4.25,Tamil Nadu-Bhavanisagar
7,NOTA,None of the Above,2003,2,2005,1,Tamil Nadu-Bhavanisagar
1,Arunmozhithevan. A,All India Anna Dravida Munnetra Kazhagam,95536,917,96453,48.92,Tamil Nadu-Bhuvanagiri
2,Ezhilvendhan. R,Bahujan Samaj Party,503,1,504,0.26,Tamil Nadu-Bhuvanagiri
3,Saravanan. Durai.K,Dravida Munnetra Kazhagam,87217,977,88194,44.73,Tamil Nadu-Bhuvanagiri
4,Balamurugan. K.S.K,Amma Makkal Munnettra Kazagam,2464,6,2470,1.25,Tamil Nadu-Bhuvanagiri
5,Rathinavel. R.,Naam Tamilar Katchi,6927,31,6958,3.53,Tamil Nadu-Bhuvanagiri
6,Revathi. R.,Indiya Jananayaka Katchi,314,1,315,0.16,Tamil Nadu-Bhuvanagiri
7,Anandan. S (a) Kavignar Sella Aananthamaalai,Independent,102,0,102,0.05,Tamil Nadu-Bhuvanagiri
8,Ezhilvendan. P.,Independent,55,0,55,0.03,Tamil Nadu-Bhuvanagiri
9,Saravanan. J.,Independent,192,4,196,0.1,Tamil Nadu-Bhuvanagiri
10,Sivakumari. T,Independent,68,0,68,0.03,Tamil Nadu-Bhuvanagiri
11,Pazhanivel. M,Independent,141,1,142,0.07,Tamil Nadu-Bhuvanagiri
12,Balamurugan. G.C,Independent,132,1,133,0.07,Tamil Nadu-Bhuvanagiri
13,Ranjith. R,Independent,333,0,333,0.17,Tamil Nadu-Bhuvanagiri
14,Jeyakumar. K,Independent,184,0,184,0.09,Tamil Nadu-Bhuvanagiri
15,NOTA,None of the Above,1058,0,1058,0.54,Tamil Nadu-Bhuvanagiri
1,THANGATAMILSELVAN,Dravida Munnetra Kazhagam,87142,1887,89029,41.45,Tamil Nadu-Bodinayakanur
2,O.PANNEERSELVAM,All India Anna Dravida Munnetra Kazhagam,99296,754,100050,46.58,Tamil Nadu-Bodinayakanur
3,K.I.M HAKKEEM,All India Trinamool Congress,552,7,559,0.26,Tamil Nadu-Bodinayakanur
4,ARUN KUMAR,My India Party,139,4,143,0.07,Tamil Nadu-Bodinayakanur
5,P.GANESH KUMAR,Makkal Needhi Maiam,4069,59,4128,1.92,Tamil Nadu-Bodinayakanur
6,P.KARUPPIAH,Bahujan Dravida Party,77,0,77,0.04,Tamil Nadu-Bodinayakanur
7,THENI.T.KARNAN,Anna Dravidar Kazhagam,80,0,80,0.04,Tamil Nadu-Bodinayakanur
8,S.KRISHNAVENI,Anna Puratchi Thalaivar Amma Dravida Munnetra Kazhagam,98,2,100,0.05,Tamil Nadu-Bodinayakanur
9,M.PREM CHANDAR,Naam Tamilar Katchi,10982,132,11114,5.17,Tamil Nadu-Bodinayakanur
10,M.MUTHUSAMY,Amma Makkal Munnettra Kazagam,5594,55,5649,2.63,Tamil Nadu-Bodinayakanur
11,A.ABTHAHIR,Independent,53,1,54,0.03,Tamil Nadu-Bodinayakanur
12,C.ANBAZHAKAN,Independent,91,3,94,0.04,Tamil Nadu-Bodinayakanur
13,M.ANANTHARAJ,Independent,269,1,270,0.13,Tamil Nadu-Bodinayakanur
14,N.KRISHNAN,Independent,125,1,126,0.06,Tamil Nadu-Bodinayakanur
15,P.KUMARAGURUBARAN,Independent,218,1,219,0.1,Tamil Nadu-Bodinayakanur
16,N.SALEEM,Independent,353,1,354,0.16,Tamil Nadu-Bodinayakanur
17,G.SENTHIL KUMAR,Independent,402,0,402,0.19,Tamil Nadu-Bodinayakanur
18,TAMILSELVAN,Independent,441,2,443,0.21,Tamil Nadu-Bodinayakanur
19,V.NANDHAGOPAL,Independent,68,0,68,0.03,Tamil Nadu-Bodinayakanur
20,P.NAGENDHREN,Independent,133,2,135,0.06,Tamil Nadu-Bodinayakanur
21,P.MANIMARAN,Independent,108,9,117,0.05,Tamil Nadu-Bodinayakanur
22,V.RAMPRAKAASH,Independent,69,2,71,0.03,Tamil Nadu-Bodinayakanur
23,RAJA MOHAMED,Independent,45,3,48,0.02,Tamil Nadu-Bodinayakanur
24,T.RAJA MOHAMED,Independent,62,0,62,0.03,Tamil Nadu-Bodinayakanur
25,NOTA,None of the Above,1381,22,1403,0.65,Tamil Nadu-Bodinayakanur
1,GAJENDRAN.M,All India Anna Dravida Munnetra Kazhagam,103561,347,103908,37.91,Tamil Nadu-Chengalpattu
2,VARALAKSHMI.M,Dravida Munnetra Kazhagam,129317,1256,130573,47.64,Tamil Nadu-Chengalpattu
3,ERANIAPPAN.S,Communist Party of India  (Marxist-Leninist)  (Liberation),684,0,684,0.25,Tamil Nadu-Chengalpattu
4,SANJEEVINATHAN.K,Naam Tamilar Katchi,26813,55,26868,9.8,Tamil Nadu-Chengalpattu
5,SATHISHKUMAR.A,Amma Makkal Munnettra Kazagam,3063,6,3069,1.12,Tamil Nadu-Chengalpattu
6,SARAVANAN.D,All India Jananayaka Makkal Kazhagam,195,0,195,0.07,Tamil Nadu-Chengalpattu
7,DILLIBABU.S,Tipu Sultan Party,403,1,404,0.15,Tamil Nadu-Chengalpattu
8,MUTHAMILSELVAN.S,Indiya Jananayaka Katchi,4133,13,4146,1.51,Tamil Nadu-Chengalpattu
9,VASUMATHI.G,Anaithu Makkal Arasiyal Katchi,141,1,142,0.05,Tamil Nadu-Chengalpattu
10,GOPALAKRISHNAN.N,Independent,129,0,129,0.05,Tamil Nadu-Chengalpattu
11,SEETHALAKSHMI.I,Independent,314,3,317,0.12,Tamil Nadu-Chengalpattu
12,RAJAGOPAL.G,Independent,233,0,233,0.09,Tamil Nadu-Chengalpattu
13,VEERADOSS.E,Independent,343,1,344,0.13,Tamil Nadu-Chengalpattu
14,NOTA,None of the Above,3058,17,3075,1.12,Tamil Nadu-Chengalpattu
1,ANBU.S,Desiya Murpokku Dravida Kazhagam,2741,28,2769,1.24,Tamil Nadu-Chengam
2,GIRI.M.P,Dravida Munnetra Kazhagam,106185,1896,108081,48.26,Tamil Nadu-Chengam
3,SHANMUGAM.G,Bahujan Samaj Party,790,11,801,0.36,Tamil Nadu-Chengam
4,NAINAKANNU.M.S,All India Anna Dravida Munnetra Kazhagam,95280,1231,96511,43.09,Tamil Nadu-Chengam
5,SUGANRAJ.S,Indiya Jananayaka Katchi,823,5,828,0.37,Tamil Nadu-Chengam
6,BASKAR.S,New Generation Peopleâ€™s Party,171,3,174,0.08,Tamil Nadu-Chengam
7,VENNILA.S,Naam Tamilar Katchi,11980,100,12080,5.39,Tamil Nadu-Chengam
8,ARUNKUMAR.M,Independent,111,1,112,0.05,Tamil Nadu-Chengam
9,ANBAZHAGAN.P.G,Independent,110,2,112,0.05,Tamil Nadu-Chengam
10,SHARMA.S,Independent,85,42,127,0.06,Tamil Nadu-Chengam
11,SIVAKUMAR.J,Independent,99,0,99,0.04,Tamil Nadu-Chengam
12,SIVAPRAKASH.K,Independent,139,34,173,0.08,Tamil Nadu-Chengam
13,SELVARAJI.V,Independent,379,2,381,0.17,Tamil Nadu-Chengam
14,DHINAKARAN.H,Independent,200,0,200,0.09,Tamil Nadu-Chengam
15,VIJAYACHANDRAN.G,Independent,417,0,417,0.19,Tamil Nadu-Chengam
16,NOTA,None of the Above,1079,6,1085,0.48,Tamil Nadu-Chengam
1,UDHAYANIDHI STALIN,Dravida Munnetra Kazhagam,92636,649,93285,67.89,Tamil Nadu-Chepauk-Thiruvallikeni
2,RAGHU C,Bahujan Samaj Party,715,8,723,0.53,Tamil Nadu-Chepauk-Thiruvallikeni
3,ABID BAKSHQ H HUSSAIN,Republican Party of India (Athawale),104,1,105,0.08,Tamil Nadu-Chepauk-Thiruvallikeni
4,RAVI M L,Desiya Makkal Sakthi Katchi,89,0,89,0.06,Tamil Nadu-Chepauk-Thiruvallikeni
5,RAJENDRAN L,Amma Makkal Munnettra Kazagam,1865,8,1873,1.36,Tamil Nadu-Chepauk-Thiruvallikeni
6,KASSALI A.V.A,Pattali Makkal Katchi,23763,167,23930,17.42,Tamil Nadu-Chepauk-Thiruvallikeni
7,TABREZ,Tipu Sultan Party,366,1,367,0.27,Tamil Nadu-Chepauk-Thiruvallikeni
8,MOHAMMED IDRIS K,Indiya Jananayaka Katchi,4090,6,4096,2.98,Tamil Nadu-Chepauk-Thiruvallikeni
9,MOHAMED RIOZ,Anaithu Makkal Arasiyal Katchi,112,0,112,0.08,Tamil Nadu-Chepauk-Thiruvallikeni
10,JAYASIMMARAJA  S M,Naam Tamilar Katchi,9170,23,9193,6.69,Tamil Nadu-Chepauk-Thiruvallikeni
11,ANANDAN  K,Independent,87,1,88,0.06,Tamil Nadu-Chepauk-Thiruvallikeni
12,KANNAN C,Independent,63,2,65,0.05,Tamil Nadu-Chepauk-Thiruvallikeni
13,Ganesan P,Independent,39,0,39,0.03,Tamil Nadu-Chepauk-Thiruvallikeni
14,KRISHNADASAN S,Independent,57,0,57,0.04,Tamil Nadu-Chepauk-Thiruvallikeni
15,CHANDRANATHAN S,Independent,118,0,118,0.09,Tamil Nadu-Chepauk-Thiruvallikeni
16,SRINIVASAN,Independent,138,1,139,0.1,Tamil Nadu-Chepauk-Thiruvallikeni
17,SENTHIL KUMAR H,Independent,244,0,244,0.18,Tamil Nadu-Chepauk-Thiruvallikeni
18,DILLIRAJ P,Independent,49,0,49,0.04,Tamil Nadu-Chepauk-Thiruvallikeni
19,NAGARAJAN,Independent,109,1,110,0.08,Tamil Nadu-Chepauk-Thiruvallikeni
20,BALAJI K,Independent,34,1,35,0.03,Tamil Nadu-Chepauk-Thiruvallikeni
21,BALAJI C,Independent,53,0,53,0.04,Tamil Nadu-Chepauk-Thiruvallikeni
22,MANIKANDAN E,Independent,49,1,50,0.04,Tamil Nadu-Chepauk-Thiruvallikeni
23,MADHANA GOPAL T,Independent,42,0,42,0.03,Tamil Nadu-Chepauk-Thiruvallikeni
24,MOHAMMED HUSSAIN,Independent,33,1,34,0.02,Tamil Nadu-Chepauk-Thiruvallikeni
25,MUNIYANDI,Independent,81,0,81,0.06,Tamil Nadu-Chepauk-Thiruvallikeni
26,RAVI E,Independent,353,14,367,0.27,Tamil Nadu-Chepauk-Thiruvallikeni
27,NOTA,None of the Above,2047,14,2061,1.5,Tamil Nadu-Chepauk-Thiruvallikeni
1,DUSI. K. MOHAN,All India Anna Dravida Munnetra Kazhagam,89469,720,90189,42.05,Tamil Nadu-Cheyyar
2,VIJAYAKANTH. S,Bahujan Samaj Party,726,5,731,0.34,Tamil Nadu-Cheyyar
3,JOTHI. O,Dravida Munnetra Kazhagam,101080,1380,102460,47.78,Tamil Nadu-Cheyyar
4,KUTTIMANI. S,Veerath Thiyagi Viswanathadoss Thozhilalarkal Katchi,503,1,504,0.24,Tamil Nadu-Cheyyar
5,NADARAJAN. B,New Generation Peopleâ€™s Party,189,1,190,0.09,Tamil Nadu-Cheyyar
6,BHEEMAN. G,Naam Tamilar Katchi,12112,80,12192,5.68,Tamil Nadu-Cheyyar
7,MANIKANDAN. M,Ganasangam Party of India,259,3,262,0.12,Tamil Nadu-Cheyyar
8,MAYILVAGANAN. T,Makkal Needhi Maiam,2403,26,2429,1.13,Tamil Nadu-Cheyyar
9,MARYVOILET. J,Desiya Sirupanmayinar Makkal Iyakkam,131,12,143,0.07,Tamil Nadu-Cheyyar
10,VARADHARAJAN. M. K,Amma Makkal Munnettra Kazagam,1748,12,1760,0.82,Tamil Nadu-Cheyyar
11,VENKATESAN .V,Anaithindia Samudaya Munnetra Kazhagam,100,12,112,0.05,Tamil Nadu-Cheyyar
12,ANANDASEKARAN. C,Independent,286,2,288,0.13,Tamil Nadu-Cheyyar
13,UDHAYAKUMAR. M,Independent,289,1,290,0.14,Tamil Nadu-Cheyyar
14,SURESH BABU. T,Independent,731,2,733,0.34,Tamil Nadu-Cheyyar
15,NIRMALA. V,Independent,281,1,282,0.13,Tamil Nadu-Cheyyar
16,NOTA,None of the Above,1882,13,1895,0.88,Tamil Nadu-Cheyyar
1,Ilayaraja S,Bahujan Samaj Party,960,4,964,0.54,Tamil Nadu-Cheyyur
2,Kanitha S,All India Anna Dravida Munnetra Kazhagam,78144,564,78708,43.94,Tamil Nadu-Cheyyur
3,Siva A,Desiya Murpokku Dravida Kazhagam,3026,28,3054,1.71,Tamil Nadu-Cheyyur
4,Anbu Tamilsekaran P,Makkal Needhi Maiam,1927,41,1968,1.1,Tamil Nadu-Cheyyur
5,Babu M,Viduthalai Chiruthaigal Katchi,81533,1217,82750,46.2,Tamil Nadu-Cheyyur
6,Rajesh R,Naam Tamilar Katchi,9568,85,9653,5.39,Tamil Nadu-Cheyyur
7,Amarnath B,Independent,215,1,216,0.12,Tamil Nadu-Cheyyur
8,Babu E,Independent,247,16,263,0.15,Tamil Nadu-Cheyyur
9,Vinoth M,Independent,402,1,403,0.22,Tamil Nadu-Cheyyur
10,NOTA,None of the Above,1127,14,1141,0.64,Tamil Nadu-Cheyyur
1,D. CHANDRA PRABU,Bahujan Samaj Party,474,4,478,0.26,Tamil Nadu-Chidambaram
2,K.A. PANDIAN,All India Anna Dravida Munnetra Kazhagam,90523,1438,91961,50.16,Tamil Nadu-Chidambaram
3,S. ABDUL RAHMAN,Indian Union Muslim League,73773,1251,75024,40.92,Tamil Nadu-Chidambaram
4,K. UDAYA SELVAN,Anaithu Makkal Puratchi Katchi,304,1,305,0.17,Tamil Nadu-Chidambaram
5,G. DEVASAGAYAM,Makkal Needhi Maiam,2924,29,2953,1.61,Tamil Nadu-Chidambaram
6,NATARAJAN KRISHNAMOORTHY,Naam Tamilar Katchi,9021,50,9071,4.95,Tamil Nadu-Chidambaram
7,M. NANTHINIDEVI,Amma Makkal Munnettra Kazagam,1380,8,1388,0.76,Tamil Nadu-Chidambaram
8,M. RAGHUNATHAN,Ilantamilar Munnani Kazhagam,145,1,146,0.08,Tamil Nadu-Chidambaram
9,B. NARAYANAMOORTHY,Independent,240,2,242,0.13,Tamil Nadu-Chidambaram
10,S. BALAMURUGAN,Independent,335,2,337,0.18,Tamil Nadu-Chidambaram
11,C. VINOBA,Independent,245,0,245,0.13,Tamil Nadu-Chidambaram
12,NOTA,None of the Above,1190,12,1202,0.66,Tamil Nadu-Chidambaram
1,AMMAN K.ARJUNAN,All India Anna Dravida Munnetra Kazhagam,80815,639,81454,40.16,Tamil Nadu-Coimbatore (North)
2,SHANMUGASUNDARAM V.M,Dravida Munnetra Kazhagam,76201,1252,77453,38.19,Tamil Nadu-Coimbatore (North)
3,APPATHURAI N.R,Amma Makkal Munnettra Kazagam,1650,9,1659,0.82,Tamil Nadu-Coimbatore (North)
4,RAJKUMAR M.P,Makkal Munnetra Peravai,83,3,86,0.04,Tamil Nadu-Coimbatore (North)
5,KANNAPIRAN V,Dravida Murpokku Makkal Katchi,128,0,128,0.06,Tamil Nadu-Coimbatore (North)
6,THANGAVELU R,Makkal Needhi Maiam,26335,168,26503,13.07,Tamil Nadu-Coimbatore (North)
7,DURAIRAJ K,Tamil Nadu Ilangyar Katchi,529,2,531,0.26,Tamil Nadu-Coimbatore (North)
8,PANNEER SELVARAJ M,New Generation Peopleâ€™s Party,135,0,135,0.07,Tamil Nadu-Coimbatore (North)
9,Balendran C.B,Naam Tamilar Katchi,11388,45,11433,5.64,Tamil Nadu-Coimbatore (North)
10,ARUL MURUGAN A,Independent,138,1,139,0.07,Tamil Nadu-Coimbatore (North)
11,KUMAR G.D.K,Independent,124,0,124,0.06,Tamil Nadu-Coimbatore (North)
12,KEERTHIGA PARTHASARATHI,Independent,245,5,250,0.12,Tamil Nadu-Coimbatore (North)
13,SHANMUGASUNDARAM K,Independent,55,2,57,0.03,Tamil Nadu-Coimbatore (North)
14,DALIT. SU. JEYARAJ,Independent,49,0,49,0.02,Tamil Nadu-Coimbatore (North)
15,NAVAMANI R,Independent,141,0,141,0.07,Tamil Nadu-Coimbatore (North)
16,BALAMURUGAN M,Independent,313,0,313,0.15,Tamil Nadu-Coimbatore (North)
17,BALAJI V,Independent,248,0,248,0.12,Tamil Nadu-Coimbatore (North)
18,MAHARISHI MANDHARACSALAM,Independent,232,1,233,0.11,Tamil Nadu-Coimbatore (North)
19,RAMESHKUMAR D,Independent,22,0,22,0.01,Tamil Nadu-Coimbatore (North)
20,LOGANATHAN M,Independent,139,1,140,0.07,Tamil Nadu-Coimbatore (North)
21,NOTA,None of the Above,1678,23,1701,0.84,Tamil Nadu-Coimbatore (North)
1,MAYURA S JAYAKUMAR,Indian National Congress,41663,720,42383,27.39,Tamil Nadu-Coimbatore (South)
2,ROSHAN,Bahujan Samaj Party,272,2,274,0.18,Tamil Nadu-Coimbatore (South)
3,VANATHI SRINIVASAN,Bharatiya Janata Party,52627,582,53209,34.38,Tamil Nadu-Coimbatore (South)
4,ABDUL WAHAB,Naam Tamilar Katchi,4265,35,4300,2.78,Tamil Nadu-Coimbatore (South)
5,KAMALHAASAN,Makkal Needhi Maiam,51087,394,51481,33.26,Tamil Nadu-Coimbatore (South)
6,GOPALAKRISHNAN,New Generation Peopleâ€™s Party,126,1,127,0.08,Tamil Nadu-Coimbatore (South)
7,SANMUGAVEL,Ganasangam Party of India,76,0,76,0.05,Tamil Nadu-Coimbatore (South)
8,DURAISAMY @ CHALLENGER DURAI,Amma Makkal Munnettra Kazagam,690,11,701,0.45,Tamil Nadu-Coimbatore (South)
9,RAGHUL GANDHI .K,Hindustan Janta Party,72,1,73,0.05,Tamil Nadu-Coimbatore (South)
10,VIVEK SUBRAMANIAM,Manitha Urimaigal Kalaagam,74,0,74,0.05,Tamil Nadu-Coimbatore (South)
11,VELLIMALAI,"Makkal Sananayaga Kudiyarasu Katchi,",59,0,59,0.04,Tamil Nadu-Coimbatore (South)
12,ALPHONSERAJ,Independent,51,0,51,0.03,Tamil Nadu-Coimbatore (South)
13,KUMAREASAN. K,Independent,58,0,58,0.04,Tamil Nadu-Coimbatore (South)
14,SUNDARAVADIVELU,Independent,190,0,190,0.12,Tamil Nadu-Coimbatore (South)
15,CHELLADURAI. S,Independent,29,0,29,0.02,Tamil Nadu-Coimbatore (South)
16,SELVAKUMAR,Independent,163,0,163,0.11,Tamil Nadu-Coimbatore (South)
17,DHANDABANI,Independent,181,0,181,0.12,Tamil Nadu-Coimbatore (South)
18,NAGAVALLI,Independent,134,1,135,0.09,Tamil Nadu-Coimbatore (South)
19,PALANIKUMAR.V,Independent,136,0,136,0.09,Tamil Nadu-Coimbatore (South)
20,JAYACHANDRAN,Independent,62,0,62,0.04,Tamil Nadu-Coimbatore (South)
21,JAYAPRAKASH.N,Independent,99,3,102,0.07,Tamil Nadu-Coimbatore (South)
22,NOTA,None of the Above,887,14,901,0.58,Tamil Nadu-Coimbatore (South)
1,Anish K.M.,Bahujan Samaj Party,829,2,831,0.45,Tamil Nadu-Colachal
2,Sivakumar M.,Desiya Murpokku Dravida Kazhagam,1320,12,1332,0.73,Tamil Nadu-Colachal
3,Prince J.G.,Indian National Congress,89121,1560,90681,49.56,Tamil Nadu-Colachal
4,Ramesh P.,Bharatiya Janata Party,65047,802,65849,35.99,Tamil Nadu-Colachal
5,Anthony Muthu S.M.,Communist Party of India  (Marxist-Leninist)  (Liberation),1203,15,1218,0.67,Tamil Nadu-Colachal
6,Antony Aslin J.,Naam Tamilar Katchi,18071,131,18202,9.95,Tamil Nadu-Colachal
7,Krishna Kumar A.,Anaithu Makkal Puratchi Katchi,1143,2,1145,0.63,Tamil Nadu-Colachal
8,Raja C.,Shiv Sena,103,0,103,0.06,Tamil Nadu-Colachal
9,Lathis Mary S.,Makkal Needhi Maiam,2117,10,2127,1.16,Tamil Nadu-Colachal
10,"Mohammed Ali, Professor, S.",Independent,130,0,130,0.07,Tamil Nadu-Colachal
11,Marystella R.,Independent,201,0,201,0.11,Tamil Nadu-Colachal
12,Vijayakumar R.,Independent,270,2,272,0.15,Tamil Nadu-Colachal
13,NOTA,None of the Above,870,8,878,0.48,Tamil Nadu-Colachal
1,"Prabhu Inbadass, S.",All India Trinamool Congress,399,5,404,0.3,Tamil Nadu-Coonoor
2,"Ramachandran, K.",Dravida Munnetra Kazhagam,60471,1349,61820,45.49,Tamil Nadu-Coonoor
3,"Vinoth, D.",All India Anna Dravida Munnetra Kazhagam,57254,461,57715,42.47,Tamil Nadu-Coonoor
4,"Arumugam, R.",Anaithu Makkal Puratchi Katchi,435,4,439,0.32,Tamil Nadu-Coonoor
5,"Kalaiselvan, S.",Amma Makkal Munnettra Kazagam,2499,28,2527,1.86,Tamil Nadu-Coonoor
6,"Rajakumar, H.B.",Makkal Needhi Maiam,3587,34,3621,2.66,Tamil Nadu-Coonoor
7,"Lavanya, M.",Naam Tamilar Katchi,7182,70,7252,5.34,Tamil Nadu-Coonoor
8,"Chandran, K.",Independent,107,2,109,0.08,Tamil Nadu-Coonoor
9,"Basha, A.",Independent,313,7,320,0.24,Tamil Nadu-Coonoor
10,"Jayaprakash, D",Independent,509,4,513,0.38,Tamil Nadu-Coonoor
11,NOTA,None of the Above,1177,11,1188,0.87,Tamil Nadu-Coonoor
1,G.IYAPPAN,Dravida Munnetra Kazhagam,82813,1750,84563,46.46,Tamil Nadu-Cuddalore
2,M.C.SAMPATH,All India Anna Dravida Munnetra Kazhagam,78004,1408,79412,43.63,Tamil Nadu-Cuddalore
3,A.GNANAPANDITHAN,Desiya Murpokku Dravida Kazhagam,1489,10,1499,0.82,Tamil Nadu-Cuddalore
4,R.VALLAL KUMAR,Bahujan Samaj Party,78,1,79,0.04,Tamil Nadu-Cuddalore
5,K.ANANDRAJ,Makkal Needhi Maiam,4005,35,4040,2.22,Tamil Nadu-Cuddalore
6,S.PUSHBARAJ,Tamil Nadu Ilangyar Katchi,608,9,617,0.34,Tamil Nadu-Cuddalore
7,A.Mohamed Usman,Anna Puratchi Thalaivar Amma Dravida Munnetra Kazhagam,29,0,29,0.02,Tamil Nadu-Cuddalore
8,S.V.RAJARAJAN,Desiya Makkal Sakthi Katchi,74,0,74,0.04,Tamil Nadu-Cuddalore
9,JALADEEPAN.V,Naam Tamilar Katchi,9480,83,9563,5.25,Tamil Nadu-Cuddalore
10,G.KRISHNAN,Independent,25,4,29,0.02,Tamil Nadu-Cuddalore
11,S.SAMPATH,Independent,46,0,46,0.03,Tamil Nadu-Cuddalore
12,K.THANGARASU,Independent,31,0,31,0.02,Tamil Nadu-Cuddalore
13,V. DAKSHNAMOORTHY,Independent,183,2,185,0.1,Tamil Nadu-Cuddalore
14,S.DEENADHAYALAN,Independent,289,2,291,0.16,Tamil Nadu-Cuddalore
15,J.JACOB,Independent,307,0,307,0.17,Tamil Nadu-Cuddalore
16,NOTA,None of the Above,1228,8,1236,0.68,Tamil Nadu-Cuddalore
1,N.Ramakrishnan,Dravida Munnetra Kazhagam,102652,2148,104800,51.81,Tamil Nadu-Cumbum
2,Syedukhan.S.P.M,All India Anna Dravida Munnetra Kazhagam,61978,409,62387,30.84,Tamil Nadu-Cumbum
3,Anish Fathima. A,Naam Tamilar Katchi,12123,224,12347,6.1,Tamil Nadu-Cumbum
4,KATHIRAVAN.S,New Generation Peopleâ€™s Party,232,4,236,0.12,Tamil Nadu-Cumbum
5,Suresh.P,Amma Makkal Munnettra Kazagam,14399,137,14536,7.19,Tamil Nadu-Cumbum
6,Pandi Selvam.R,Anna Puratchi Thalaivar Amma Dravida Munnetra Kazhagam,148,3,151,0.07,Tamil Nadu-Cumbum
7,RADHAKRISHNAN.K,Anaithu Makkal Puratchi Katchi,121,1,122,0.06,Tamil Nadu-Cumbum
8,Lal Bahdur Sasthri.V,My India Party,116,4,120,0.06,Tamil Nadu-Cumbum
9,Venkidesh.N,Makkal Needhi Maiam,4582,65,4647,2.3,Tamil Nadu-Cumbum
10,SARAVANAN.S.R,Independent,320,1,321,0.16,Tamil Nadu-Cumbum
11,THAVIDHU RAJA. A,Independent,99,2,101,0.05,Tamil Nadu-Cumbum
12,Prakash.P,Independent,152,3,155,0.08,Tamil Nadu-Cumbum
13,MARIMUTHU.G,Independent,105,1,106,0.05,Tamil Nadu-Cumbum
14,MUTHUSELVAM.G,Independent,134,2,136,0.07,Tamil Nadu-Cumbum
15,MUTHU MUNEESWARAN.M,Independent,450,1,451,0.22,Tamil Nadu-Cumbum
16,NOTA,None of the Above,1625,34,1659,0.82,Tamil Nadu-Cumbum
1,KAYALVIZHI N,Dravida Munnetra Kazhagam,88471,1515,89986,46.39,Tamil Nadu-Dharapuram
2,MURUGAN L,Bharatiya Janata Party,87964,629,88593,45.67,Tamil Nadu-Dharapuram
3,RANGASAMY S,Bahujan Samaj Party,638,2,640,0.33,Tamil Nadu-Dharapuram
4,KALARANI C,Amma Makkal Munnettra Kazagam,1166,6,1172,0.6,Tamil Nadu-Dharapuram
5,CHARLI A,Makkal Needhi Maiam,2114,16,2130,1.1,Tamil Nadu-Dharapuram
6,CHIDAMBHARAM V,India Dravida Makkal Munnetra Katchi,123,3,126,0.06,Tamil Nadu-Dharapuram
7,MUNIYAPPAN A,Anna Puratchi Thalaivar Amma Dravida Munnetra Kazhagam,220,0,220,0.11,Tamil Nadu-Dharapuram
8,RANJITHA K,Naam Tamilar Katchi,6691,62,6753,3.48,Tamil Nadu-Dharapuram
9,ANANTHI S,Independent,152,5,157,0.08,Tamil Nadu-Dharapuram
10,KAYALVIZHI K,Independent,887,5,892,0.46,Tamil Nadu-Dharapuram
11,KAYALVIZHI P,Independent,201,1,202,0.1,Tamil Nadu-Dharapuram
12,KARTHIKEYAN A,Independent,157,1,158,0.08,Tamil Nadu-Dharapuram
13,SELVARAJ V,Independent,233,0,233,0.12,Tamil Nadu-Dharapuram
14,MURUGAN A,Independent,824,2,826,0.43,Tamil Nadu-Dharapuram
15,NOTA,None of the Above,1881,22,1903,0.98,Tamil Nadu-Dharapuram
1,SUBRAMANI.P,Dravida Munnetra Kazhagam,76846,1924,78770,36.24,Tamil Nadu-Dharmapuri
2,PERUMAL.P,Bahujan Samaj Party,462,2,464,0.21,Tamil Nadu-Dharmapuri
3,SAKTHIVEL.P.,Desiya Makkal Sakthi Katchi,210,3,213,0.1,Tamil Nadu-Dharmapuri
4,SENTHIL KUMAR (A) SENTHIL.A.,Naam Tamilar Katchi,8609,91,8700,4,Tamil Nadu-Dharmapuri
5,NATARAJAN.M.,Anna Puratchi Thalaivar Amma Dravida Munnetra Kazhagam,1890,7,1897,0.87,Tamil Nadu-Dharmapuri
6,MANI.L.,Dhesiya Makkal Kazhagam,194,0,194,0.09,Tamil Nadu-Dharmapuri
7,RAMASAMY.T.,My India Party,208,0,208,0.1,Tamil Nadu-Dharmapuri
8,RAJENDRAN.D.K.,Amma Makkal Munnettra Kazagam,11166,60,11226,5.17,Tamil Nadu-Dharmapuri
9,VENKATESHWARAN.S.P.,Pattali Makkal Katchi,104415,1215,105630,48.6,Tamil Nadu-Dharmapuri
10,JAYAVENKATESAN.S.K.,Makkal Needhi Maiam,5034,49,5083,2.34,Tamil Nadu-Dharmapuri
11,SHANMUGAM.P.,Independent,236,1,237,0.11,Tamil Nadu-Dharmapuri
12,SUNDARAMOORTHY.M.,Independent,126,1,127,0.06,Tamil Nadu-Dharmapuri
13,SUBRAMANI.P.,Independent,110,0,110,0.05,Tamil Nadu-Dharmapuri
14,SUBRAMANI.K.,Independent,364,0,364,0.17,Tamil Nadu-Dharmapuri
15,SUBRAMANI.T.,Independent,304,0,304,0.14,Tamil Nadu-Dharmapuri
16,TAMILARASAN.S.,Independent,654,0,654,0.3,Tamil Nadu-Dharmapuri
17,NATARAJAN.V.,Independent,716,2,718,0.33,Tamil Nadu-Dharmapuri
18,PALANI.S.K.,Independent,160,0,160,0.07,Tamil Nadu-Dharmapuri
19,MANIGANDAN.E.V.,Independent,355,2,357,0.16,Tamil Nadu-Dharmapuri
20,RAJENDRAN.K.,Independent,74,0,74,0.03,Tamil Nadu-Dharmapuri
21,VENKATESWARAN.B.,Independent,114,3,117,0.05,Tamil Nadu-Dharmapuri
22,NOTA,None of the Above,1713,13,1726,0.79,Tamil Nadu-Dharmapuri
1,ARASUR MANOHARAN.S,Bahujan Samaj Party,492,9,501,0.26,Tamil Nadu-Dindigul
2,SREENIVASAN.C,All India Anna Dravida Munnetra Kazhagam,89685,910,90595,46.43,Tamil Nadu-Dindigul
3,PANDI.N,Communist Party of India  (Marxist),70393,2455,72848,37.34,Tamil Nadu-Dindigul
4,AKKAMMAL.S,My India Party,301,4,305,0.16,Tamil Nadu-Dindigul
5,ALAGU PANDIAN.R,Anaithu Makkal Munnetra Kazhagam,232,0,232,0.12,Tamil Nadu-Dindigul
6,RAJENDRAN.R,Makkal Needhi Maiam,8950,113,9063,4.64,Tamil Nadu-Dindigul
7,KARTHIKEYAN.V,Anna Puratchi Thalaivar Amma Dravida Munnetra Kazhagam,92,0,92,0.05,Tamil Nadu-Dindigul
8,SIVAGANAM.A,Anaithu Makkal Puratchi Katchi,51,2,53,0.03,Tamil Nadu-Dindigul
9,MURUGESAN.A,Puthiya Tamilagam,245,9,254,0.13,Tamil Nadu-Dindigul
10,RAMUTHEVAR.P,Amma Makkal Munnettra Kazagam,2379,48,2427,1.24,Tamil Nadu-Dindigul
11,JAYASUNDAR.R,Naam Tamilar Katchi,14703,157,14860,7.62,Tamil Nadu-Dindigul
12,ANBUROSE.D,Independent,190,1,191,0.1,Tamil Nadu-Dindigul
13,SENTHIL ALAGAPPAN.A,Independent,81,1,82,0.04,Tamil Nadu-Dindigul
14,DHANASEKARAN.C,Independent,165,1,166,0.09,Tamil Nadu-Dindigul
15,NAGARAJ.N,Independent,179,1,180,0.09,Tamil Nadu-Dindigul
16,BALASUBRAMANI.K,Independent,561,9,570,0.29,Tamil Nadu-Dindigul
17,BALAJI.R,Independent,104,0,104,0.05,Tamil Nadu-Dindigul
18,BASKARAN CHELLAPPA.J,Independent,344,1,345,0.18,Tamil Nadu-Dindigul
19,RAHAMATHULLA.M,Independent,209,1,210,0.11,Tamil Nadu-Dindigul
20,VIJAYAPANDI.P,Independent,109,5,114,0.06,Tamil Nadu-Dindigul
21,HARI PRAKASH.M,Independent,118,1,119,0.06,Tamil Nadu-Dindigul
22,NOTA,None of the Above,1772,35,1807,0.93,Tamil Nadu-Dindigul
1,EBENEZER. J.J. (@)  JOHN EBENEZER.J,Dravida Munnetra Kazhagam,95516,247,95763,51.2,Tamil Nadu-Dr.Radhakrishnan Nagar
2,RAAJESH.R.S.,All India Anna Dravida Munnetra Kazhagam,53204,80,53284,28.49,Tamil Nadu-Dr.Radhakrishnan Nagar
3,VIJAYAN.P,Bahujan Samaj Party,361,0,361,0.19,Tamil Nadu-Dr.Radhakrishnan Nagar
4,RAMADASS . E,Makkal Nalvaazhvuk Katchi,104,0,104,0.06,Tamil Nadu-Dr.Radhakrishnan Nagar
5,DR. KALIDAS . P,Amma Makkal Munnettra Kazagam,1848,4,1852,0.99,Tamil Nadu-Dr.Radhakrishnan Nagar
6,GOWRISHANKAR . K,Naam Tamilar Katchi,20401,36,20437,10.93,Tamil Nadu-Dr.Radhakrishnan Nagar
7,SIVAKUMAR.S,SOCIALIST UNITY CENTRE OF INDIA (COMMUNIST),214,1,215,0.11,Tamil Nadu-Dr.Radhakrishnan Nagar
8,FAZIL . A,Makkal Needhi Maiam,11181,17,11198,5.99,Tamil Nadu-Dr.Radhakrishnan Nagar
9,BABU MAILAN . A,Republican Party of India (Athawale),115,0,115,0.06,Tamil Nadu-Dr.Radhakrishnan Nagar
10,MOHAN . R,United States of India Party,79,0,79,0.04,Tamil Nadu-Dr.Radhakrishnan Nagar
11,VENUGOPAL.D,Shiv Sena,32,2,34,0.02,Tamil Nadu-Dr.Radhakrishnan Nagar
12,ETHIRAJ.R,Independent,26,0,26,0.01,Tamil Nadu-Dr.Radhakrishnan Nagar
13,KANDEEPAN.G,Independent,111,0,111,0.06,Tamil Nadu-Dr.Radhakrishnan Nagar
14,KALIDASS,Independent,67,0,67,0.04,Tamil Nadu-Dr.Radhakrishnan Nagar
15,GUNASEKARAN.G,Independent,92,0,92,0.05,Tamil Nadu-Dr.Radhakrishnan Nagar
16,SASIDARAN.S,Independent,241,0,241,0.13,Tamil Nadu-Dr.Radhakrishnan Nagar
17,SANTHAKUMAR . A,Independent,557,0,557,0.3,Tamil Nadu-Dr.Radhakrishnan Nagar
18,Daniel Sachin Mani.E,Independent,222,0,222,0.12,Tamil Nadu-Dr.Radhakrishnan Nagar
19,DEVAKUMAR.R,Independent,48,0,48,0.03,Tamil Nadu-Dr.Radhakrishnan Nagar
20,DEVARAJ.M,Independent,48,0,48,0.03,Tamil Nadu-Dr.Radhakrishnan Nagar
21,FRANKLIN.D,Independent,44,0,44,0.02,Tamil Nadu-Dr.Radhakrishnan Nagar
22,PREMKUMAR.P,Independent,79,0,79,0.04,Tamil Nadu-Dr.Radhakrishnan Nagar
23,PURUSHOTHAMAN . K,Independent,44,0,44,0.02,Tamil Nadu-Dr.Radhakrishnan Nagar
24,BOOTHIRAJAN.G,Independent,39,0,39,0.02,Tamil Nadu-Dr.Radhakrishnan Nagar
25,MADHAN RAJ . D,Independent,22,0,22,0.01,Tamil Nadu-Dr.Radhakrishnan Nagar
26,MARIMUTHU.P,Independent,38,0,38,0.02,Tamil Nadu-Dr.Radhakrishnan Nagar
27,RAJESH . I,Independent,47,0,47,0.03,Tamil Nadu-Dr.Radhakrishnan Nagar
28,RAJESH . S,Independent,36,1,37,0.02,Tamil Nadu-Dr.Radhakrishnan Nagar
29,VIVEK.C,Independent,27,0,27,0.01,Tamil Nadu-Dr.Radhakrishnan Nagar
30,VENKATRAMAN . C,Independent,36,1,37,0.02,Tamil Nadu-Dr.Radhakrishnan Nagar
31,SRIDHAR . C,Independent,55,0,55,0.03,Tamil Nadu-Dr.Radhakrishnan Nagar
32,NOTA,None of the Above,1702,2,1704,0.91,Tamil Nadu-Dr.Radhakrishnan Nagar
1,SAMBATHKUMAR. T,Dravida Munnetra Kazhagam,68082,1270,69352,28.04,Tamil Nadu-Edappadi
2,EDAPPADI PALANISWAMI. K,All India Anna Dravida Munnetra Kazhagam,160931,2223,163154,65.97,Tamil Nadu-Edappadi
3,JAMUNA. A,Bahujan Samaj Party,813,2,815,0.33,Tamil Nadu-Edappadi
4,SOCIAL WORKER ESWARI. P,Ambedkarite Party of India,132,3,135,0.05,Tamil Nadu-Edappadi
5,GUNASEKARAN. K.N,My India Party,117,1,118,0.05,Tamil Nadu-Edappadi
6,SURIYAMOORTHY. S,MGR Makkal Katchi,64,0,64,0.03,Tamil Nadu-Edappadi
7,THASAPPARAJ. D,Makkal Needhi Maiam,1532,15,1547,0.63,Tamil Nadu-Edappadi
8,POOKADAI SEKAR. N,Amma Makkal Munnettra Kazagam,764,10,774,0.31,Tamil Nadu-Edappadi
9,MANI. C,Dhesiya Makkal Kazhagam,46,1,47,0.02,Tamil Nadu-Edappadi
10,MANIKANDAN. R,Tamil Nadu Ilangyar Katchi,147,6,153,0.06,Tamil Nadu-Edappadi
11,SHRI RATHNA,Naam Tamilar Katchi,6574,52,6626,2.68,Tamil Nadu-Edappadi
12,AGNI SRI RAMACHANDRAN. N,Independent,259,2,261,0.11,Tamil Nadu-Edappadi
13,ESWARAMURTHY. N,Independent,89,0,89,0.04,Tamil Nadu-Edappadi
14,ESWARAMOORTHY P,Independent,165,1,166,0.07,Tamil Nadu-Edappadi
15,IYYAPPAN. P,Independent,483,0,483,0.2,Tamil Nadu-Edappadi
16,KATHIRAVAN. V,Independent,555,0,555,0.22,Tamil Nadu-Edappadi
17,KATHIRESAN. L,Independent,407,0,407,0.16,Tamil Nadu-Edappadi
18,GUHESHKUMAR. M,Independent,474,0,474,0.19,Tamil Nadu-Edappadi
19,SHANMUGAM. G,Independent,66,0,66,0.03,Tamil Nadu-Edappadi
20,SOWNTHARARAJAN. G,Independent,44,0,44,0.02,Tamil Nadu-Edappadi
21,DR. PADMARAJAN. K,Independent,35,1,36,0.01,Tamil Nadu-Edappadi
22,PALANISAMY. A,Independent,26,0,26,0.01,Tamil Nadu-Edappadi
23,BALASUBRAMANIAM. J,Independent,60,1,61,0.02,Tamil Nadu-Edappadi
24,BALAMURUGAN. M,Independent,39,0,39,0.02,Tamil Nadu-Edappadi
25,MURUGAN. M,Independent,90,1,91,0.04,Tamil Nadu-Edappadi
26,LAKSHMI. G,Independent,199,0,199,0.08,Tamil Nadu-Edappadi
27,LOGANATHAN. S,Independent,208,0,208,0.08,Tamil Nadu-Edappadi
28,STALIN. A,Independent,202,0,202,0.08,Tamil Nadu-Edappadi
29,NOTA,None of the Above,1091,18,1109,0.45,Tamil Nadu-Edappadi
1,K.P.SUNDARAPRATHABAN,Bahujan Samaj Party,357,4,361,0.3,Tamil Nadu-Egmore
2,I.PARANTHAMEN,Dravida Munnetra Kazhagam,68160,672,68832,57.71,Tamil Nadu-Egmore
3,T.PRABHU,Desiya Murpokku Dravida Kazhagam,1270,23,1293,1.08,Tamil Nadu-Egmore
4,B.JOHN PANDIAN,All India Anna Dravida Munnetra Kazhagam,29729,335,30064,25.21,Tamil Nadu-Egmore
5,P.GEETHA LAKSHMI,Naam Tamilar Katchi,6237,39,6276,5.26,Tamil Nadu-Egmore
6,J.CHANDRAKALA,Lok Jan Shakti Party,91,1,92,0.08,Tamil Nadu-Egmore
7,U. PRIYADARSINI,Makkal Needhi Maiam,9933,57,9990,8.38,Tamil Nadu-Egmore
8,R.REVANTH,Anaithu Makkal Arasiyal Katchi,45,0,45,0.04,Tamil Nadu-Egmore
9,G.SHEEJA,Nam India Naam Indiyar Katchi,55,0,55,0.05,Tamil Nadu-Egmore
10,N.ARAVINTH KUMAR,Independent,38,0,38,0.03,Tamil Nadu-Egmore
11,V.ESWARAN,Independent,22,4,26,0.02,Tamil Nadu-Egmore
12,M.UTHAYAKUMAR,Independent,39,2,41,0.03,Tamil Nadu-Egmore
13,Dr.N. GUNASEKAR,Independent,107,2,109,0.09,Tamil Nadu-Egmore
14,V.SEKAR,Independent,26,2,28,0.02,Tamil Nadu-Egmore
15,A.PARANTHAMAN,Independent,98,0,98,0.08,Tamil Nadu-Egmore
16,V. PRABHU,Independent,491,1,492,0.41,Tamil Nadu-Egmore
17,G.R.RAJENDRAN,Independent,82,2,84,0.07,Tamil Nadu-Egmore
18,S.JAYAKALPANA,Independent,171,0,171,0.14,Tamil Nadu-Egmore
19,NOTA,None of the Above,1167,9,1176,0.99,Tamil Nadu-Egmore
1,"GOVINDARAJ,S.",Bahujan Samaj Party,366,6,372,0.24,Tamil Nadu-Erode (East)
2,"THIRUMAHAN EVERAA,E.",Indian National Congress,66497,803,67300,44.27,Tamil Nadu-Erode (East)
3,"YUVARAJA,M.",All India Anna Dravida Munnetra Kazhagam,58097,299,58396,38.41,Tamil Nadu-Erode (East)
4,ARUMUGA AC KANNAN,Ambedkarite Party of India,373,0,373,0.25,Tamil Nadu-Erode (East)
5,"GOMATHI,S.",Naam Tamilar Katchi,11575,54,11629,7.65,Tamil Nadu-Erode (East)
6,"SHANMUGAVEL,S.",MGR Makkal Katchi,150,1,151,0.1,Tamil Nadu-Erode (East)
7,"MUTHUKUMARAN,S.A.",Amma Makkal Munnettra Kazagam,1197,7,1204,0.79,Tamil Nadu-Erode (East)
8,"RAJA,P.","Makkal Thilagam Munnetra Kazhagam,",100,2,102,0.07,Tamil Nadu-Erode (East)
9,"RAJAKUMAR,A.M.R",Makkal Needhi Maiam,9966,39,10005,6.58,Tamil Nadu-Erode (East)
10,"ANTONY PETER,L.",Independent,95,1,96,0.06,Tamil Nadu-Erode (East)
11,"MINNAL MURUGESH,R.",Independent,72,1,73,0.05,Tamil Nadu-Erode (East)
12,"MEENAKSHI,V.",Independent,296,3,299,0.2,Tamil Nadu-Erode (East)
13,"YUVARAJ,M.",Independent,234,1,235,0.15,Tamil Nadu-Erode (East)
14,"SHAJAHAN,I.",Independent,256,0,256,0.17,Tamil Nadu-Erode (East)
15,NOTA,None of the Above,1530,16,1546,1.02,Tamil Nadu-Erode (East)
1,Ramalingam K V,All India Anna Dravida Munnetra Kazhagam,78200,468,78668,38.27,Tamil Nadu-Erode (West)
2,Dhanalakshmi A,Bahujan Samaj Party,568,0,568,0.28,Tamil Nadu-Erode (West)
3,Muthusamy S,Dravida Munnetra Kazhagam,99032,1725,100757,49.01,Tamil Nadu-Erode (West)
4,Chandra kumar P,Naam Tamilar Katchi,13297,56,13353,6.5,Tamil Nadu-Erode (West)
5,Chandran M,Ambedkarite Party of India,113,0,113,0.05,Tamil Nadu-Erode (West)
6,Sivasubramaniyan S,Amma Makkal Munnettra Kazagam,728,2,730,0.36,Tamil Nadu-Erode (West)
7,Thangavel G,United States of India Party,106,3,109,0.05,Tamil Nadu-Erode (West)
8,Durai Sevugan,Makkal Needhi Maiam,8068,39,8107,3.94,Tamil Nadu-Erode (West)
9,Balasubramaniam K,India Dravida Makkal Munnetra Katchi,54,0,54,0.03,Tamil Nadu-Erode (West)
10,Madhan K,Ganasangam Party of India,108,0,108,0.05,Tamil Nadu-Erode (West)
11,Iyyavu R,Independent,71,2,73,0.04,Tamil Nadu-Erode (West)
12,Kalithass R,Independent,166,3,169,0.08,Tamil Nadu-Erode (West)
13,Muthusamy A,Independent,189,0,189,0.09,Tamil Nadu-Erode (West)
14,Vimala M,Independent,432,2,434,0.21,Tamil Nadu-Erode (West)
15,VENGATESAN A,Independent,177,2,179,0.09,Tamil Nadu-Erode (West)
16,NOTA,None of the Above,1954,14,1968,0.96,Tamil Nadu-Erode (West)
1,M.Chinnadurai,Communist Party of India  (Marxist),68715,995,69710,44.23,Tamil Nadu-Gandarvakkottai
2,S.Jayabharathi,All India Anna Dravida Munnetra Kazhagam,56681,308,56989,36.16,Tamil Nadu-Gandarvakkottai
3,P.Asaithambi,Communist Party of India  (Marxist-Leninist)  (Liberation),1260,11,1271,0.81,Tamil Nadu-Gandarvakkottai
4,KRM.Adhidravidar,Makkal Needhi Maiam,843,5,848,0.54,Tamil Nadu-Gandarvakkottai
5,M.Thanaraj,Namadhu Makkal Katchi,133,0,133,0.08,Tamil Nadu-Gandarvakkottai
6,S.Malarvizhi,Anaithu Makkal Arasiyal Katchi,188,2,190,0.12,Tamil Nadu-Gandarvakkottai
7,M.Ramila,Naam Tamilar Katchi,12606,55,12661,8.03,Tamil Nadu-Gandarvakkottai
8,P.Lenin,Amma Makkal Munnettra Kazagam,12728,112,12840,8.15,Tamil Nadu-Gandarvakkottai
9,V.Ilaiyaraja,Independent,129,1,130,0.08,Tamil Nadu-Gandarvakkottai
10,P.Karthikeyan,Independent,286,3,289,0.18,Tamil Nadu-Gandarvakkottai
11,Keerai.A.T.Chinnappa,Independent,109,2,111,0.07,Tamil Nadu-Gandarvakkottai
12,K. Manimuthu,Independent,231,1,232,0.15,Tamil Nadu-Gandarvakkottai
13,P.Rengasamy,Independent,206,0,206,0.13,Tamil Nadu-Gandarvakkottai
14,V.Rethinam,Independent,620,0,620,0.39,Tamil Nadu-Gandarvakkottai
15,NOTA,None of the Above,1384,6,1390,0.88,Tamil Nadu-Gandarvakkottai
1,"SELLAMMAL,V.M.",Bahujan Samaj Party,481,4,485,0.26,Tamil Nadu-Gangavalli
2,"NALLATHAMBI,A.",All India Anna Dravida Munnetra Kazhagam,88900,668,89568,48.02,Tamil Nadu-Gangavalli
3,"REKHA PRIYADHARSHINI,J.",Dravida Munnetra Kazhagam,80466,1741,82207,44.08,Tamil Nadu-Gangavalli
4,"NAVAN,P.",Puthiya Tamilagam,603,6,609,0.33,Tamil Nadu-Gangavalli
5,"PANDIAN,A.",Amma Makkal Munnettra Kazagam,1497,22,1519,0.81,Tamil Nadu-Gangavalli
6,"PERIYASAMY,K.",Indiya Jananayaka Katchi,488,5,493,0.26,Tamil Nadu-Gangavalli
7,"VINOTHINI,R.",Naam Tamilar Katchi,9241,82,9323,5,Tamil Nadu-Gangavalli
8,"AYYADURAI,J.",Independent,104,1,105,0.06,Tamil Nadu-Gangavalli
9,"CHANDRASEKARAN,K.",Independent,155,0,155,0.08,Tamil Nadu-Gangavalli
10,"SARAVANAN,R.",Independent,396,0,396,0.21,Tamil Nadu-Gangavalli
11,"SENTHILKUMAR,K.",Independent,392,0,392,0.21,Tamil Nadu-Gangavalli
12,NOTA,None of the Above,1241,10,1251,0.67,Tamil Nadu-Gangavalli
1,MASTHAN K S,Dravida Munnetra Kazhagam,107683,1942,109625,52.99,Tamil Nadu-Gingee
2,JAGAJANANDAM  R,Bahujan Samaj Party,632,5,637,0.31,Tamil Nadu-Gingee
3,ELUMALAI N A,Anna Dravidar Kazhagam,401,9,410,0.2,Tamil Nadu-Gingee
4,GOWTHAM SAGAR A,Amma Makkal Munnettra Kazagam,4751,60,4811,2.33,Tamil Nadu-Gingee
5,SUGUMAR AP,Naam Tamilar Katchi,9860,60,9920,4.8,Tamil Nadu-Gingee
6,RAJENDIRAN P,Pattali Makkal Katchi,73078,744,73822,35.68,Tamil Nadu-Gingee
7,SRIPATHI P,Makkal Needhi Maiam,2137,14,2151,1.04,Tamil Nadu-Gingee
8,KIRUBAKARAN T,Independent,179,2,181,0.09,Tamil Nadu-Gingee
9,GOPI S,Independent,1911,3,1914,0.93,Tamil Nadu-Gingee
10,SAHEERA,Independent,167,1,168,0.08,Tamil Nadu-Gingee
11,SENJIRAJA KNK,Independent,156,1,157,0.08,Tamil Nadu-Gingee
12,MARIYAPPAN S,Independent,245,1,246,0.12,Tamil Nadu-Gingee
13,VARTHAMANAN B,Independent,554,5,559,0.27,Tamil Nadu-Gingee
14,NOTA,None of the Above,2275,4,2279,1.1,Tamil Nadu-Gingee
1,SENGOTTAIYAN K.A,All India Anna Dravida Munnetra Kazhagam,107571,1037,108608,50.68,Tamil Nadu-Gobichettipalayam
2,PALANISAMY P,Bahujan Samaj Party,1027,7,1034,0.48,Tamil Nadu-Gobichettipalayam
3,MANIMARAN G.V,Dravida Munnetra Kazhagam,78488,1557,80045,37.36,Tamil Nadu-Gobichettipalayam
4,SAKTHIVEL G,India Dravida Makkal Munnetra Katchi,412,3,415,0.19,Tamil Nadu-Gobichettipalayam
5,SEETHALAKSHMI M.K,Naam Tamilar Katchi,11661,58,11719,5.47,Tamil Nadu-Gobichettipalayam
6,THULASIMANI N.K,Amma Makkal Munnettra Kazagam,2653,29,2682,1.25,Tamil Nadu-Gobichettipalayam
7,PRAKASH N.K,Makkal Needhi Maiam,4258,33,4291,2,Tamil Nadu-Gobichettipalayam
8,KUMAR D,Independent,128,2,130,0.06,Tamil Nadu-Gobichettipalayam
9,SANKARKUMAR K.A,Independent,157,0,157,0.07,Tamil Nadu-Gobichettipalayam
10,SELVAKKUMAR S,Independent,77,0,77,0.04,Tamil Nadu-Gobichettipalayam
11,DHANABAL K,Independent,310,1,311,0.15,Tamil Nadu-Gobichettipalayam
12,DEVARAJ N,Independent,305,2,307,0.14,Tamil Nadu-Gobichettipalayam
13,PALANISAMYRAAJ M,Independent,426,4,430,0.2,Tamil Nadu-Gobichettipalayam
14,BOOPATHIRAJA  A.N,Independent,418,0,418,0.2,Tamil Nadu-Gobichettipalayam
15,MUTHUMANI P,Independent,296,0,296,0.14,Tamil Nadu-Gobichettipalayam
16,MOHANRAJ K,Independent,789,0,789,0.37,Tamil Nadu-Gobichettipalayam
17,RAKKIMUTHU RANGANADAR R,Independent,611,0,611,0.29,Tamil Nadu-Gobichettipalayam
18,JUNAYATH M,Independent,178,0,178,0.08,Tamil Nadu-Gobichettipalayam
19,SRIDEVI R,Independent,473,3,476,0.22,Tamil Nadu-Gobichettipalayam
20,NOTA,None of the Above,1295,12,1307,0.61,Tamil Nadu-Gobichettipalayam
1,"KASILINGAM, S.",Dravida Munnetra Kazhagam,61564,987,62551,45.24,Tamil Nadu-Gudalur
2,PON.JAYASEELAN,All India Anna Dravida Munnetra Kazhagam,63810,686,64496,46.65,Tamil Nadu-Gudalur
3,"YOGESWARAN, A.",Desiya Murpokku Dravida Kazhagam,1160,13,1173,0.85,Tamil Nadu-Gudalur
4,"KETHEESWARAN, R.",Naam Tamilar Katchi,7252,65,7317,5.29,Tamil Nadu-Gudalur
5,"BABU, J.",Makkal Needhi Maiam,950,10,960,0.69,Tamil Nadu-Gudalur
6,"JAYAPRAKASH, P.",Tamilaga Makkal Thannurimai Katchi,321,1,322,0.23,Tamil Nadu-Gudalur
7,"SARAVANAN, M.",Independent,417,4,421,0.3,Tamil Nadu-Gudalur
8,NOTA,None of the Above,1003,14,1017,0.74,Tamil Nadu-Gudalur
1,Amulu.V,Dravida Munnetra Kazhagam,99525,887,100412,47.45,Tamil Nadu-Gudiyattam
2,Paritha.G,All India Anna Dravida Munnetra Kazhagam,93066,445,93511,44.19,Tamil Nadu-Gudiyattam
3,Raja.S,Bahujan Samaj Party,502,3,505,0.24,Tamil Nadu-Gudiyattam
4,Kalaiyenthiri.R,Naam Tamilar Katchi,11776,58,11834,5.59,Tamil Nadu-Gudiyattam
5,Selvavinayagam.D,All Pensionerâ€™s Party,117,2,119,0.06,Tamil Nadu-Gudiyattam
6,Rajan.C,Indiya Jananayaka Katchi,477,5,482,0.23,Tamil Nadu-Gudiyattam
7,Vennila.R,Republican Party of India (Athawale),65,2,67,0.03,Tamil Nadu-Gudiyattam
8,Jayanthi Padmanaban.C,Amma Makkal Munnettra Kazagam,1793,17,1810,0.86,Tamil Nadu-Gudiyattam
9,Elumalai.M,Independent,166,2,168,0.08,Tamil Nadu-Gudiyattam
10,Gunaseelan.P,Independent,137,0,137,0.06,Tamil Nadu-Gudiyattam
11,Priya.M,Independent,60,2,62,0.03,Tamil Nadu-Gudiyattam
12,Manojkumar.G,Independent,52,0,52,0.02,Tamil Nadu-Gudiyattam
13,Radha,Independent,66,0,66,0.03,Tamil Nadu-Gudiyattam
14,Lakshmipathy.N,Independent,255,2,257,0.12,Tamil Nadu-Gudiyattam
15,Jaikarthikeyan.K,Independent,448,1,449,0.21,Tamil Nadu-Gudiyattam
16,NOTA,None of the Above,1691,8,1699,0.8,Tamil Nadu-Gudiyattam
1,GOVINDARAJAN T.J,Dravida Munnetra Kazhagam,125001,1451,126452,56.94,Tamil Nadu-Gummidipoondi
2,DILLIY K.M,Desiya Murpokku Dravida Kazhagam,2553,23,2576,1.16,Tamil Nadu-Gummidipoondi
3,NAGARAJ S,Bahujan Samaj Party,1031,7,1038,0.47,Tamil Nadu-Gummidipoondi
4,USHA,Naam Tamilar Katchi,11643,58,11701,5.27,Tamil Nadu-Gummidipoondi
5,GOWTHAM J,Anaithu Makkal Arasiyal Katchi,254,0,254,0.11,Tamil Nadu-Gummidipoondi
6,SARAVANAN V,Indiya Jananayaka Katchi,813,3,816,0.37,Tamil Nadu-Gummidipoondi
7,PRAKASH M,Pattali Makkal Katchi,75004,510,75514,34,Tamil Nadu-Gummidipoondi
8,SARAVANAN E,Independent,526,6,532,0.24,Tamil Nadu-Gummidipoondi
9,DEVANATHAN R,Independent,482,0,482,0.22,Tamil Nadu-Gummidipoondi
10,PRAKASH K,Independent,349,2,351,0.16,Tamil Nadu-Gummidipoondi
11,PRAKASH M,Independent,196,0,196,0.09,Tamil Nadu-Gummidipoondi
12,LAKSHMI R,Independent,369,5,374,0.17,Tamil Nadu-Gummidipoondi
13,NOTA,None of the Above,1775,8,1783,0.8,Tamil Nadu-Gummidipoondi
1,SEKARBABU. P.K,Dravida Munnetra Kazhagam,59073,244,59317,58.35,Tamil Nadu-Harbour
2,RAVIKUMAR. C,Bahujan Samaj Party,410,0,410,0.4,Tamil Nadu-Harbour
3,VINOJ. P. SELVAM,Bharatiya Janata Party,31971,72,32043,31.52,Tamil Nadu-Harbour
4,AHAMED FAZIL. M,Naam Tamilar Katchi,3345,12,3357,3.3,Tamil Nadu-Harbour
5,SANTHANA KRISHNAN. P,Amma Makkal Munnettra Kazagam,771,4,775,0.76,Tamil Nadu-Harbour
6,RAMESH. A,Makkal Needhi Maiam,3758,5,3763,3.7,Tamil Nadu-Harbour
7,ANANDRAJ. T.K,Independent,21,0,21,0.02,Tamil Nadu-Harbour
8,UDHAYAKUMAR. V,Independent,25,0,25,0.02,Tamil Nadu-Harbour
9,GANESH. S,Independent,68,0,68,0.07,Tamil Nadu-Harbour
10,KAMAL. J,Independent,45,2,47,0.05,Tamil Nadu-Harbour
11,KRISHNAKUMAR. G,Independent,22,0,22,0.02,Tamil Nadu-Harbour
12,SHANKAR. A,Independent,37,1,38,0.04,Tamil Nadu-Harbour
13,CHANDRAN. R,Independent,13,0,13,0.01,Tamil Nadu-Harbour
14,SIVARAMAN. G,Independent,40,0,40,0.04,Tamil Nadu-Harbour
15,ZIONRAJ. M,Independent,18,0,18,0.02,Tamil Nadu-Harbour
16,SURESH. R,Independent,117,0,117,0.12,Tamil Nadu-Harbour
17,SELVAM. P,Independent,247,0,247,0.24,Tamil Nadu-Harbour
18,SELVAKUMAR. R,Independent,37,0,37,0.04,Tamil Nadu-Harbour
19,SELVARAJ. S,Independent,63,0,63,0.06,Tamil Nadu-Harbour
20,DAMODHARAN. A.G,Independent,20,0,20,0.02,Tamil Nadu-Harbour
21,NAGARAJ. S,Independent,10,0,10,0.01,Tamil Nadu-Harbour
22,PUGALENTHI. P,Independent,28,0,28,0.03,Tamil Nadu-Harbour
23,MAHALINGAM. D,Independent,10,0,10,0.01,Tamil Nadu-Harbour
24,RAGHUNATH. K,Independent,13,0,13,0.01,Tamil Nadu-Harbour
25,RAMESH. D,Independent,11,1,12,0.01,Tamil Nadu-Harbour
26,RAMKI. P,Independent,33,0,33,0.03,Tamil Nadu-Harbour
27,VIVEK RAM. A,Independent,166,0,166,0.16,Tamil Nadu-Harbour
28,SRINIVASAN. P,Independent,25,0,25,0.02,Tamil Nadu-Harbour
29,NOTA,None of the Above,909,3,912,0.9,Tamil Nadu-Harbour
1,KUMAR.A,Communist Party of India  (Marxist),67358,1341,68699,34.6,Tamil Nadu-Harur
2,SAMPATHKUMAR.V,All India Anna Dravida Munnetra Kazhagam,98130,931,99061,49.89,Tamil Nadu-Harur
3,SIVAKUMAR.A,Bahujan Samaj Party,920,0,920,0.46,Tamil Nadu-Harur
4,KARUTHOVIYAM.P,My India Party,377,5,382,0.19,Tamil Nadu-Harur
5,KEERTHANA.K,Naam Tamilar Katchi,10830,120,10950,5.51,Tamil Nadu-Harur
6,SATHISKUMAR.S,Indiya Jananayaka Katchi,275,7,282,0.14,Tamil Nadu-Harur
7,CHINNASAMY.K,Dhesiya Makkal Kazhagam,168,1,169,0.09,Tamil Nadu-Harur
8,MURUGAN.R,Amma Makkal Munnettra Kazagam,14161,166,14327,7.22,Tamil Nadu-Harur
9,KUMAR.P,Independent,263,2,265,0.13,Tamil Nadu-Harur
10,SARATHKUMAR.M,Independent,153,1,154,0.08,Tamil Nadu-Harur
11,PALANI.C,Independent,172,1,173,0.09,Tamil Nadu-Harur
12,PARTHIPAN.P,Independent,409,4,413,0.21,Tamil Nadu-Harur
13,MURUGAN.R,Independent,520,1,521,0.26,Tamil Nadu-Harur
14,NOTA,None of the Above,2232,17,2249,1.13,Tamil Nadu-Harur
1,PRAKAASH Y,Dravida Munnetra Kazhagam,117199,1032,118231,47.65,Tamil Nadu-Hosur
2,JYOTHI S,All India Anna Dravida Munnetra Kazhagam,105475,389,105864,42.67,Tamil Nadu-Hosur
3,EZHILAN S,Veerath Thiyagi Viswanathadoss Thozhilalarkal Katchi,460,2,462,0.19,Tamil Nadu-Hosur
4,GEETHA LAKSHMI S,Naam Tamilar Katchi,11391,31,11422,4.6,Tamil Nadu-Hosur
5,SUNDAR L,Shiv Sena,127,0,127,0.05,Tamil Nadu-Hosur
6,SELVAM G,New Generation Peopleâ€™s Party,145,0,145,0.06,Tamil Nadu-Hosur
7,MASOOD S,Makkal Needhi Maiam,6536,27,6563,2.65,Tamil Nadu-Hosur
8,MAREGOWDU M,Amma Makkal Munnettra Kazagam,806,0,806,0.32,Tamil Nadu-Hosur
9,JAYASEELAN G,Anna Puratchi Thalaivar Amma Dravida Munnetra Kazhagam,64,1,65,0.03,Tamil Nadu-Hosur
10,KISHORE KUMAR R,Independent,54,0,54,0.02,Tamil Nadu-Hosur
11,GEETHA V,Independent,72,1,73,0.03,Tamil Nadu-Hosur
12,SHANMUGAM R,Independent,124,1,125,0.05,Tamil Nadu-Hosur
13,DEVAPPA Y,Independent,80,1,81,0.03,Tamil Nadu-Hosur
14,BALARAJU N,Independent,132,0,132,0.05,Tamil Nadu-Hosur
15,MUTHAMIZH MUDHALVAN S,Independent,395,2,397,0.16,Tamil Nadu-Hosur
16,MUTHU R K,Independent,585,0,585,0.24,Tamil Nadu-Hosur
17,RAMASWAMY G C,Independent,628,1,629,0.25,Tamil Nadu-Hosur
18,LOKESH V,Independent,361,0,361,0.15,Tamil Nadu-Hosur
19,NOTA,None of the Above,1968,8,1976,0.8,Tamil Nadu-Hosur
1,KANNAN KA SO KA,Dravida Munnetra Kazhagam,98174,1355,99529,46,Tamil Nadu-Jayankondam
2,NEELAMEGAM K,Bahujan Samaj Party,603,2,605,0.28,Tamil Nadu-Jayankondam
3,SIVA J K,Amma Makkal Munnettra Kazagam,1545,15,1560,0.72,Tamil Nadu-Jayankondam
4,SORNALATHA @ LATHA G,Indiya Jananayaka Katchi,4662,38,4700,2.17,Tamil Nadu-Jayankondam
5,NATARAJAN A,Anna Dravidar Kazhagam,413,5,418,0.19,Tamil Nadu-Jayankondam
6,BALU K,Pattali Makkal Katchi,93217,860,94077,43.48,Tamil Nadu-Jayankondam
7,MAHALINGAM NEELA,Naam Tamilar Katchi,9903,53,9956,4.6,Tamil Nadu-Jayankondam
8,KESAVARAJAN V K,Independent,1543,3,1546,0.71,Tamil Nadu-Jayankondam
9,SATHISHKUMAR R,Independent,348,1,349,0.16,Tamil Nadu-Jayankondam
10,SAMUVEL MARTIN A,Independent,309,3,312,0.14,Tamil Nadu-Jayankondam
11,SUDARVIZHI K,Independent,247,3,250,0.12,Tamil Nadu-Jayankondam
12,SEDHURAMAN R,Independent,257,1,258,0.12,Tamil Nadu-Jayankondam
13,RAJKUMAR S,Independent,945,2,947,0.44,Tamil Nadu-Jayankondam
14,NOTA,None of the Above,1850,11,1861,0.86,Tamil Nadu-Jayankondam
1,SIVAKUMAR.V.C.,Bahujan Samaj Party,341,6,347,0.18,Tamil Nadu-Jolarpet
2,DEVARAJI.K.,Dravida Munnetra Kazhagam,88237,1253,89490,45.57,Tamil Nadu-Jolarpet
3,VEERAMANI.K.C.,All India Anna Dravida Munnetra Kazhagam,87365,1034,88399,45.02,Tamil Nadu-Jolarpet
4,KALASTHRI.S.,All India Uzhavargal Uzhaippalargal Katchi,861,9,870,0.44,Tamil Nadu-Jolarpet
5,SIVA.A.,Naam Tamilar Katchi,13199,129,13328,6.79,Tamil Nadu-Jolarpet
6,THENNARASU SAAMRAJ,Amma Makkal Munnettra Kazagam,614,5,619,0.32,Tamil Nadu-Jolarpet
7,KARUNANIDHI.R.,Independent,1057,10,1067,0.54,Tamil Nadu-Jolarpet
8,DEVARAJI.R.,Independent,101,2,103,0.05,Tamil Nadu-Jolarpet
9,DEVARAJ.V.K.,Independent,80,2,82,0.04,Tamil Nadu-Jolarpet
10,MANITHAN,Independent,140,2,142,0.07,Tamil Nadu-Jolarpet
11,VEERAMANI.A.,Independent,148,0,148,0.08,Tamil Nadu-Jolarpet
12,VEERAMANI.H.,Independent,208,1,209,0.11,Tamil Nadu-Jolarpet
13,VEERAMANI.S.,Independent,217,0,217,0.11,Tamil Nadu-Jolarpet
14,NOTA,None of the Above,1328,9,1337,0.68,Tamil Nadu-Jolarpet
1,C.KRISHNAMURALI,All India Anna Dravida Munnetra Kazhagam,87900,574,88474,43.08,Tamil Nadu-Kadayanallur
2,M.AMBIKADEVI,Makkal Needhi Maiam,1756,22,1778,0.87,Tamil Nadu-Kadayanallur
3,S.AYYADURAIPANDIAN,Amma Makkal Munnettra Kazagam,34047,169,34216,16.66,Tamil Nadu-Kadayanallur
4,S.RAJA RAM,New Generation Peopleâ€™s Party,313,5,318,0.15,Tamil Nadu-Kadayanallur
5,M.MUTHULAKSHMI,Naam Tamilar Katchi,10052,84,10136,4.94,Tamil Nadu-Kadayanallur
6,K.A.M.MUHAMMED ABUBACKER,Indian Union Muslim League,63298,827,64125,31.22,Tamil Nadu-Kadayanallur
7,M.AYYADURAI,Independent,283,1,284,0.14,Tamil Nadu-Kadayanallur
8,AYYADURAI  R,Independent,87,0,87,0.04,Tamil Nadu-Kadayanallur
9,AVANI RAJA.T,Independent,80,0,80,0.04,Tamil Nadu-Kadayanallur
10,K.RADHA KRISHNAN,Independent,84,1,85,0.04,Tamil Nadu-Kadayanallur
11,RAJA PONNUSAMY,Independent,257,2,259,0.13,Tamil Nadu-Kadayanallur
12,A.GANESAN,Independent,117,5,122,0.06,Tamil Nadu-Kadayanallur
13,R.KRISHNAN,Independent,126,0,126,0.06,Tamil Nadu-Kadayanallur
14,A.SANKAR,Independent,413,0,413,0.2,Tamil Nadu-Kadayanallur
15,SIVASUBRAMANIYAN R,Independent,666,6,672,0.33,Tamil Nadu-Kadayanallur
16,S.SEENIVASAN,Independent,938,0,938,0.46,Tamil Nadu-Kadayanallur
17,POOLOGARAJ R,Independent,657,1,658,0.32,Tamil Nadu-Kadayanallur
18,MARIDURAIPANDIAN,Independent,96,0,96,0.05,Tamil Nadu-Kadayanallur
19,S.MURUGANANTHAM,Independent,532,0,532,0.26,Tamil Nadu-Kadayanallur
20,P.RAJI,Independent,245,2,247,0.12,Tamil Nadu-Kadayanallur
21,VELAMMAL,Independent,670,2,672,0.33,Tamil Nadu-Kadayanallur
22,NOTA,None of the Above,1047,9,1056,0.51,Tamil Nadu-Kadayanallur
1,Saravanan.P.S.T,Dravida Munnetra Kazhagam,92712,1422,94134,47.92,Tamil Nadu-Kalasapakkam
2,Nehru.M,Desiya Murpokku Dravida Kazhagam,2738,18,2756,1.4,Tamil Nadu-Kalasapakkam
3,Panneerselvam.V,All India Anna Dravida Munnetra Kazhagam,84070,842,84912,43.23,Tamil Nadu-Kalasapakkam
4,Rajkumar.E,Bahujan Samaj Party,623,9,632,0.32,Tamil Nadu-Kalasapakkam
5,Kalyanasundaram.A,Veerath Thiyagi Viswanathadoss Thozhilalarkal Katchi,126,2,128,0.07,Tamil Nadu-Kalasapakkam
6,Sampath.R.V,Anna Dravidar Kazhagam,91,1,92,0.05,Tamil Nadu-Kalasapakkam
7,Balaji.E,Naam Tamilar Katchi,8748,74,8822,4.49,Tamil Nadu-Kalasapakkam
8,Rajendran.M.S,Indiya Jananayaka Katchi,239,5,244,0.12,Tamil Nadu-Kalasapakkam
9,Amutha.G,Independent,362,20,382,0.19,Tamil Nadu-Kalasapakkam
10,Saravanan.K,Independent,244,6,250,0.13,Tamil Nadu-Kalasapakkam
11,Tirunavukarasu.M,Independent,755,10,765,0.39,Tamil Nadu-Kalasapakkam
12,Panneerselvam.S,Independent,710,3,713,0.36,Tamil Nadu-Kalasapakkam
13,Panneerselvam.V,Independent,238,1,239,0.12,Tamil Nadu-Kalasapakkam
14,Rajamani.K,Independent,449,1,450,0.23,Tamil Nadu-Kalasapakkam
15,Jagannathan.R,Independent,321,1,322,0.16,Tamil Nadu-Kalasapakkam
16,NOTA,None of the Above,1584,9,1593,0.81,Tamil Nadu-Kalasapakkam
1,Suriyaprakash.M,Independent,655,4,659,0.29,Tamil Nadu-Kallakurichi
2,Dravidamuthamilselvi.D,Naam Tamilar Katchi,16409,65,16474,7.29,Tamil Nadu-Kallakurichi
3,Manirathinem.K.I,Indian National Congress,83367,1385,84752,37.52,Tamil Nadu-Kallakurichi
4,Vijayakumar.N,Desiya Murpokku Dravida Kazhagam,6555,16,6571,2.91,Tamil Nadu-Kallakurichi
5,Senthilkumar.M,All India Anna Dravida Munnetra Kazhagam,109909,734,110643,48.99,Tamil Nadu-Kallakurichi
6,Dinesh.M,My India Party,197,1,198,0.09,Tamil Nadu-Kallakurichi
7,Ayyasamy.M,Indiya Jananayaka Katchi,864,7,871,0.39,Tamil Nadu-Kallakurichi
8,Devimangayarkarasi.K,Independent,1197,0,1197,0.53,Tamil Nadu-Kallakurichi
9,Prabu.C,Independent,937,0,937,0.41,Tamil Nadu-Kallakurichi
10,Gurusamy.M,Independent,103,0,103,0.05,Tamil Nadu-Kallakurichi
11,Selvaraj.M,Independent,265,1,266,0.12,Tamil Nadu-Kallakurichi
12,Palanisamy.A,Bahujan Samaj Party,1096,1,1097,0.49,Tamil Nadu-Kallakurichi
13,Kuppusamy.K,Anna MGR Dravida Makkal Kalgam,171,0,171,0.08,Tamil Nadu-Kallakurichi
14,Oviyar Ananth,Lok Jan Shakti Party,102,0,102,0.05,Tamil Nadu-Kallakurichi
15,Elaiyaperumal.K,Independent,185,0,185,0.08,Tamil Nadu-Kallakurichi
16,Sivakumar.S,Independent,125,0,125,0.06,Tamil Nadu-Kallakurichi
17,Subramaniyan.P,Independent,248,2,250,0.11,Tamil Nadu-Kallakurichi
18,NOTA,None of the Above,1247,10,1257,0.56,Tamil Nadu-Kallakurichi
1,C.V.M.P. Ezhailzrasan,Dravida Munnetra Kazhagam,100914,1798,102712,44.77,Tamil Nadu-Kancheepuram
2,K. Prabakaran,Bahujan Samaj Party,1185,8,1193,0.52,Tamil Nadu-Kancheepuram
3,B. GOPINATH,Makkal Needhi Maiam,11936,92,12028,5.24,Tamil Nadu-Kancheepuram
4,S. SALDIN,Naam Tamilar Katchi,13829,117,13946,6.08,Tamil Nadu-Kancheepuram
5,P. Magesh Kumar,Pattali Makkal Katchi,90390,727,91117,39.71,Tamil Nadu-Kancheepuram
6,N. MANOGARAN,Amma Makkal Munnettra Kazagam,2283,18,2301,1,Tamil Nadu-Kancheepuram
7,M. MEGANATHAN,New Generation Peopleâ€™s Party,241,7,248,0.11,Tamil Nadu-Kancheepuram
8,L. ARULNATHAN,Independent,2024,26,2050,0.89,Tamil Nadu-Kancheepuram
9,M.ELANGOVAN,Independent,94,17,111,0.05,Tamil Nadu-Kancheepuram
10,P. EZHILARASAN,Independent,126,1,127,0.06,Tamil Nadu-Kancheepuram
11,S. SRINIVASAN,Independent,162,0,162,0.07,Tamil Nadu-Kancheepuram
12,D.GNANAMOORTHY,Independent,412,3,415,0.18,Tamil Nadu-Kancheepuram
13,T. MAGESH,Independent,143,14,157,0.07,Tamil Nadu-Kancheepuram
14,R. VINOTHRAJ,Independent,133,0,133,0.06,Tamil Nadu-Kancheepuram
15,J. JAYARAJ,Independent,192,1,193,0.08,Tamil Nadu-Kancheepuram
16,NOTA,None of the Above,2521,18,2539,1.11,Tamil Nadu-Kancheepuram
1,AYYAVU.N,Bahujan Samaj Party,421,0,421,0.21,Tamil Nadu-Kangayam
2,SAMINATHAN.M.P,Dravida Munnetra Kazhagam,93178,1019,94197,47.14,Tamil Nadu-Kangayam
3,RAMALINGAM.A.S,All India Anna Dravida Munnetra Kazhagam,86477,389,86866,43.47,Tamil Nadu-Kangayam
4,SIVANANTHAM.K,Naam Tamilar Katchi,11248,59,11307,5.66,Tamil Nadu-Kangayam
5,MANOHARAN.S,Anna Puratchi Thalaivar Amma Dravida Munnetra Kazhagam,134,0,134,0.07,Tamil Nadu-Kangayam
6,RAMESH.C,Amma Makkal Munnettra Kazagam,474,0,474,0.24,Tamil Nadu-Kangayam
7,APPASAMY.R,Independent,2317,10,2327,1.16,Tamil Nadu-Kangayam
8,IMMANUVEL.R,Independent,434,1,435,0.22,Tamil Nadu-Kangayam
9,GOPINATH.P,Independent,247,0,247,0.12,Tamil Nadu-Kangayam
10,SATHISH KUMAR.P,Independent,60,2,62,0.03,Tamil Nadu-Kangayam
11,SATHYAMOORTHI.S,Independent,106,1,107,0.05,Tamil Nadu-Kangayam
12,SUKUMARAN.N,Independent,59,0,59,0.03,Tamil Nadu-Kangayam
13,SUBRAMANIAN.D,Independent,123,1,124,0.06,Tamil Nadu-Kangayam
14,SELVAKUMAR.K,Independent,225,0,225,0.11,Tamil Nadu-Kangayam
15,NALLAMUTHU.P,Independent,276,0,276,0.14,Tamil Nadu-Kangayam
16,NITHIYANDHAN.C,Independent,285,0,285,0.14,Tamil Nadu-Kangayam
17,PRABHAKARAN.G,Independent,113,0,113,0.06,Tamil Nadu-Kangayam
18,MANI.A,Independent,273,0,273,0.14,Tamil Nadu-Kangayam
19,MANIKANDAN.R,Independent,330,0,330,0.17,Tamil Nadu-Kangayam
20,RAVIKUMAR.R,Independent,98,2,100,0.05,Tamil Nadu-Kangayam
21,RAMALINGAM.N,Independent,38,0,38,0.02,Tamil Nadu-Kangayam
22,RAJENDRAN.B,Independent,94,1,95,0.05,Tamil Nadu-Kangayam
23,RAJENDRAN.P,Independent,40,0,40,0.02,Tamil Nadu-Kangayam
24,VADUGANATHAN.K.K.,Independent,83,0,83,0.04,Tamil Nadu-Kangayam
25,JAHANGEER.K.O.,Independent,88,1,89,0.04,Tamil Nadu-Kangayam
26,JOTHI KALIMUTHU.G,Independent,84,0,84,0.04,Tamil Nadu-Kangayam
27,NOTA,None of the Above,1020,7,1027,0.51,Tamil Nadu-Kangayam
1,AUSTIN S.,Dravida Munnetra Kazhagam,91511,2021,93532,41.59,Tamil Nadu-Kanniyakumari
2,SUTHARMAN C.J.,Bahujan Samaj Party,675,6,681,0.3,Tamil Nadu-Kanniyakumari
3,THALAVAI SUNDARAM N.,All India Anna Dravida Munnetra Kazhagam,108136,1609,109745,48.8,Tamil Nadu-Kanniyakumari
4,SASIKALA  R.,Naam Tamilar Katchi,14072,68,14140,6.29,Tamil Nadu-Kanniyakumari
5,SENTHIL MURUGAN  P.,Amma Makkal Munnettra Kazagam,1570,19,1589,0.71,Tamil Nadu-Kanniyakumari
6,SELVAKUMAR  P.T.,Makkal Needhi Maiam,3100,6,3106,1.38,Tamil Nadu-Kanniyakumari
7,AUGUSTIN A.,Independent,445,1,446,0.2,Tamil Nadu-Kanniyakumari
8,SUNDARA NATHAN Y.,Independent,50,0,50,0.02,Tamil Nadu-Kanniyakumari
9,SUBASH S.,Independent,77,1,78,0.03,Tamil Nadu-Kanniyakumari
10,CHELLIAH PILLAI I.,Independent,55,0,55,0.02,Tamil Nadu-Kanniyakumari
11,THANU NEELAN S.,Independent,95,0,95,0.04,Tamil Nadu-Kanniyakumari
12,MAKESH N.,Independent,115,4,119,0.05,Tamil Nadu-Kanniyakumari
13,MANICKAVASAGAM PILLAI NA.,Independent,141,1,142,0.06,Tamil Nadu-Kanniyakumari
14,NOTA,None of the Above,1092,4,1096,0.49,Tamil Nadu-Kanniyakumari
1,N.Baluswamy,Bahujan Samaj Party,649,3,652,0.31,Tamil Nadu-Karaikudi
2,S.Mangudi,Indian National Congress,73777,2177,75954,35.75,Tamil Nadu-Karaikudi
3,H.Raja,Bharatiya Janata Party,53863,502,54365,25.59,Tamil Nadu-Karaikudi
4,N.Durai Manickam,Naam Tamilar Katchi,23725,147,23872,11.24,Tamil Nadu-Karaikudi
5,Dherpoki V Pandi,Amma Makkal Munnettra Kazagam,44561,303,44864,21.12,Tamil Nadu-Karaikudi
6,Rajkumar.G,Anna MGR Dravida Makkal Kalgam,338,3,341,0.16,Tamil Nadu-Karaikudi
7,S.Rajkumar,Makkal Needhi Maiam,8260,91,8351,3.93,Tamil Nadu-Karaikudi
8,B.Vanitha,Puthiya Tamilagam,698,4,702,0.33,Tamil Nadu-Karaikudi
9,A.Ganesan,Independent,340,6,346,0.16,Tamil Nadu-Karaikudi
10,M.Naina Mohamed,Independent,412,4,416,0.2,Tamil Nadu-Karaikudi
11,A.Paramasivam,Independent,192,0,192,0.09,Tamil Nadu-Karaikudi
12,N.Meenal,Independent,543,5,548,0.26,Tamil Nadu-Karaikudi
13,K.Velu,Independent,498,6,504,0.24,Tamil Nadu-Karaikudi
14,NOTA,None of the Above,1329,20,1349,0.63,Tamil Nadu-Karaikudi
1,AADHIKRISHNAN.P,Bahujan Samaj Party,210,0,210,0.1,Tamil Nadu-Karur
2,SENTHILBALAJI V,Dravida Munnetra Kazhagam,100356,1401,101757,49.08,Tamil Nadu-Karur
3,THANGARAJ.N,Desiya Murpokku Dravida Kazhagam,946,7,953,0.46,Tamil Nadu-Karur
4,VIJAYABHASKAR. M.R,All India Anna Dravida Munnetra Kazhagam,88440,869,89309,43.08,Tamil Nadu-Karur
5,KARUPPAIYA.R,Naam Tamilar Katchi,7286,30,7316,3.53,Tamil Nadu-Karur
6,SHANMUGAM.N,Samaniya Makkal Nala Katchi,99,0,99,0.05,Tamil Nadu-Karur
7,DHANALAKSHMI.M,Ganasangam Party of India,105,0,105,0.05,Tamil Nadu-Karur
8,MOHANRAJ.S,Makkal Needhi Maiam,4138,16,4154,2,Tamil Nadu-Karur
9,JOSEPH.M.A,Desiya Makkal Sakthi Katchi,39,0,39,0.02,Tamil Nadu-Karur
10,ABILAZAN.N,Independent,29,0,29,0.01,Tamil Nadu-Karur
11,AMARNATH.K,Independent,28,0,28,0.01,Tamil Nadu-Karur
12,AMARSRI.M,Independent,56,0,56,0.03,Tamil Nadu-Karur
13,ANBAZHAGAN,Independent,334,0,334,0.16,Tamil Nadu-Karur
14,RAVI.P,Independent,366,3,369,0.18,Tamil Nadu-Karur
15,KANNAN.T,Independent,165,0,165,0.08,Tamil Nadu-Karur
16,KATHIRAVAN.P,Independent,114,0,114,0.05,Tamil Nadu-Karur
17,KARUNAMOORTHY.S,Independent,29,0,29,0.01,Tamil Nadu-Karur
18,KALAI RAJ.K,Independent,51,0,51,0.02,Tamil Nadu-Karur
19,KAMARAJ.P,Independent,15,0,15,0.01,Tamil Nadu-Karur
20,KRISHNAKUMAR.S,Independent,42,0,42,0.02,Tamil Nadu-Karur
21,GOPALAKRISHNAN.A,Independent,19,0,19,0.01,Tamil Nadu-Karur
22,SAKTHIKUMAR,Independent,2,0,2,0,Tamil Nadu-Karur
23,SANTHANAKUMAR.M,Independent,3,1,4,0,Tamil Nadu-Karur
24,SATHISH.P,Independent,10,0,10,0,Tamil Nadu-Karur
25,SAMPATH.S,Independent,9,0,9,0,Tamil Nadu-Karur
26,SARAVANAN.R,Independent,10,0,10,0,Tamil Nadu-Karur
27,SAMIAPPAN.K,Independent,10,0,10,0,Tamil Nadu-Karur
28,SAMIVEL.A,Independent,12,0,12,0.01,Tamil Nadu-Karur
29,SHIVAKUMAR.K,Independent,29,0,29,0.01,Tamil Nadu-Karur
30,SIVAKUMAR.N,Independent,18,0,18,0.01,Tamil Nadu-Karur
31,SIVAKUMAR.V,Independent,46,0,46,0.02,Tamil Nadu-Karur
32,SIVASAMY.P,Independent,37,0,37,0.02,Tamil Nadu-Karur
33,SUDHAKAR.S,Independent,7,0,7,0,Tamil Nadu-Karur
34,SUDHAKAR.L,Independent,19,0,19,0.01,Tamil Nadu-Karur
35,SUBASH MALAYALAM.T,Independent,8,0,8,0,Tamil Nadu-Karur
36,SURYA,Independent,96,0,96,0.05,Tamil Nadu-Karur
37,SENTHILKUMAR.A,Independent,13,0,13,0.01,Tamil Nadu-Karur
38,SENTHILKUMAR.A.M,Independent,2,0,2,0,Tamil Nadu-Karur
39,SELVAKUMAR.M,Independent,7,0,7,0,Tamil Nadu-Karur
40,DANIYA,Independent,11,0,11,0.01,Tamil Nadu-Karur
41,TAMILARASAN.K,Independent,13,0,13,0.01,Tamil Nadu-Karur
42,THAMILALAGAN,Independent,7,0,7,0,Tamil Nadu-Karur
43,DHANABAL,Independent,7,0,7,0,Tamil Nadu-Karur
44,THIRUGNANAM.M,Independent,13,0,13,0.01,Tamil Nadu-Karur
45,DEEPANANDH.N,Independent,14,0,14,0.01,Tamil Nadu-Karur
46,DURAISAMY.J,Independent,5,0,5,0,Tamil Nadu-Karur
47,NOOR MOHAMMED THOUFFIC.A,Independent,13,0,13,0.01,Tamil Nadu-Karur
48,PALANIVEL.P,Independent,17,0,17,0.01,Tamil Nadu-Karur
49,BALAMANIKANDAN.K,Independent,56,0,56,0.03,Tamil Nadu-Karur
50,BANUMATHY,Independent,16,0,16,0.01,Tamil Nadu-Karur
51,PRAKASH.A,Independent,11,0,11,0.01,Tamil Nadu-Karur
52,PRAKASH.N,Independent,20,0,20,0.01,Tamil Nadu-Karur
53,PRAKASH.V,Independent,5,0,5,0,Tamil Nadu-Karur
54,PRASANTH.S,Independent,4,0,4,0,Tamil Nadu-Karur
55,PUSHPARAJ.P,Independent,3,0,3,0,Tamil Nadu-Karur
56,BOOPATHI.P,Independent,6,0,6,0,Tamil Nadu-Karur
57,MAHENDRAN,Independent,11,0,11,0.01,Tamil Nadu-Karur
58,MANIKANDAN.K,Independent,2,0,2,0,Tamil Nadu-Karur
59,MANIVANNAN.S,Independent,3,0,3,0,Tamil Nadu-Karur
60,MANOJ.P,Independent,10,0,10,0,Tamil Nadu-Karur
61,MUTHU. K.R,Independent,14,0,14,0.01,Tamil Nadu-Karur
62,MUTHUKUMAR.G,Independent,8,0,8,0,Tamil Nadu-Karur
63,MURALI.M,Independent,10,0,10,0,Tamil Nadu-Karur
64,MURUGANANTHAM.T,Independent,30,0,30,0.01,Tamil Nadu-Karur
65,MURUGESAN.A,Independent,83,1,84,0.04,Tamil Nadu-Karur
66,MOHAN.M.L.M,Independent,42,0,42,0.02,Tamil Nadu-Karur
67,MOUNAGURUBALUSAMY.K,Independent,14,0,14,0.01,Tamil Nadu-Karur
68,RAJESHKANNAN.S,Independent,138,0,138,0.07,Tamil Nadu-Karur
69,VIGNESHWARAN.P,Independent,25,0,25,0.01,Tamil Nadu-Karur
70,VINOTHKUMAR,Independent,9,0,9,0,Tamil Nadu-Karur
71,VIJAYABHASKAR.R.V,Independent,14,0,14,0.01,Tamil Nadu-Karur
72,VIJAYAN.K,Independent,13,0,13,0.01,Tamil Nadu-Karur
73,VEERAKUMAR.T,Independent,5,0,5,0,Tamil Nadu-Karur
74,VENKADESH.K,Independent,14,0,14,0.01,Tamil Nadu-Karur
75,VENKATESH PRABU.K,Independent,26,0,26,0.01,Tamil Nadu-Karur
76,JAYAKUMAR.G,Independent,100,2,102,0.05,Tamil Nadu-Karur
77,JOTHI SUTHARSAN,Independent,22,0,22,0.01,Tamil Nadu-Karur
78,NOTA,None of the Above,954,7,961,0.46,Tamil Nadu-Karur
1,DURAIMURUGAN,Dravida Munnetra Kazhagam,83243,1897,85140,45.71,Tamil Nadu-Katpadi
2,V RAMU,All India Anna Dravida Munnetra Kazhagam,83675,719,84394,45.31,Tamil Nadu-Katpadi
3,K RAJA,Bahujan Samaj Party,368,6,374,0.2,Tamil Nadu-Katpadi
4,ARUMUGAM K P,Republican Party of India (Athawale),142,2,144,0.08,Tamil Nadu-Katpadi
5,M SUDHARSAN,Indiya Jananayaka Katchi,991,12,1003,0.54,Tamil Nadu-Katpadi
6,S THIRUKKUMARAN,Naam Tamilar Katchi,10325,124,10449,5.61,Tamil Nadu-Katpadi
7,A S RAJA,Amma Makkal Munnettra Kazagam,1059,7,1066,0.57,Tamil Nadu-Katpadi
8,R S SRIDHAR,Anna MGR Dravida Makkal Kalgam,75,3,78,0.04,Tamil Nadu-Katpadi
9,J ANANDHI,Independent,177,16,193,0.1,Tamil Nadu-Katpadi
10,P DHANANJAYAN,Independent,163,3,166,0.09,Tamil Nadu-Katpadi
11,R BASKARAN,Independent,221,3,224,0.12,Tamil Nadu-Katpadi
12,RAMAN,Independent,144,0,144,0.08,Tamil Nadu-Katpadi
13,K RAMU,Independent,99,0,99,0.05,Tamil Nadu-Katpadi
14,D RAMU,Independent,332,0,332,0.18,Tamil Nadu-Katpadi
15,V VINAYAGAM,Independent,548,3,551,0.3,Tamil Nadu-Katpadi
16,NOTA,None of the Above,1852,37,1889,1.01,Tamil Nadu-Katpadi
1,THANGA UDHAYAKUMAR,Bahujan Samaj Party,425,4,429,0.24,Tamil Nadu-Kattumannarkoil
2,N. MURUGUMARAN,All India Anna Dravida Munnetra Kazhagam,74608,883,75491,43,Tamil Nadu-Kattumannarkoil
3,M.G. KALYANASUNDARAM,All India Jananayaka Makkal Kazhagam,458,2,460,0.26,Tamil Nadu-Kattumannarkoil
4,SINTHANAI SELVAN,Viduthalai Chiruthaigal Katchi,84986,1070,86056,49.02,Tamil Nadu-Kattumannarkoil
5,THANGA VIKRAM,Makkal Needhi Maiam,1391,24,1415,0.81,Tamil Nadu-Kattumannarkoil
6,M. THIRUNAVUKARASU,Anna Puratchi Thalaivar Amma Dravida Munnetra Kazhagam,133,1,134,0.08,Tamil Nadu-Kattumannarkoil
7,S. NARAYANAMOORTHY,Amma Makkal Munnettra Kazagam,1892,12,1904,1.08,Tamil Nadu-Kattumannarkoil
8,P. NIVEDHA,Naam Tamilar Katchi,6762,44,6806,3.88,Tamil Nadu-Kattumannarkoil
9,M.A.T. ARCHUNAN,Independent,417,4,421,0.24,Tamil Nadu-Kattumannarkoil
10,A. ANANDAN,Independent,991,0,991,0.56,Tamil Nadu-Kattumannarkoil
11,P.M. KUMAR,Independent,362,1,363,0.21,Tamil Nadu-Kattumannarkoil
12,S.TAMILSELVAN,Independent,216,0,216,0.12,Tamil Nadu-Kattumannarkoil
13,MATHIAZHAGAN,Independent,227,0,227,0.13,Tamil Nadu-Kattumannarkoil
14,NOTA,None of the Above,647,1,648,0.37,Tamil Nadu-Kattumannarkoil
1,G.Arunkumar,All India Anna Dravida Munnetra Kazhagam,134981,688,135669,43.78,Tamil Nadu-Kavundampalayam
2,R.Krishnan,Dravida Munnetra Kazhagam,124557,1336,125893,40.62,Tamil Nadu-Kavundampalayam
3,Aruna.M,Amma Makkal Munnettra Kazagam,1992,10,2002,0.65,Tamil Nadu-Kavundampalayam
4,Kalamani.M,Naam Tamilar Katchi,17823,74,17897,5.77,Tamil Nadu-Kavundampalayam
5,Siva.K,Tamil Nadu Ilangyar Katchi,718,8,726,0.23,Tamil Nadu-Kavundampalayam
6,Selvaraj.M,New Generation Peopleâ€™s Party,177,1,178,0.06,Tamil Nadu-Kavundampalayam
7,Pankaj Jain,Makkal Needhi Maiam,23427,100,23527,7.59,Tamil Nadu-Kavundampalayam
8,Arunkumar.T,Independent,294,2,296,0.1,Tamil Nadu-Kavundampalayam
9,Krishnan.M,Independent,140,0,140,0.05,Tamil Nadu-Kavundampalayam
10,Suriyakumar.K,Independent,117,0,117,0.04,Tamil Nadu-Kavundampalayam
11,Gnanaraj.M,Independent,160,1,161,0.05,Tamil Nadu-Kavundampalayam
12,Pushpanantham.V,Independent,419,1,420,0.14,Tamil Nadu-Kavundampalayam
13,NOTA,None of the Above,2868,24,2892,0.93,Tamil Nadu-Kavundampalayam
1,SIVAKUMAR  V,Bahujan Samaj Party,1571,25,1596,0.94,Tamil Nadu-Killiyoor
2,RAJESH KUMAR  S,Indian National Congress,99393,2148,101541,59.76,Tamil Nadu-Killiyoor
3,JUDE DEV   K.V,All India Anna Dravida Munnetra Kazhagam,45419,722,46141,27.15,Tamil Nadu-Killiyoor
4,ANTONY  A,All India Samathuva Makhal Katchi,1205,9,1214,0.71,Tamil Nadu-Killiyoor
5,SEEMA  A,Amma Makkal Munnettra Kazagam,1079,23,1102,0.65,Tamil Nadu-Killiyoor
6,THANKAPPAN C,Tamilnadu Mahatma Gandhi Makkal Katchi,159,3,162,0.1,Tamil Nadu-Killiyoor
7,PETER H,Naam Tamilar Katchi,14328,189,14517,8.54,Tamil Nadu-Killiyoor
8,VIJIKUMAR K,National Democratic Party of South India,184,2,186,0.11,Tamil Nadu-Killiyoor
9,JAYARAJ E,Tamil Nadu Ilangyar Katchi,1429,14,1443,0.85,Tamil Nadu-Killiyoor
10,ANCHALOSE R,Independent,210,3,213,0.13,Tamil Nadu-Killiyoor
11,SIVAN RAJ  K,Independent,315,8,323,0.19,Tamil Nadu-Killiyoor
12,RAMESH RAJA KUMAR C,Independent,275,3,278,0.16,Tamil Nadu-Killiyoor
13,JOHN BENADICT G,Independent,233,2,235,0.14,Tamil Nadu-Killiyoor
14,SHAJU SINGH M R,Independent,211,2,213,0.13,Tamil Nadu-Killiyoor
15,NOTA,None of the Above,747,7,754,0.44,Tamil Nadu-Killiyoor
1,SubashChandrabose,Bahujan Samaj Party,593,5,598,0.29,Tamil Nadu-Kilpennathur
2,K.Pitchandi,Dravida Munnetra Kazhagam,102713,1962,104675,51.34,Tamil Nadu-Kilpennathur
3,A.R.Elumalai,Veerath Thiyagi Viswanathadoss Thozhilalarkal Katchi,497,7,504,0.25,Tamil Nadu-Kilpennathur
4,P.Kathikeyan,Amma Makkal Munnettra Kazagam,2172,19,2191,1.07,Tamil Nadu-Kilpennathur
5,V.Suganantham,Makkal Needhi Maiam,1431,6,1437,0.7,Tamil Nadu-Kilpennathur
6,K.Selvakumar,Pattali Makkal Katchi,76854,1034,77888,38.2,Tamil Nadu-Kilpennathur
7,N.Thangaraj,Makkal Munnetra Peravai,313,4,317,0.16,Tamil Nadu-Kilpennathur
8,Dr.R.Rameshbabu,Naam Tamilar Katchi,11464,77,11541,5.66,Tamil Nadu-Kilpennathur
9,A.Venkatesan,Republican Party of India (Athawale),147,0,147,0.07,Tamil Nadu-Kilpennathur
10,Farmer Jayaraman,Anaithu Makkal Arasiyal Katchi,236,3,239,0.12,Tamil Nadu-Kilpennathur
11,M.Athiyaman,Independent,185,0,185,0.09,Tamil Nadu-Kilpennathur
12,P.Ganeshraja,Independent,194,3,197,0.1,Tamil Nadu-Kilpennathur
13,G.krishnamurthy,Independent,86,39,125,0.06,Tamil Nadu-Kilpennathur
14,Sakthivel,Independent,407,1,408,0.2,Tamil Nadu-Kilpennathur
15,S.Sasikumar,Independent,592,5,597,0.29,Tamil Nadu-Kilpennathur
16,M.Sampathraj,Independent,415,2,417,0.2,Tamil Nadu-Kilpennathur
17,M.Dinakaran,Independent,251,20,271,0.13,Tamil Nadu-Kilpennathur
18,M.Murugan,Independent,835,9,844,0.41,Tamil Nadu-Kilpennathur
19,M.Mohanraja,Independent,117,0,117,0.06,Tamil Nadu-Kilpennathur
20,Lourdammal,Independent,75,0,75,0.04,Tamil Nadu-Kilpennathur
21,C.Jothi,Independent,151,1,152,0.07,Tamil Nadu-Kilpennathur
22,NOTA,None of the Above,954,7,961,0.47,Tamil Nadu-Kilpennathur
1,K Seetharaman,Dravida Munnetra Kazhagam,72933,1064,73997,42.5,Tamil Nadu-Kilvaithinankuppam
2,DHANASEELAN,Desiya Murpokku Dravida Kazhagam,1406,26,1432,0.82,Tamil Nadu-Kilvaithinankuppam
3,PUSHPALATHA D,Bahujan Samaj Party,505,14,519,0.3,Tamil Nadu-Kilvaithinankuppam
4,M.JAGAN MOORTHY,All India Anna Dravida Munnetra Kazhagam,83989,590,84579,48.57,Tamil Nadu-Kilvaithinankuppam
5,K ELAVARASAN,Republican Party of India (Athawale),543,4,547,0.31,Tamil Nadu-Kilvaithinankuppam
6,K SATHU,National Democratic Party of South India,132,1,133,0.08,Tamil Nadu-Kilvaithinankuppam
7,J.Divya Rani,Naam Tamilar Katchi,9911,116,10027,5.76,Tamil Nadu-Kilvaithinankuppam
8,K VENKATASAMY,Indiya Jananayaka Katchi,519,0,519,0.3,Tamil Nadu-Kilvaithinankuppam
9,E.P.ELANCHEZHIYAN,Independent,238,4,242,0.14,Tamil Nadu-Kilvaithinankuppam
10,S SELVA CHENGUTTUVAN,Independent,324,7,331,0.19,Tamil Nadu-Kilvaithinankuppam
11,NOTA,None of the Above,1773,25,1798,1.03,Tamil Nadu-Kilvaithinankuppam
1,TAMILARASAN U,Bahujan Samaj Party,636,5,641,0.45,Tamil Nadu-Kilvelur
2,NAGAIMAALI V P,Communist Party of India  (Marxist),67288,700,67988,47.55,Tamil Nadu-Kilvelur
3,SIDHU G,Makkal Needhi Maiam,2890,16,2906,2.03,Tamil Nadu-Kilvelur
4,NEETHIMOHAN M,Amma Makkal Munnettra Kazagam,2494,9,2503,1.75,Tamil Nadu-Kilvelur
5,PONELAVAZHAKI  S,Naam Tamilar Katchi,15088,85,15173,10.61,Tamil Nadu-Kilvelur
6,MUTHALAGAN S,Puthiya Tamilagam,614,0,614,0.43,Tamil Nadu-Kilvelur
7,VADIVEL RAVANAN  S,Pattali Makkal Katchi,50754,249,51003,35.67,Tamil Nadu-Kilvelur
8,KALAISELVAN G,Independent,613,2,615,0.43,Tamil Nadu-Kilvelur
9,MARUTHAIYAN G,Independent,171,2,173,0.12,Tamil Nadu-Kilvelur
10,VEDHA MUKUNDHAN,Independent,481,1,482,0.34,Tamil Nadu-Kilvelur
11,NOTA,None of the Above,895,2,897,0.63,Tamil Nadu-Kilvelur
1,Kuruchi Prabhakaran,Dravida Munnetra Kazhagam,99311,1131,100442,43.21,Tamil Nadu-Kinathukadavu
2,Damodaran.S,All India Anna Dravida Munnetra Kazhagam,101069,468,101537,43.68,Tamil Nadu-Kinathukadavu
3,Anbazhagan.G,Veerath Thiyagi Viswanathadoss Thozhilalarkal Katchi,352,1,353,0.15,Tamil Nadu-Kinathukadavu
4,Umajagadesh.M,Naam Tamilar Katchi,11249,31,11280,4.85,Tamil Nadu-Kinathukadavu
5,Siva.A,Makkal Needhi Maiam,13880,59,13939,6,Tamil Nadu-Kinathukadavu
6,Mariappan.R,Ganasangam Party of India,187,0,187,0.08,Tamil Nadu-Kinathukadavu
7,ROHINI MA.PA,Amma Makkal Munnettra Kazagam,1237,11,1248,0.54,Tamil Nadu-Kinathukadavu
8,James.S,All India Jananayaka Makkal Kazhagam,55,0,55,0.02,Tamil Nadu-Kinathukadavu
9,Atheeswaran.S,Independent,50,0,50,0.02,Tamil Nadu-Kinathukadavu
10,Dharmalingam.K,Independent,107,1,108,0.05,Tamil Nadu-Kinathukadavu
11,Nazir Babu.S,Independent,88,0,88,0.04,Tamil Nadu-Kinathukadavu
12,Nagendran.P,Independent,225,3,228,0.1,Tamil Nadu-Kinathukadavu
13,Noor Muhamad . A,Independent,135,0,135,0.06,Tamil Nadu-Kinathukadavu
14,Velusamy.V,Independent,504,1,505,0.22,Tamil Nadu-Kinathukadavu
15,NOTA,None of the Above,2268,12,2280,0.98,Tamil Nadu-Kinathukadavu
1,AADIRAJARAM,All India Anna Dravida Munnetra Kazhagam,34801,337,35138,20.27,Tamil Nadu-Kolathur
2,MJS.JAMAL MOHAMED MEERA,Bahujan Samaj Party,1286,9,1295,0.75,Tamil Nadu-Kolathur
3,M.K. STALIN,Dravida Munnetra Kazhagam,104305,1217,105522,60.86,Tamil Nadu-Kolathur
4,ASHOK KUMAR.S,New Generation Peopleâ€™s Party,257,0,257,0.15,Tamil Nadu-Kolathur
5,J.ARUMUGAM,Amma Makkal Munnettra Kazagam,1075,5,1080,0.62,Tamil Nadu-Kolathur
6,ELUMALAI.K,Veerath Thiyagi Viswanathadoss Thozhilalarkal Katchi,69,0,69,0.04,Tamil Nadu-Kolathur
7,F.CAMILUS SELVA,Naam Tamilar Katchi,11234,45,11279,6.51,Tamil Nadu-Kolathur
8,A.SEETHA,Bahujan Dravida Party,41,0,41,0.02,Tamil Nadu-Kolathur
9,SURESH,Tamil Nadu Ilangyar Katchi,619,1,620,0.36,Tamil Nadu-Kolathur
10,S.SURESHKUMAR,Makkalatchi Katchi,38,5,43,0.02,Tamil Nadu-Kolathur
11,D.SURESHBABU,Desiya Makkal Sakthi Katchi,87,0,87,0.05,Tamil Nadu-Kolathur
12,E.RAJENDRAN,Anna MGR Dravida Makkal Kalgam,25,5,30,0.02,Tamil Nadu-Kolathur
13,M.RAJENDRAN,National Democratic Party of South India,65,0,65,0.04,Tamil Nadu-Kolathur
14,VIVEKRAJ.J,Thamizhaga Munnetra Congress,116,0,116,0.07,Tamil Nadu-Kolathur
15,G.VELMURUGAN,Shiv Sena,130,2,132,0.08,Tamil Nadu-Kolathur
16,A.JAGADISH KUMAR,Makkal Needhi Maiam,13989,87,14076,8.12,Tamil Nadu-Kolathur
17,AGNI SRI RAMACHANDRAN,Independent,680,1,681,0.39,Tamil Nadu-Kolathur
18,L.KATHIRESAN,Independent,118,0,118,0.07,Tamil Nadu-Kolathur
19,SATHIYASEELAN,Independent,86,0,86,0.05,Tamil Nadu-Kolathur
20,V.SURESHKUMAR,Independent,22,0,22,0.01,Tamil Nadu-Kolathur
21,J.SURIYAMUTHU,Independent,109,1,110,0.06,Tamil Nadu-Kolathur
22,M.A.S. SENTHIL KUMAR,Independent,32,1,33,0.02,Tamil Nadu-Kolathur
23,P.SENTHIL KUMAR,Independent,38,0,38,0.02,Tamil Nadu-Kolathur
24,R.SELVAM,Independent,32,1,33,0.02,Tamil Nadu-Kolathur
25,DIVYA,Independent,180,1,181,0.1,Tamil Nadu-Kolathur
26,DEVIKARANI,Independent,37,0,37,0.02,Tamil Nadu-Kolathur
27,AL. NARESH KUMAR,Independent,198,0,198,0.11,Tamil Nadu-Kolathur
28,NIRMALA DEVI,Independent,29,0,29,0.02,Tamil Nadu-Kolathur
29,D.NILAMANI,Independent,44,1,45,0.03,Tamil Nadu-Kolathur
30,K. PANNERSELVAM,Independent,38,2,40,0.02,Tamil Nadu-Kolathur
31,MALARVIZHI,Independent,92,0,92,0.05,Tamil Nadu-Kolathur
32,MIRZA SAFDAR ALI,Independent,97,0,97,0.06,Tamil Nadu-Kolathur
33,RAMA DEVI,Independent,61,0,61,0.04,Tamil Nadu-Kolathur
34,B.VIJAYA KUMAR,Independent,18,0,18,0.01,Tamil Nadu-Kolathur
35,C.JEEVAKUMAR,Independent,52,0,52,0.03,Tamil Nadu-Kolathur
36,P.HARISHKUMAR,Independent,38,0,38,0.02,Tamil Nadu-Kolathur
37,NOTA,None of the Above,1518,11,1529,0.88,Tamil Nadu-Kolathur
1,KADAMBUR RAJU,All India Anna Dravida Munnetra Kazhagam,67970,586,68556,37.89,Tamil Nadu-Kovilpatti
2,K.Srinivasan,Communist Party of India  (Marxist),36234,1146,37380,20.66,Tamil Nadu-Kovilpatti
3,Ramachandiran.R,Bahujan Samaj Party,200,3,203,0.11,Tamil Nadu-Kovilpatti
4,S.Udaiyar,Naam Indiar Party,175,0,175,0.1,Tamil Nadu-Kovilpatti
5,K.Kathiravan,Makkal Needhi Maiam,3628,39,3667,2.03,Tamil Nadu-Kovilpatti
6,M.Gomathi,Naam Tamilar Katchi,9114,99,9213,5.09,Tamil Nadu-Kovilpatti
7,K.Shanmugasundaram,Bahujan Dravida Party,244,2,246,0.14,Tamil Nadu-Kovilpatti
8,TTV DHINAKARAN,Amma Makkal Munnettra Kazagam,55729,424,56153,31.04,Tamil Nadu-Kovilpatti
9,M.G.R.Nambbi,All India MGR Makkal Munnetra Kazhagam,244,0,244,0.13,Tamil Nadu-Kovilpatti
10,RAJKUMAR POLIAH,Universal Brotherhood Movement,97,2,99,0.05,Tamil Nadu-Kovilpatti
11,Athikaran @ Athikumar,Independent,638,6,644,0.36,Tamil Nadu-Kovilpatti
12,J.Ravisankar Jayachanthiran,Independent,203,2,205,0.11,Tamil Nadu-Kovilpatti
13,P.Ramasamy,Independent,66,0,66,0.04,Tamil Nadu-Kovilpatti
14,Kannan,Independent,121,0,121,0.07,Tamil Nadu-Kovilpatti
15,A.Kaliraj,Independent,315,0,315,0.17,Tamil Nadu-Kovilpatti
16,P.Gunasekaran,Independent,405,7,412,0.23,Tamil Nadu-Kovilpatti
17,Sivasubramanian,Independent,420,0,420,0.23,Tamil Nadu-Kovilpatti
18,Subash,Independent,442,1,443,0.24,Tamil Nadu-Kovilpatti
19,A.PattuRani,Independent,134,2,136,0.08,Tamil Nadu-Kovilpatti
20,K.Pandimuneeswari,Independent,78,3,81,0.04,Tamil Nadu-Kovilpatti
21,M.Ponnusamy,Independent,118,2,120,0.07,Tamil Nadu-Kovilpatti
22,Manthirasudamani,Independent,103,1,104,0.06,Tamil Nadu-Kovilpatti
23,M.Marimuthu,Independent,133,0,133,0.07,Tamil Nadu-Kovilpatti
24,Rameshkannan,Independent,498,0,498,0.28,Tamil Nadu-Kovilpatti
25,Raja,Independent,79,1,80,0.04,Tamil Nadu-Kovilpatti
26,Renganayagalu,Independent,90,0,90,0.05,Tamil Nadu-Kovilpatti
27,NOTA,None of the Above,1106,18,1124,0.62,Tamil Nadu-Kovilpatti
1,Ashokkumar.K,All India Anna Dravida Munnetra Kazhagam,95300,750,96050,45.38,Tamil Nadu-Krishnagiri
2,CHANDRAMOHAN.K.M,Nationalist Congress Party,1072,16,1088,0.51,Tamil Nadu-Krishnagiri
3,SENGUTTUVAN.T,Dravida Munnetra Kazhagam,93507,1749,95256,45.01,Tamil Nadu-Krishnagiri
4,TAMILSELVAN.S,Bahujan Samaj Party,485,3,488,0.23,Tamil Nadu-Krishnagiri
5,AMEENULLA,All India Majlis-E-Ittehadul Muslimeen,851,7,858,0.41,Tamil Nadu-Krishnagiri
6,SASIKUMAR.K.S,Anna Puratchi Thalaivar Amma Dravida Munnetra Kazhagam,128,1,129,0.06,Tamil Nadu-Krishnagiri
7,NIRANDARI.V,Naam Tamilar Katchi,11009,128,11137,5.26,Tamil Nadu-Krishnagiri
8,RAVISHANKAR.R.K,Makkal Needhi Maiam,3423,32,3455,1.63,Tamil Nadu-Krishnagiri
9,RUTHRAMANI.T,Desiya Makkal Sakthi Katchi,84,5,89,0.04,Tamil Nadu-Krishnagiri
10,VIJAYAKUMAR.R,Veerath Thiyagi Viswanathadoss Thozhilalarkal Katchi,133,4,137,0.06,Tamil Nadu-Krishnagiri
11,TVS GANDHI,Independent,97,0,97,0.05,Tamil Nadu-Krishnagiri
12,KUMARESAN.M,Independent,59,0,59,0.03,Tamil Nadu-Krishnagiri
13,GOPINATH.M,Independent,229,3,232,0.11,Tamil Nadu-Krishnagiri
14,SAKTHI.K,Independent,417,1,418,0.2,Tamil Nadu-Krishnagiri
15,SIVAN.C,Independent,314,4,318,0.15,Tamil Nadu-Krishnagiri
16,NOTA,None of the Above,1827,10,1837,0.87,Tamil Nadu-Krishnagiri
1,KATHIRVEL.M,Desiya Murpokku Dravida Kazhagam,1940,6,1946,1.08,Tamil Nadu-Krishnarayapuram
2,SIVAGAMA SUNDARI.K,Dravida Munnetra Kazhagam,95321,1219,96540,53.37,Tamil Nadu-Krishnarayapuram
3,MUTHUKUMAR,All India Anna Dravida Munnetra Kazhagam,64507,408,64915,35.88,Tamil Nadu-Krishnarayapuram
4,MURUGESAN.R,Bahujan Samaj Party,538,2,540,0.3,Tamil Nadu-Krishnarayapuram
5,ASHOKAN.P,Puthiya Tamilagam,194,1,195,0.11,Tamil Nadu-Krishnarayapuram
6,ILAKIYA.R,Naam Tamilar Katchi,9654,52,9706,5.37,Tamil Nadu-Krishnarayapuram
7,CHANDRA.P,My India Party,128,0,128,0.07,Tamil Nadu-Krishnarayapuram
8,SARAVANAN.V,Makkal Needhi Maiam,1837,11,1848,1.02,Tamil Nadu-Krishnarayapuram
9,NARAYANAN.KR,Communist Party of India  (Marxist-Leninist)  (Liberation),100,1,101,0.06,Tamil Nadu-Krishnarayapuram
10,RAJAGURU. M,Samaniya Makkal Nala Katchi,121,1,122,0.07,Tamil Nadu-Krishnarayapuram
11,KRISHNAMOORTHI.M,Independent,119,0,119,0.07,Tamil Nadu-Krishnarayapuram
12,GOPI KRISHNAN.P,Independent,97,0,97,0.05,Tamil Nadu-Krishnarayapuram
13,SAKTHIVEL.K,Independent,151,0,151,0.08,Tamil Nadu-Krishnarayapuram
14,SATHYARAJ,Independent,433,0,433,0.24,Tamil Nadu-Krishnarayapuram
15,SIVAKUMAR. O,Independent,910,1,911,0.5,Tamil Nadu-Krishnarayapuram
16,CHINNASAMY.V,Independent,377,0,377,0.21,Tamil Nadu-Krishnarayapuram
17,SENTHILKUMAR.M,Independent,214,0,214,0.12,Tamil Nadu-Krishnarayapuram
18,SELVAKUMAR.S,Independent,710,0,710,0.39,Tamil Nadu-Krishnarayapuram
19,TAMIL SELVAN.M,Independent,242,0,242,0.13,Tamil Nadu-Krishnarayapuram
20,NAGARAJAN. C,Independent,68,0,68,0.04,Tamil Nadu-Krishnarayapuram
21,MAHAMUNI.A,Independent,27,0,27,0.01,Tamil Nadu-Krishnarayapuram
22,MAHESWARAN.A,Independent,24,0,24,0.01,Tamil Nadu-Krishnarayapuram
23,MUHILAN.T,Independent,21,0,21,0.01,Tamil Nadu-Krishnarayapuram
24,MURUGANANTHAM.T,Independent,69,0,69,0.04,Tamil Nadu-Krishnarayapuram
25,RAMESH.N.P,Independent,107,1,108,0.06,Tamil Nadu-Krishnarayapuram
26,RAJAGOPAL.K,Independent,113,0,113,0.06,Tamil Nadu-Krishnarayapuram
27,NOTA,None of the Above,1172,5,1177,0.65,Tamil Nadu-Krishnarayapuram
1,P.Anbalagan,Bahujan Samaj Party,585,5,590,0.3,Tamil Nadu-Kulithalai
2,N.R.Chandrasekar,All India Anna Dravida Munnetra Kazhagam,76579,710,77289,39.14,Tamil Nadu-Kulithalai
3,R.Manickam,Dravida Munnetra Kazhagam,99285,1544,100829,51.06,Tamil Nadu-Kulithalai
4,M.Sankar,Samaniya Makkal Nala Katchi,455,5,460,0.23,Tamil Nadu-Kulithalai
5,A.Subethar,Tipu Sultan Party,213,2,215,0.11,Tamil Nadu-Kulithalai
6,V.Nirosha,Amma Makkal Munnettra Kazagam,754,7,761,0.39,Tamil Nadu-Kulithalai
7,Seeni.Prakasu,Naam Tamilar Katchi,11426,85,11511,5.83,Tamil Nadu-Kulithalai
8,S.Manikandan,Indiya Jananayaka Katchi,670,4,674,0.34,Tamil Nadu-Kulithalai
9,V.Alex Mouris,Independent,244,1,245,0.12,Tamil Nadu-Kulithalai
10,S.Kandasamy,Independent,138,0,138,0.07,Tamil Nadu-Kulithalai
11,R.Kalyana Sundaram,Independent,109,2,111,0.06,Tamil Nadu-Kulithalai
12,R.Chandrasekar,Independent,674,20,694,0.35,Tamil Nadu-Kulithalai
13,M.Saravanan,Independent,213,8,221,0.11,Tamil Nadu-Kulithalai
14,R.Saravanan,Independent,834,4,838,0.42,Tamil Nadu-Kulithalai
15,K.Suresh,Independent,490,4,494,0.25,Tamil Nadu-Kulithalai
16,B.Selvaraj,Independent,399,0,399,0.2,Tamil Nadu-Kulithalai
17,S.Barani,Independent,184,0,184,0.09,Tamil Nadu-Kulithalai
18,V.Vellaiyan,Independent,612,0,612,0.31,Tamil Nadu-Kulithalai
19,NOTA,None of the Above,1187,4,1191,0.6,Tamil Nadu-Kulithalai
1,K.R.SIVASUBIRAMANIYAN,Desiya Murpokku Dravida Kazhagam,1021,1,1022,0.51,Tamil Nadu-Kumarapalayam
2,THANGAMANI.P,All India Anna Dravida Munnetra Kazhagam,100201,599,100800,49.92,Tamil Nadu-Kumarapalayam
3,M.VENKATACHALAM,Dravida Munnetra Kazhagam,68521,633,69154,34.25,Tamil Nadu-Kumarapalayam
4,K.KAMARAJ,Makkal Needhi Maiam,6107,18,6125,3.03,Tamil Nadu-Kumarapalayam
5,R.KUMARESAN,Manitha Urimaigal Kalaagam,304,0,304,0.15,Tamil Nadu-Kumarapalayam
6,R.KUMAR,Ambedkarite Party of India,55,2,57,0.03,Tamil Nadu-Kumarapalayam
7,SUBRAMANI.S,Communist Party of India  (Marxist-Leninist)  (Liberation),112,1,113,0.06,Tamil Nadu-Kumarapalayam
8,S.VARUN,Naam Tamilar Katchi,13171,69,13240,6.56,Tamil Nadu-Kumarapalayam
9,V.AMIRTHALINGAM,Independent,118,1,119,0.06,Tamil Nadu-Kumarapalayam
10,OMMSHARRAVANA.S,Independent,7305,37,7342,3.64,Tamil Nadu-Kumarapalayam
11,M.KATHAVARAYAN,Independent,76,0,76,0.04,Tamil Nadu-Kumarapalayam
12,KARTHI,Independent,155,0,155,0.08,Tamil Nadu-Kumarapalayam
13,GOPALAKRISHNAN,Independent,61,2,63,0.03,Tamil Nadu-Kumarapalayam
14,GOWRISANKARAN,Independent,199,1,200,0.1,Tamil Nadu-Kumarapalayam
15,SARAVANAN,Independent,242,0,242,0.12,Tamil Nadu-Kumarapalayam
16,P.SENGODAGOUNDAR,Independent,409,2,411,0.2,Tamil Nadu-Kumarapalayam
17,K.SELLAPPAN,Independent,131,0,131,0.06,Tamil Nadu-Kumarapalayam
18,M.DHANASEKARAN,Independent,252,0,252,0.12,Tamil Nadu-Kumarapalayam
19,B.BALAKRISHNAN,Independent,188,0,188,0.09,Tamil Nadu-Kumarapalayam
20,S.PRABHAKARAN,Independent,37,0,37,0.02,Tamil Nadu-Kumarapalayam
21,S.PONGIYANNAN,Independent,193,1,194,0.1,Tamil Nadu-Kumarapalayam
22,MANIKANDAN,Independent,22,0,22,0.01,Tamil Nadu-Kumarapalayam
23,M.YUVARAJ,Independent,30,0,30,0.01,Tamil Nadu-Kumarapalayam
24,G.RAGAVENDIRAN,Independent,23,0,23,0.01,Tamil Nadu-Kumarapalayam
25,G.RAJUGANESAN,Independent,42,0,42,0.02,Tamil Nadu-Kumarapalayam
26,K.A.VIJAYAN,Independent,35,0,35,0.02,Tamil Nadu-Kumarapalayam
27,A.VENKATACHALAM,Independent,27,0,27,0.01,Tamil Nadu-Kumarapalayam
28,K.VENKATACHALAM,Independent,77,1,78,0.04,Tamil Nadu-Kumarapalayam
29,P.VENKATACHALAM,Independent,100,1,101,0.05,Tamil Nadu-Kumarapalayam
30,NOTA,None of the Above,1337,5,1342,0.66,Tamil Nadu-Kumarapalayam
1,"ANBALAGAN, G.",Dravida Munnetra Kazhagam,94284,1773,96057,48.62,Tamil Nadu-Kumbakonam
2,"SRITHAR VANDAYAR, G.M.",All India Anna Dravida Munnetra Kazhagam,74334,340,74674,37.8,Tamil Nadu-Kumbakonam
3,"ANANDH, M.",Naam Tamilar Katchi,12419,61,12480,6.32,Tamil Nadu-Kumbakonam
4,"GOPALAKRISHNAN, G.",Makkal Needhi Maiam,5234,42,5276,2.67,Tamil Nadu-Kumbakonam
5,"BALAMURUGAN, S.",Amma Makkal Munnettra Kazagam,6475,48,6523,3.3,Tamil Nadu-Kumbakonam
6,"AYYAPPAN, M.",Independent,208,1,209,0.11,Tamil Nadu-Kumbakonam
7,"GURUMOORTHI, D.",Independent,229,5,234,0.12,Tamil Nadu-Kumbakonam
8,"SUBRAMANIAN, P.",Independent,151,2,153,0.08,Tamil Nadu-Kumbakonam
9,"PRAKASH, P.",Independent,119,1,120,0.06,Tamil Nadu-Kumbakonam
10,"VIJAYAKUMAR, C.",Independent,190,0,190,0.1,Tamil Nadu-Kumbakonam
11,NOTA,None of the Above,1623,25,1648,0.83,Tamil Nadu-Kumbakonam
1,"RAMACHANDRAN, R.T.",All India Anna Dravida Munnetra Kazhagam,96734,859,97593,44.38,Tamil Nadu-Kunnam
2,"SIVASANKAR, S.S.",Dravida Munnetra Kazhagam,102707,1215,103922,47.26,Tamil Nadu-Kunnam
3,"PANDIYAN, S.",Bahujan Samaj Party,494,0,494,0.22,Tamil Nadu-Kunnam
4,"ARUL, P.",Naam Tamilar Katchi,9319,35,9354,4.25,Tamil Nadu-Kunnam
5,"RAVANAN, M.",New Generation Peopleâ€™s Party,183,4,187,0.09,Tamil Nadu-Kunnam
6,"KAARTHIKEYAN, S.",Amma Makkal Munnettra Kazagam,2092,26,2118,0.96,Tamil Nadu-Kunnam
7,"SATHIK BASHA, A.S.",Makkal Needhi Maiam,731,8,739,0.34,Tamil Nadu-Kunnam
8,"ARUL, G.",Independent,119,4,123,0.06,Tamil Nadu-Kunnam
9,"KATHIRAVAN, C.",Independent,47,1,48,0.02,Tamil Nadu-Kunnam
10,"KALAISELVI, J.",Independent,67,1,68,0.03,Tamil Nadu-Kunnam
11,KALAIYARASI SARAVANAN,Independent,89,1,90,0.04,Tamil Nadu-Kunnam
12,"GOWTHAMAN, V.",Independent,331,5,336,0.15,Tamil Nadu-Kunnam
13,"SURESHKUMAR, S.",Independent,265,4,269,0.12,Tamil Nadu-Kunnam
14,"SELVAM, J.",Independent,174,0,174,0.08,Tamil Nadu-Kunnam
15,"SELVARAJU, R.",Independent,977,0,977,0.44,Tamil Nadu-Kunnam
16,"BALAMURUGAN, S.",Independent,934,0,934,0.42,Tamil Nadu-Kunnam
17,"PRAKASH, M.R.",Independent,604,0,604,0.27,Tamil Nadu-Kunnam
18,"PUGALENTHI, Dr.S.",Independent,366,0,366,0.17,Tamil Nadu-Kunnam
19,"MANIKANDAN, K.",Independent,152,0,152,0.07,Tamil Nadu-Kunnam
20,"MATHIYAZHAGAN, S.",Independent,86,1,87,0.04,Tamil Nadu-Kunnam
21,"MUTHAMILSELVAN, D.",Independent,40,0,40,0.02,Tamil Nadu-Kunnam
22,"VINOTHKUMAR, M.",Independent,451,0,451,0.21,Tamil Nadu-Kunnam
23,NOTA,None of the Above,751,2,753,0.34,Tamil Nadu-Kunnam
1,SELVI RAMAJAYAM,All India Anna Dravida Munnetra Kazhagam,83478,451,83929,42.22,Tamil Nadu-Kurinjipadi
2,M.R.K.PANNEERSELVAM,Dravida Munnetra Kazhagam,100463,993,101456,51.04,Tamil Nadu-Kurinjipadi
3,T.VELAYUDHAM,Bahujan Samaj Party,480,2,482,0.24,Tamil Nadu-Kurinjipadi
4,K.CHANDRAMOULI,Janata Dal  (Secular),1178,11,1189,0.6,Tamil Nadu-Kurinjipadi
5,S.SUMATHI,Naam Tamilar Katchi,8470,42,8512,4.28,Tamil Nadu-Kurinjipadi
6,R.MUTHUKRISHNAN,Anna Dravidar Kazhagam,140,0,140,0.07,Tamil Nadu-Kurinjipadi
7,A.VASANTHAKUMAR,Amma Makkal Munnettra Kazagam,834,3,837,0.42,Tamil Nadu-Kurinjipadi
8,R.SARATHKUMAR,Independent,154,0,154,0.08,Tamil Nadu-Kurinjipadi
9,BRIJITA ROSLENE,Independent,91,1,92,0.05,Tamil Nadu-Kurinjipadi
10,L.MADHIYAZHAGAN,Independent,139,0,139,0.07,Tamil Nadu-Kurinjipadi
11,N.MUTHAZHAGAN,Independent,124,0,124,0.06,Tamil Nadu-Kurinjipadi
12,R.RAJESH,Independent,515,0,515,0.26,Tamil Nadu-Kurinjipadi
13,NOTA,None of the Above,1208,4,1212,0.61,Tamil Nadu-Kurinjipadi
1,A.SOUNDARAPANDIAN,Dravida Munnetra Kazhagam,83264,1650,84914,48.59,Tamil Nadu-Lalgudi
2,D.R.DHARMARAJ,All India Anna Dravida Munnetra Kazhagam,67612,353,67965,38.89,Tamil Nadu-Lalgudi
3,K.KAMARAJ,Samaniya Makkal Nala Katchi,268,2,270,0.15,Tamil Nadu-Lalgudi
4,R.SILAMBARASAN,Anna MGR Dravida Makkal Kalgam,138,0,138,0.08,Tamil Nadu-Lalgudi
5,P.NAMBIRAJAN,Puthiya Tamilagam,123,1,124,0.07,Tamil Nadu-Lalgudi
6,I.MALAR TAMIL PRABHA,Naam Tamilar Katchi,16134,114,16248,9.3,Tamil Nadu-Lalgudi
7,VEERAN.MUTHUKUMAR,Shiv Sena,64,1,65,0.04,Tamil Nadu-Lalgudi
8,M.VIJAYAMURTHY,Amma Makkal Munnettra Kazagam,2913,28,2941,1.68,Tamil Nadu-Lalgudi
9,K.ANANTHABABU,Independent,56,1,57,0.03,Tamil Nadu-Lalgudi
10,A.ANANDHKUMAR,Independent,92,4,96,0.05,Tamil Nadu-Lalgudi
11,P.M.SAHADEVAN,Independent,65,0,65,0.04,Tamil Nadu-Lalgudi
12,ANBIL K.THANGAMANI,Independent,246,1,247,0.14,Tamil Nadu-Lalgudi
13,K.DHARMARAJ,Independent,120,0,120,0.07,Tamil Nadu-Lalgudi
14,U.JOHNSON,Independent,303,1,304,0.17,Tamil Nadu-Lalgudi
15,NOTA,None of the Above,1191,9,1200,0.69,Tamil Nadu-Lalgudi
1,J.BENJAMIN KIRUBAKARAN,Bahujan Samaj Party,465,2,467,0.26,Tamil Nadu-Madathukulam
2,C MAHENDRAN,All India Anna Dravida Munnetra Kazhagam,83634,679,84313,46.35,Tamil Nadu-Madathukulam
3,R.JAYARAMAKRISHNAN,Dravida Munnetra Kazhagam,76885,990,77875,42.81,Tamil Nadu-Madathukulam
4,K KUMARESAN,Makkal Needhi Maiam,2877,17,2894,1.59,Tamil Nadu-Madathukulam
5,K SAKTHIVEL,Anna Puratchi Thalaivar Amma Dravida Munnetra Kazhagam,105,0,105,0.06,Tamil Nadu-Madathukulam
6,C.SHANMUGAVELU,Amma Makkal Munnettra Kazagam,6467,48,6515,3.58,Tamil Nadu-Madathukulam
7,U SANUJA,Naam Tamilar Katchi,6200,45,6245,3.43,Tamil Nadu-Madathukulam
8,M SHANMUGAVEL,Independent,130,0,130,0.07,Tamil Nadu-Madathukulam
9,P SUBRAMANIAN,Independent,83,0,83,0.05,Tamil Nadu-Madathukulam
10,P THANGARAJ,Independent,86,2,88,0.05,Tamil Nadu-Madathukulam
11,K.MAHALINGAM,Independent,136,5,141,0.08,Tamil Nadu-Madathukulam
12,K MAHENDRAKUMAR,Independent,609,2,611,0.34,Tamil Nadu-Madathukulam
13,P MAHENDRAN,Independent,171,1,172,0.09,Tamil Nadu-Madathukulam
14,K MANICKASAMY,Independent,503,0,503,0.28,Tamil Nadu-Madathukulam
15,G RAMAKRISHNAN,Independent,711,1,712,0.39,Tamil Nadu-Madathukulam
16,NOTA,None of the Above,1042,6,1048,0.58,Tamil Nadu-Madathukulam
1,SUDHARSANAM. S,Dravida Munnetra Kazhagam,150654,831,151485,50.04,Tamil Nadu-Madavaram
2,DEEPAK. S,Bahujan Samaj Party,1390,3,1393,0.46,Tamil Nadu-Madavaram
3,Moorthy. V,All India Anna Dravida Munnetra Kazhagam,94206,208,94414,31.19,Tamil Nadu-Madavaram
4,ARAVIND KUMAR. P,Desiya Makkal Sakthi Katchi,465,0,465,0.15,Tamil Nadu-Madavaram
5,ELUMALAI. R,Naam Tamilar Katchi,27411,42,27453,9.07,Tamil Nadu-Madavaram
6,SAMBATH. E,Shiv Sena,175,0,175,0.06,Tamil Nadu-Madavaram
7,DHAKSHNAMOORTHY. D,Amma Makkal Munnettra Kazagam,7088,16,7104,2.35,Tamil Nadu-Madavaram
8,YUVARAJ. M,Anna MGR Dravida Makkal Kalgam,81,0,81,0.03,Tamil Nadu-Madavaram
9,VINOTH KUMAR. M,Naadaalum Makkal Katchi,113,1,114,0.04,Tamil Nadu-Madavaram
10,RAMESH,Makkal Needhi Maiam,15838,39,15877,5.25,Tamil Nadu-Madavaram
11,ARIVUNITHI. S,Independent,108,0,108,0.04,Tamil Nadu-Madavaram
12,SAKTHIVEL. A,Independent,83,2,85,0.03,Tamil Nadu-Madavaram
13,SATHISH KUMAR. S,Independent,62,0,62,0.02,Tamil Nadu-Madavaram
14,SUDHARSANAN. D,Independent,169,1,170,0.06,Tamil Nadu-Madavaram
15,NIRMAL KUMAR. M,Independent,101,0,101,0.03,Tamil Nadu-Madavaram
16,BABU. M.G,Independent,411,2,413,0.14,Tamil Nadu-Madavaram
17,MOORTHY. S,Independent,437,0,437,0.14,Tamil Nadu-Madavaram
18,RAMESH. G,Independent,47,0,47,0.02,Tamil Nadu-Madavaram
19,RAMU. S,Independent,431,0,431,0.14,Tamil Nadu-Madavaram
20,JAYASEELAN. S,Independent,119,0,119,0.04,Tamil Nadu-Madavaram
21,NOTA,None of the Above,2161,5,2166,0.72,Tamil Nadu-Madavaram
1,THAVAMANI A,Bahujan Samaj Party,283,3,286,0.19,Tamil Nadu-Madurai Central
2,PALANIVEL THIAGA RAJAN,Dravida Munnetra Kazhagam,72231,974,73205,48.99,Tamil Nadu-Madurai Central
3,JOTHI MUTHURAMALINGAM N,All India Anna Dravida Munnetra Kazhagam,38834,195,39029,26.12,Tamil Nadu-Madurai Central
4,ESWARI M,My India Party,285,2,287,0.19,Tamil Nadu-Madurai Central
5,SIKKANDAR BATCHA G S,SOCIAL DEMOCRATIC PARTY OF INDIA,3327,20,3347,2.24,Tamil Nadu-Madurai Central
6,PANDIAMMAL J,Naam Tamilar Katchi,11156,59,11215,7.51,Tamil Nadu-Madurai Central
7,MANI B,Makkal Needhi Maiam,14437,58,14495,9.7,Tamil Nadu-Madurai Central
8,RAJAKUMAR NAIDU E V S,Tamil Telugu National Party,175,1,176,0.12,Tamil Nadu-Madurai Central
9,ELANGOVAN R,Independent,264,0,264,0.18,Tamil Nadu-Madurai Central
10,KREMMER SURESH,Independent,4880,27,4907,3.28,Tamil Nadu-Madurai Central
11,KRISHNAPRABBU M R,Independent,437,3,440,0.29,Tamil Nadu-Madurai Central
12,SATHIYENDRAN N,Independent,51,0,51,0.03,Tamil Nadu-Madurai Central
13,SIVASANKAR S,Independent,94,0,94,0.06,Tamil Nadu-Madurai Central
14,RAJASURIYAA K R,Independent,192,1,193,0.13,Tamil Nadu-Madurai Central
15,NOTA,None of the Above,1432,9,1441,0.96,Tamil Nadu-Madurai Central
1,GOPALAKRISHNAN R,All India Anna Dravida Munnetra Kazhagam,72588,537,73125,30.74,Tamil Nadu-Madurai East
2,MOORTHY P,Dravida Munnetra Kazhagam,120459,2270,122729,51.59,Tamil Nadu-Madurai East
3,SARAVANAN T,Amma Makkal Munnettra Kazagam,6636,93,6729,2.83,Tamil Nadu-Madurai East
4,BALAMURUGAN A,Puthiya Tamilagam,1737,18,1755,0.74,Tamil Nadu-Madurai East
5,PRABAHARAN M,Bahujan Dravida Party,109,3,112,0.05,Tamil Nadu-Madurai East
6,MUTHUKRISHNAN I,Makkal Needhi Maiam,11864,129,11993,5.04,Tamil Nadu-Madurai East
7,MUTHU KRISHNAN M,Anaithu Makkal Puratchi Katchi,151,1,152,0.06,Tamil Nadu-Madurai East
8,MUSTAK MOHAMED.A.K,Tipu Sultan Party,306,2,308,0.13,Tamil Nadu-Madurai East
9,RAJA P,My India Party,120,2,122,0.05,Tamil Nadu-Madurai East
10,LATHA J,Naam Tamilar Katchi,17504,164,17668,7.43,Tamil Nadu-Madurai East
11,GANDHI K,Independent,232,1,233,0.1,Tamil Nadu-Madurai East
12,CHANDRASEKARAN V,Independent,345,1,346,0.15,Tamil Nadu-Madurai East
13,DINESH G,Independent,95,0,95,0.04,Tamil Nadu-Madurai East
14,PALANIAMMAL P,Independent,345,4,349,0.15,Tamil Nadu-Madurai East
15,JEYAKUMAR P,Independent,231,1,232,0.1,Tamil Nadu-Madurai East
16,NOTA,None of the Above,1923,21,1944,0.82,Tamil Nadu-Madurai East
1,SARAVANAN P,Bharatiya Janata Party,49700,394,50094,32,Tamil Nadu-Madurai North
2,THALAPATHI G,Dravida Munnetra Kazhagam,71949,1061,73010,46.64,Tamil Nadu-Madurai North
3,ALAGAR M,Makkal Needhi Maiam,12019,83,12102,7.73,Tamil Nadu-Madurai North
4,ANBARASI S,Naam Tamilar Katchi,15178,133,15311,9.78,Tamil Nadu-Madurai North
5,VASANTHAKUMAR S,Anna Dravidar Kazhagam,167,0,167,0.11,Tamil Nadu-Madurai North
6,VOLTAIRE M J,SOCIALIST UNITY CENTRE OF INDIA (COMMUNIST),114,1,115,0.07,Tamil Nadu-Madurai North
7,JEYAPAL M,Amma Makkal Munnettra Kazagam,3235,45,3280,2.1,Tamil Nadu-Madurai North
8,ABUBAKKAR SITHICK J,Independent,138,1,139,0.09,Tamil Nadu-Madurai North
9,RAAM VISHWAKARMA T,Independent,93,1,94,0.06,Tamil Nadu-Madurai North
10,ISMAIL D,Independent,105,0,105,0.07,Tamil Nadu-Madurai North
11,KUPPUSAMY N,Independent,49,0,49,0.03,Tamil Nadu-Madurai North
12,KESAVARAJAH J,Independent,69,1,70,0.04,Tamil Nadu-Madurai North
13,SANKARAPANDI P,Independent,161,2,163,0.1,Tamil Nadu-Madurai North
14,THEIVAMMAL K,Independent,124,1,125,0.08,Tamil Nadu-Madurai North
15,NATARAJAN R,Independent,167,1,168,0.11,Tamil Nadu-Madurai North
16,NOTA,None of the Above,1548,16,1564,1,Tamil Nadu-Madurai North
1,SARAVANAN. S.S,All India Anna Dravida Munnetra Kazhagam,56005,292,56297,38.08,Tamil Nadu-Madurai South
2,BOOMINATHAN.M,Dravida Munnetra Kazhagam,62284,528,62812,42.49,Tamil Nadu-Madurai South
3,ABBAS.M,Naam Tamilar Katchi,10430,53,10483,7.09,Tamil Nadu-Madurai South
4,ESWARAN.G,Makkal Needhi Maiam,12773,48,12821,8.67,Tamil Nadu-Madurai South
5,SADAM HUSSAIN.K,My India Party,104,0,104,0.07,Tamil Nadu-Madurai South
6,BHARATHI KANNAMMA. S,New Generation Peopleâ€™s Party,140,0,140,0.09,Tamil Nadu-Madurai South
7,RAAJALINGAM.SHA,Amma Makkal Munnettra Kazagam,2662,10,2672,1.81,Tamil Nadu-Madurai South
8,UMESH.K.R,Independent,81,0,81,0.05,Tamil Nadu-Madurai South
9,SARAVANAN.R,Independent,254,3,257,0.17,Tamil Nadu-Madurai South
10,RAVICHANDRAN.V.C,Independent,116,0,116,0.08,Tamil Nadu-Madurai South
11,RAJKUMAR(a)MANIKANDAN.K,Independent,162,0,162,0.11,Tamil Nadu-Madurai South
12,VENGADACHALAPATHY.T.S,Independent,158,1,159,0.11,Tamil Nadu-Madurai South
13,JEYA.K,Independent,175,3,178,0.12,Tamil Nadu-Madurai South
14,NOTA,None of the Above,1532,19,1551,1.05,Tamil Nadu-Madurai South
1,CHINNAMMAL. C,Dravida Munnetra Kazhagam,73463,1299,74762,37.07,Tamil Nadu-Madurai West
2,BALACHANDRAN. P,Desiya Murpokku Dravida Kazhagam,3384,33,3417,1.69,Tamil Nadu-Madurai West
3,RAJU. K,All India Anna Dravida Munnetra Kazhagam,83586,297,83883,41.59,Tamil Nadu-Madurai West
4,KARTHIKEYAN. R,Akhil Bharat Hindu Mahasabha,315,3,318,0.16,Tamil Nadu-Madurai West
5,SULTHAN BADUSHA. J,Anna MGR Dravida Makkal Kalgam,79,0,79,0.04,Tamil Nadu-Madurai West
6,NAGAJOTHI. K,Tamil Nadu Ilangyar Katchi,2483,26,2509,1.24,Tamil Nadu-Madurai West
7,MUNIYASAMY. V,Makkal Needhi Maiam,15749,100,15849,7.86,Tamil Nadu-Madurai West
8,VETRIKUMARAN. C,Naam Tamilar Katchi,18133,91,18224,9.04,Tamil Nadu-Madurai West
9,ARASU THIRUVALAVAN. K. K,Independent,96,1,97,0.05,Tamil Nadu-Madurai West
10,ANBUMANIKANDANTAMILSOORIYAN.K,Independent,73,0,73,0.04,Tamil Nadu-Madurai West
11,SULTHAN BASHA. K,Independent,43,1,44,0.02,Tamil Nadu-Madurai West
12,SEBASTHIYAN. B,Independent,49,0,49,0.02,Tamil Nadu-Madurai West
13,PREMKUMAR. M,Independent,122,0,122,0.06,Tamil Nadu-Madurai West
14,RAMU. N,Independent,368,0,368,0.18,Tamil Nadu-Madurai West
15,VENKATESAN. M,Independent,126,0,126,0.06,Tamil Nadu-Madurai West
16,NOTA,None of the Above,1757,17,1774,0.88,Tamil Nadu-Madurai West
1,Sathya. C.E,Dravida Munnetra Kazhagam,81739,1337,83076,44.7,Tamil Nadu-Madurantakam
2,Madhanraj. M,Bahujan Samaj Party,587,0,587,0.32,Tamil Nadu-Madurantakam
3,Maragatham. K,All India Anna Dravida Munnetra Kazhagam,85791,855,86646,46.62,Tamil Nadu-Madurantakam
4,Moorthi . N,Desiya Murpokku Dravida Kazhagam,2130,7,2137,1.15,Tamil Nadu-Madurantakam
5,Kothandan. A,Desiya Sirupanmayinar Makkal Iyakkam,249,2,251,0.14,Tamil Nadu-Madurantakam
6,Subash. S,Makkal Munnetra Peravai,120,1,121,0.07,Tamil Nadu-Madurantakam
7,Sumitha. P,Naam Tamilar Katchi,9249,44,9293,5,Tamil Nadu-Madurantakam
8,Dinesh. K,Makkal Needhi Maiam,1476,12,1488,0.8,Tamil Nadu-Madurantakam
9,Tamizhselvan. S,Independent,633,6,639,0.34,Tamil Nadu-Madurantakam
10,Ranjitham. M,Independent,233,0,233,0.13,Tamil Nadu-Madurantakam
11,NOTA,None of the Above,1369,2,1371,0.74,Tamil Nadu-Madurantakam
1,GANAPATHY.K,Dravida Munnetra Kazhagam,120441,857,121298,44.29,Tamil Nadu-Maduravoyal
2,SANTHAKUMAR.Y,Bahujan Samaj Party,622,6,628,0.23,Tamil Nadu-Maduravoyal
3,BENJAMIN.P,All India Anna Dravida Munnetra Kazhagam,89313,264,89577,32.71,Tamil Nadu-Maduravoyal
4,LAVANYA.P,Nationalist Congress Party,348,1,349,0.13,Tamil Nadu-Maduravoyal
5,GANESHKUMAR.G,Naam Tamilar Katchi,20999,46,21045,7.68,Tamil Nadu-Maduravoyal
6,SHANMUGAM.K,Tamil Nadu Ilangyar Katchi,906,2,908,0.33,Tamil Nadu-Maduravoyal
7,SUMITHRA.R,Bahujan Dravida Party,64,0,64,0.02,Tamil Nadu-Maduravoyal
8,NEVIS STELLA MARY.B,Anaithu Makkal Arasiyal Katchi,124,0,124,0.05,Tamil Nadu-Maduravoyal
9,PADMA PRIYA.S,Makkal Needhi Maiam,33310,91,33401,12.2,Tamil Nadu-Maduravoyal
10,MUTHURAMAN.S,Anna MGR Dravida Makkal Kalgam,69,0,69,0.03,Tamil Nadu-Maduravoyal
11,LUCKY MURUGAN.E,Amma Makkal Munnettra Kazagam,2648,12,2660,0.97,Tamil Nadu-Maduravoyal
12,ABARAJITHAN.R,Independent,142,1,143,0.05,Tamil Nadu-Maduravoyal
13,AMALRAJ.S,Independent,69,0,69,0.03,Tamil Nadu-Maduravoyal
14,ARUNKUMAR.A,Independent,95,0,95,0.03,Tamil Nadu-Maduravoyal
15,GANAPATHY.R,Independent,96,0,96,0.04,Tamil Nadu-Maduravoyal
16,SELVAKUMAR.V,Independent,287,0,287,0.1,Tamil Nadu-Maduravoyal
17,PRIYA.K,Independent,552,1,553,0.2,Tamil Nadu-Maduravoyal
18,BENJAMIN MOSES.S,Independent,149,0,149,0.05,Tamil Nadu-Maduravoyal
19,MURUGAN.D,Independent,161,0,161,0.06,Tamil Nadu-Maduravoyal
20,RAVI.C.V,Independent,48,0,48,0.02,Tamil Nadu-Maduravoyal
21,NOTA,None of the Above,2137,9,2146,0.78,Tamil Nadu-Maduravoyal
1,SUNDARESAN A,Desiya Murpokku Dravida Kazhagam,3913,8,3921,2.22,Tamil Nadu-Mailam
2,DURAI M,Bahujan Samaj Party,647,1,648,0.37,Tamil Nadu-Mailam
3,Dr. MASILAMANI R,Dravida Munnetra Kazhagam,77899,915,78814,44.53,Tamil Nadu-Mailam
4,UMAMAHESWARI L,Naam Tamilar Katchi,8315,25,8340,4.71,Tamil Nadu-Mailam
5,SIVAKUMAR C,Pattali Makkal Katchi,80203,841,81044,45.79,Tamil Nadu-Mailam
6,MANAVALAN A,Anna MGR Dravida Makkal Kalgam,373,4,377,0.21,Tamil Nadu-Mailam
7,KANNAN G,Independent,109,0,109,0.06,Tamil Nadu-Mailam
8,SATHIYARAJ S,Independent,144,0,144,0.08,Tamil Nadu-Mailam
9,CHANDRA PRAKASH R,Independent,249,0,249,0.14,Tamil Nadu-Mailam
10,SEKAR NAYAKKAR I M,Independent,137,0,137,0.08,Tamil Nadu-Mailam
11,MASILAMANI V,Independent,519,5,524,0.3,Tamil Nadu-Mailam
12,MASILAMANI V,Independent,805,2,807,0.46,Tamil Nadu-Mailam
13,RAJASEKAR M,Independent,641,6,647,0.37,Tamil Nadu-Mailam
14,SRIDHAR D,Independent,343,1,344,0.19,Tamil Nadu-Mailam
15,NOTA,None of the Above,882,2,884,0.5,Tamil Nadu-Mailam
1,V. INDIRANI,Bahujan Samaj Party,448,3,451,0.23,Tamil Nadu-Manachanallur
2,S. KATHIRAVAN,Dravida Munnetra Kazhagam,114451,1883,116334,59.14,Tamil Nadu-Manachanallur
3,M. PARANJOTHI,All India Anna Dravida Munnetra Kazhagam,56366,350,56716,28.83,Tamil Nadu-Manachanallur
4,C. ARULMANI,Akila India Vallalar Peravai,379,0,379,0.19,Tamil Nadu-Manachanallur
5,M. RAJASEKHARN,Amma Makkal Munnettra Kazagam,1619,12,1631,0.83,Tamil Nadu-Manachanallur
6,Dr. KRISHNASAMY. V,Naam Tamilar Katchi,14361,82,14443,7.34,Tamil Nadu-Manachanallur
7,K. GURUNATHAN,Samaniya Makkal Nala Katchi,103,0,103,0.05,Tamil Nadu-Manachanallur
8,R. SAMSON,Makkal Needhi Maiam,1975,21,1996,1.01,Tamil Nadu-Manachanallur
9,M. DHINAKARAN,Puthiya Tamilagam,155,3,158,0.08,Tamil Nadu-Manachanallur
10,T. RENGARAJ,Tamil Nadu Ilangyar Katchi,240,0,240,0.12,Tamil Nadu-Manachanallur
11,S. ROHINI,Makkal Munnetra Peravai,89,2,91,0.05,Tamil Nadu-Manachanallur
12,P. JAGADEESAN,My India Party,110,2,112,0.06,Tamil Nadu-Manachanallur
13,P. RAMALINGAM,Independent,107,2,109,0.06,Tamil Nadu-Manachanallur
14,R. RAJASEHAR,Independent,135,2,137,0.07,Tamil Nadu-Manachanallur
15,K.R.ELAIYARAJA,Independent,237,0,237,0.12,Tamil Nadu-Manachanallur
16,V. GOPALAKRISHNAN,Independent,206,0,206,0.1,Tamil Nadu-Manachanallur
17,R. SUDHA,Independent,158,3,161,0.08,Tamil Nadu-Manachanallur
18,V.M. SELVARAJ,Independent,576,1,577,0.29,Tamil Nadu-Manachanallur
19,P. NEELAMEGAM,Independent,192,0,192,0.1,Tamil Nadu-Manachanallur
20,S. PUGAZHENTHI,Independent,166,2,168,0.09,Tamil Nadu-Manachanallur
21,P. MACHAVALLAVAN,Independent,38,0,38,0.02,Tamil Nadu-Manachanallur
22,K. MANIMARABOOPATHI,Independent,61,0,61,0.03,Tamil Nadu-Manachanallur
23,A.C. MANOHARAN,Independent,43,0,43,0.02,Tamil Nadu-Manachanallur
24,S. MANOJ KUMAR,Independent,55,0,55,0.03,Tamil Nadu-Manachanallur
25,V. MUTHUSAMY,Independent,100,0,100,0.05,Tamil Nadu-Manachanallur
26,N. MOHAN,Independent,91,0,91,0.05,Tamil Nadu-Manachanallur
27,K. RAJINIKANTH,Independent,110,0,110,0.06,Tamil Nadu-Manachanallur
28,P. RAJARAM,Independent,482,0,482,0.25,Tamil Nadu-Manachanallur
29,V. RAJU,Independent,230,1,231,0.12,Tamil Nadu-Manachanallur
30,NOTA,None of the Above,1055,12,1067,0.54,Tamil Nadu-Manachanallur
1,Tamilarasi A.,Dravida Munnetra Kazhagam,87827,1537,89364,44.01,Tamil Nadu-Manamadurai
2,Nagarajan S.,All India Anna Dravida Munnetra Kazhagam,74433,840,75273,37.07,Tamil Nadu-Manamadurai
3,Shanmugapriya M.,Naam Tamilar Katchi,22916,312,23228,11.44,Tamil Nadu-Manamadurai
4,Chandrasekar M.,Anaithu Makkal Puratchi Katchi,226,3,229,0.11,Tamil Nadu-Manamadurai
5,Sivasankari P.,Makkal Needhi Maiam,2219,38,2257,1.11,Tamil Nadu-Manamadurai
6,Mariappankennady S.,Amma Makkal Munnettra Kazagam,10074,157,10231,5.04,Tamil Nadu-Manamadurai
7,Muralitharan M.,Anna MGR Dravida Makkal Kalgam,128,0,128,0.06,Tamil Nadu-Manamadurai
8,Rajendran A.,My India Party,104,7,111,0.05,Tamil Nadu-Manamadurai
9,Karuppaiah S.,Independent,83,1,84,0.04,Tamil Nadu-Manamadurai
10,Thamaraiselvi S.,Independent,140,2,142,0.07,Tamil Nadu-Manamadurai
11,Duraipandi M.,Independent,125,0,125,0.06,Tamil Nadu-Manamadurai
12,Muthumari K.,Independent,185,0,185,0.09,Tamil Nadu-Manamadurai
13,Rajaiah  C.,Independent,369,2,371,0.18,Tamil Nadu-Manamadurai
14,NOTA,None of the Above,1318,15,1333,0.66,Tamil Nadu-Manamadurai
1,ABDUL SAMAD P,Dravida Munnetra Kazhagam,96204,1873,98077,44.23,Tamil Nadu-Manapparai
2,KRISHNAGOPAL P,Desiya Murpokku Dravida Kazhagam,10666,53,10719,4.83,Tamil Nadu-Manapparai
3,CHANDRASEKAR.R,All India Anna Dravida Munnetra Kazhagam,85133,701,85834,38.71,Tamil Nadu-Manapparai
4,UMARANI K,Indiya Jananayaka Katchi,908,6,914,0.41,Tamil Nadu-Manapparai
5,KANIMOZHI.P,Naam Tamilar Katchi,19358,92,19450,8.77,Tamil Nadu-Manapparai
6,SAKTHIVEL.M,Communist Party of India  (Marxist-Leninist)  (Liberation),186,5,191,0.09,Tamil Nadu-Manapparai
7,PANDIAN V,Ezhuchi Tamilargal Munnetra Kazhagam,128,1,129,0.06,Tamil Nadu-Manapparai
8,VARADAN.M,Lok Jan Shakti Party,81,1,82,0.04,Tamil Nadu-Manapparai
9,ARPUTHASAMY V,Independent,286,1,287,0.13,Tamil Nadu-Manapparai
10,ILANGOVAN S,Independent,122,1,123,0.06,Tamil Nadu-Manapparai
11,ELAYARAJA C,Independent,544,3,547,0.25,Tamil Nadu-Manapparai
12,KARTHICK KRISHNA P,Independent,173,0,173,0.08,Tamil Nadu-Manapparai
13,SATHYA PRIYA A,Independent,301,6,307,0.14,Tamil Nadu-Manapparai
14,CHANDRASEKAR V,Independent,1255,4,1259,0.57,Tamil Nadu-Manapparai
15,CHITHAIYAN T,Independent,261,9,270,0.12,Tamil Nadu-Manapparai
16,CHINNAN P,Independent,649,1,650,0.29,Tamil Nadu-Manapparai
17,SUBRAMANIAN P,Independent,628,0,628,0.28,Tamil Nadu-Manapparai
18,DAVID P,Independent,179,1,180,0.08,Tamil Nadu-Manapparai
19,NIRMAL KUMAR M,Independent,543,1,544,0.25,Tamil Nadu-Manapparai
20,PRASANNA KUMAR P,Independent,113,0,113,0.05,Tamil Nadu-Manapparai
21,RASU P,Independent,169,0,169,0.08,Tamil Nadu-Manapparai
22,JEYAPANDIAN D,Independent,93,0,93,0.04,Tamil Nadu-Manapparai
23,NOTA,None of the Above,1002,7,1009,0.46,Tamil Nadu-Manapparai
1,RAJAMANICKAM  SIVA,All India Anna Dravida Munnetra Kazhagam,49570,209,49779,25.76,Tamil Nadu-Mannargudi
2,RAJAA T R B,Dravida Munnetra Kazhagam,86071,1101,87172,45.11,Tamil Nadu-Mannargudi
3,ARAVINDAN RAMA,Naam Tamilar Katchi,10398,40,10438,5.4,Tamil Nadu-Mannargudi
4,ANBANANDAM S,Makkal Needhi Maiam,1358,8,1366,0.71,Tamil Nadu-Mannargudi
5,KAMARAJ S,Amma Makkal Munnettra Kazagam,40271,210,40481,20.95,Tamil Nadu-Mannargudi
6,SATHISKUMAR S,Puthiya Tamilagam,584,4,588,0.3,Tamil Nadu-Mannargudi
7,KUMARESAN T,Independent,1837,8,1845,0.95,Tamil Nadu-Mannargudi
8,BARADHIDASAN T,Independent,95,2,97,0.05,Tamil Nadu-Mannargudi
9,MARIMUTHU A.V.M,Independent,124,1,125,0.06,Tamil Nadu-Mannargudi
10,MURUGAN S,Independent,376,2,378,0.2,Tamil Nadu-Mannargudi
11,NOTA,None of the Above,955,5,960,0.5,Tamil Nadu-Mannargudi
1,Shamsudeen.N,Bahujan Samaj Party,523,3,526,0.3,Tamil Nadu-Mayiladuthurai
2,Rajakumar.S,Indian National Congress,72376,1266,73642,42.17,Tamil Nadu-Mayiladuthurai
3,Anbarasan Komal R K,Amma Makkal Munnettra Kazagam,7205,77,7282,4.17,Tamil Nadu-Mayiladuthurai
4,Kasiraman.K,Naam Tamilar Katchi,13123,63,13186,7.55,Tamil Nadu-Mayiladuthurai
5,Palanisamy.A,Pattali Makkal Katchi,70310,590,70900,40.6,Tamil Nadu-Mayiladuthurai
6,Ravichandran.N,Makkal Needhi Maiam,5850,83,5933,3.4,Tamil Nadu-Mayiladuthurai
7,Rajkumar.S,Tamil Nadu Ilangyar Katchi,645,6,651,0.37,Tamil Nadu-Mayiladuthurai
8,Ganesan.S,Independent,185,0,185,0.11,Tamil Nadu-Mayiladuthurai
9,Loga.Sampath,Independent,152,3,155,0.09,Tamil Nadu-Mayiladuthurai
10,Thimothy.T,Independent,135,3,138,0.08,Tamil Nadu-Mayiladuthurai
11,Niranjan.R,Independent,242,1,243,0.14,Tamil Nadu-Mayiladuthurai
12,Babusankar.R,Independent,167,1,168,0.1,Tamil Nadu-Mayiladuthurai
13,Manimaran.T,Independent,206,2,208,0.12,Tamil Nadu-Mayiladuthurai
14,Rajendran.M,Independent,356,0,356,0.2,Tamil Nadu-Mayiladuthurai
15,NOTA,None of the Above,1054,13,1067,0.61,Tamil Nadu-Mayiladuthurai
1,RAVICHANDRAN  T.,Indian National Congress,47727,455,48182,26.36,Tamil Nadu-Melur
2,PERIYAPULLAN @ SELVAM  P.,All India Anna Dravida Munnetra Kazhagam,83126,218,83344,45.6,Tamil Nadu-Melur
3,KATHIRESAN  K.,Makkal Needhi Maiam,2161,15,2176,1.19,Tamil Nadu-Melur
4,KARUPPUSAMY  P.,Naam Tamilar Katchi,10606,63,10669,5.84,Tamil Nadu-Melur
5,SENTHILRAJ  K.,My India Party,270,0,270,0.15,Tamil Nadu-Melur
6,SELVARAJ  A.,Amma Makkal Munnettra Kazagam,34027,235,34262,18.74,Tamil Nadu-Melur
7,KANNAN  P.,Independent,257,1,258,0.14,Tamil Nadu-Melur
8,GOBALAKRISHNAN  M.,Independent,350,0,350,0.19,Tamil Nadu-Melur
9,SIVASAMY  R.,Independent,109,1,110,0.06,Tamil Nadu-Melur
10,DHARMAR  P.,Independent,95,0,95,0.05,Tamil Nadu-Melur
11,DHINAKARAN  S.,Independent,274,0,274,0.15,Tamil Nadu-Melur
12,NAGENDRAN  N.,Independent,199,1,200,0.11,Tamil Nadu-Melur
13,PANDI  K.,Independent,736,0,736,0.4,Tamil Nadu-Melur
14,BALAN  T.,Independent,630,0,630,0.34,Tamil Nadu-Melur
15,MOHANRAM  C.,Independent,342,0,342,0.19,Tamil Nadu-Melur
16,NOTA,None of the Above,875,9,884,0.48,Tamil Nadu-Melur
1,SHANMUGASUNDARAM T R,Dravida Munnetra Kazhagam,101451,1324,102775,45.66,Tamil Nadu-Mettuppalayam
2,SELVARAJ A K,All India Anna Dravida Munnetra Kazhagam,104632,599,105231,46.75,Tamil Nadu-Mettuppalayam
3,SARAVANAN P,Amma Makkal Munnettra Kazagam,1856,8,1864,0.83,Tamil Nadu-Mettuppalayam
4,MAHESHWARAN K,Veerath Thiyagi Viswanathadoss Thozhilalarkal Katchi,274,0,274,0.12,Tamil Nadu-Mettuppalayam
5,YASMIN K,Naam Tamilar Katchi,10900,54,10954,4.87,Tamil Nadu-Mettuppalayam
6,SHANMUGASUNDARAM K,Independent,115,0,115,0.05,Tamil Nadu-Mettuppalayam
7,SHANMUGASUNDARAM P,Independent,184,0,184,0.08,Tamil Nadu-Mettuppalayam
8,MARIAPPAN T,Independent,110,0,110,0.05,Tamil Nadu-Mettuppalayam
9,LIAKATHALI O,Independent,182,1,183,0.08,Tamil Nadu-Mettuppalayam
10,SRINIVASAN S,Independent,653,7,660,0.29,Tamil Nadu-Mettuppalayam
11,NOTA,None of the Above,2701,32,2733,1.21,Tamil Nadu-Mettuppalayam
1,SRINIVASAPERUMAL.S,Dravida Munnetra Kazhagam,94437,1962,96399,44.13,Tamil Nadu-Mettur
2,RAMESH ARAVIND.M,Desiya Murpokku Dravida Kazhagam,1860,14,1874,0.86,Tamil Nadu-Mettur
3,ANUSUYA.P,Makkal Needhi Maiam,4549,56,4605,2.11,Tamil Nadu-Mettur
4,SADHASIVAM.S,Pattali Makkal Katchi,95795,1260,97055,44.43,Tamil Nadu-Mettur
5,THANGAVEL. K,Dhesiya Makkal Kazhagam,1781,2,1783,0.82,Tamil Nadu-Mettur
6,BANUPRIYA.P,Ganasangam Party of India,434,1,435,0.2,Tamil Nadu-Mettur
7,MANIKANDAN.C,Naam Tamilar Katchi,9004,105,9109,4.17,Tamil Nadu-Mettur
8,RASAPPAN.K,My India Party,226,0,226,0.1,Tamil Nadu-Mettur
9,AMBIKA.A,Independent,732,6,738,0.34,Tamil Nadu-Mettur
10,ARIVAZHAGAN.P,Independent,166,2,168,0.08,Tamil Nadu-Mettur
11,SADHASIVAM.P,Independent,383,3,386,0.18,Tamil Nadu-Mettur
12,SELVAN,Independent,2817,6,2823,1.29,Tamil Nadu-Mettur
13,SEKAR.P,Independent,266,3,269,0.12,Tamil Nadu-Mettur
14,Dr.PADMARAJAN.K,Independent,321,4,325,0.15,Tamil Nadu-Mettur
15,NOTA,None of the Above,2239,8,2247,1.03,Tamil Nadu-Mettur
1,SARASWATHI.C,Bharatiya Janata Party,77653,472,78125,42.96,Tamil Nadu-Modakkurichi
2,SUBBULAKSHMI JEGADEESAN,Dravida Munnetra Kazhagam,76409,1435,77844,42.81,Tamil Nadu-Modakkurichi
3,BOOPATHI.R,Bahujan Samaj Party,1136,7,1143,0.63,Tamil Nadu-Modakkurichi
4,THANGARAJ.D,Amma Makkal Munnettra Kazagam,1539,8,1547,0.85,Tamil Nadu-Modakkurichi
5,PRAKASH.G,Naam Tamilar Katchi,12871,73,12944,7.12,Tamil Nadu-Modakkurichi
6,MAHESWARAN .A,My India Party,288,7,295,0.16,Tamil Nadu-Modakkurichi
7,MANI.P,India Dravida Makkal Munnetra Katchi,119,0,119,0.07,Tamil Nadu-Modakkurichi
8,MANICKAM.R,Ganasangam Party of India,326,1,327,0.18,Tamil Nadu-Modakkurichi
9,RAMESH.M,Namathu Kongu Munnetra Kalagam,230,5,235,0.13,Tamil Nadu-Modakkurichi
10,RAJESHKUMAR.M,Makkal Needhi Maiam,4555,19,4574,2.52,Tamil Nadu-Modakkurichi
11,GOVANAM THANGAVEL.K.S,Independent,300,1,301,0.17,Tamil Nadu-Modakkurichi
12,SAMI KANDHASAMY,Independent,881,1,882,0.48,Tamil Nadu-Modakkurichi
13,BHARATHI.L,Independent,273,2,275,0.15,Tamil Nadu-Modakkurichi
14,MAYILSAMY.P,Independent,335,0,335,0.18,Tamil Nadu-Modakkurichi
15,VIJAYAKUMAR.M,Independent,562,7,569,0.31,Tamil Nadu-Modakkurichi
16,NOTA,None of the Above,2332,10,2342,1.29,Tamil Nadu-Modakkurichi
1,KEERTHIKA,All India Anna Dravida Munnetra Kazhagam,80166,1014,81180,36.7,Tamil Nadu-Mudhukulathur
2,N.SIVANANDAM,Bahujan Samaj Party,533,2,535,0.24,Tamil Nadu-Mudhukulathur
3,R.S.RAJAKANNAPPAN,Dravida Munnetra Kazhagam,100328,1573,101901,46.06,Tamil Nadu-Mudhukulathur
4,A.SARAVANAKUMAR,Naam Indiar Party,609,5,614,0.28,Tamil Nadu-Mudhukulathur
5,C.NAVAPANNEERSELVAM,Makkal Needhi Maiam,923,20,943,0.43,Tamil Nadu-Mudhukulathur
6,K.PANCHATCHARAM,My India Party,133,1,134,0.06,Tamil Nadu-Mudhukulathur
7,K.BOOMIRAJAN YADAV,Tamilaga Makkal Thannurimai Katchi,212,2,214,0.1,Tamil Nadu-Mudhukulathur
8,C.MALAISELVAM,Puthiya Tamilagam,383,10,393,0.18,Tamil Nadu-Mudhukulathur
9,M.MURUGAN,Amma Makkal Munnettra Kazagam,19403,266,19669,8.89,Tamil Nadu-Mudhukulathur
10,R.RAHMADNISHA,Naam Tamilar Katchi,11099,145,11244,5.08,Tamil Nadu-Mudhukulathur
11,S.RAJA,People's Party of India(secular),114,0,114,0.05,Tamil Nadu-Mudhukulathur
12,T.AZHAKUMALAI KUMARAN,Independent,127,4,131,0.06,Tamil Nadu-Mudhukulathur
13,S.IMMANUVEL SEKAR,Independent,197,1,198,0.09,Tamil Nadu-Mudhukulathur
14,K.RAMACHANDRAN,Independent,390,0,390,0.18,Tamil Nadu-Mudhukulathur
15,M.KARTHICK,Independent,140,1,141,0.06,Tamil Nadu-Mudhukulathur
16,K.SATHISH,Independent,807,6,813,0.37,Tamil Nadu-Mudhukulathur
17,G.M.SENTHILMURUGAN,Independent,708,5,713,0.32,Tamil Nadu-Mudhukulathur
18,DEVA SITHAM.I,Independent,199,5,204,0.09,Tamil Nadu-Mudhukulathur
19,S.PRABAKARAN,Independent,546,2,548,0.25,Tamil Nadu-Mudhukulathur
20,K.MURUGAN,Independent,327,0,327,0.15,Tamil Nadu-Mudhukulathur
21,P.MURUGAN,Independent,92,1,93,0.04,Tamil Nadu-Mudhukulathur
22,E.MOHAN,Independent,82,0,82,0.04,Tamil Nadu-Mudhukulathur
23,K.RAJAKUMAR,Independent,109,0,109,0.05,Tamil Nadu-Mudhukulathur
24,NOTA,None of the Above,521,2,523,0.24,Tamil Nadu-Mudhukulathur
1,Kumar.K.S,Desiya Murpokku Dravida Kazhagam,3153,29,3182,1.77,Tamil Nadu-Musiri
2,M. Selvarasu,All India Anna Dravida Munnetra Kazhagam,63179,609,63788,35.5,Tamil Nadu-Musiri
3,N. Thiyagarajan,Dravida Munnetra Kazhagam,88487,2137,90624,50.43,Tamil Nadu-Musiri
4,V. Bernardshaw,Bahujan Samaj Party,458,0,458,0.25,Tamil Nadu-Musiri
5,S. Gokul,Makkal Needhi Maiam,2467,32,2499,1.39,Tamil Nadu-Musiri
6,Gautham. S,Rashtriya Samaj Paksha,251,2,253,0.14,Tamil Nadu-Musiri
7,D. Dharmalingam,Samaniya Makkal Nala Katchi,109,1,110,0.06,Tamil Nadu-Musiri
8,Sridevi Ilangovan,Naam Tamilar Katchi,14207,104,14311,7.96,Tamil Nadu-Musiri
9,N. Aravan,Independent,108,0,108,0.06,Tamil Nadu-Musiri
10,R. Anandhan,Independent,103,1,104,0.06,Tamil Nadu-Musiri
11,Devanur Karthick,Independent,227,0,227,0.13,Tamil Nadu-Musiri
12,Shanmugam,Independent,361,2,363,0.2,Tamil Nadu-Musiri
13,"A.Chandran. M.Sc.,",Independent,174,1,175,0.1,Tamil Nadu-Musiri
14,N. Saminathan,Independent,313,4,317,0.18,Tamil Nadu-Musiri
15,N. Sivakumar,Independent,513,0,513,0.29,Tamil Nadu-Musiri
16,T. Senthil Kumar,Independent,497,0,497,0.28,Tamil Nadu-Musiri
17,V. Natarajan,Independent,164,0,164,0.09,Tamil Nadu-Musiri
18,T. Periyathambi,Independent,462,1,463,0.26,Tamil Nadu-Musiri
19,R. Michael,Independent,297,0,297,0.17,Tamil Nadu-Musiri
20,"P. Loganathan. M.sc.,",Independent,160,1,161,0.09,Tamil Nadu-Musiri
21,NOTA,None of the Above,1081,11,1092,0.61,Tamil Nadu-Musiri
1,NATARAJ.R,All India Anna Dravida Munnetra Kazhagam,55466,293,55759,36.34,Tamil Nadu-Mylapore
2,BALAJI,Bahujan Samaj Party,410,3,413,0.27,Tamil Nadu-Mylapore
3,VELU.DHA,Dravida Munnetra Kazhagam,67919,473,68392,44.58,Tamil Nadu-Mylapore
4,KARTHICK.D,Amma Makkal Munnettra Kazagam,1113,5,1118,0.73,Tamil Nadu-Mylapore
5,SENTHIL KUMAR.D,Anaithu Makkal Arasiyal Katchi,82,0,82,0.05,Tamil Nadu-Mylapore
6,MAHALAKSHMI.K,Naam Tamilar Katchi,10098,26,10124,6.6,Tamil Nadu-Mylapore
7,MOHANRAJ.J,Jebamani Janata,113,0,113,0.07,Tamil Nadu-Mylapore
8,SRIPRIYA,Makkal Needhi Maiam,14850,54,14904,9.71,Tamil Nadu-Mylapore
9,ARUNRAJ BALAN,Independent,76,0,76,0.05,Tamil Nadu-Mylapore
10,KAJENDRAN.M,Independent,35,3,38,0.02,Tamil Nadu-Mylapore
11,KUPPUSWAMY.T.M,Independent,26,0,26,0.02,Tamil Nadu-Mylapore
12,SHANMUGARAJAN B,Independent,35,0,35,0.02,Tamil Nadu-Mylapore
13,SELVAKUMAR,Independent,112,0,112,0.07,Tamil Nadu-Mylapore
14,NATARAJAN P,Independent,127,2,129,0.08,Tamil Nadu-Mylapore
15,NANDAGOPAL.G,Independent,85,2,87,0.06,Tamil Nadu-Mylapore
16,NALLAPPAN.G,Independent,181,0,181,0.12,Tamil Nadu-Mylapore
17,PASUPATHI PRAGALATHAN,Independent,117,0,117,0.08,Tamil Nadu-Mylapore
18,MALAR KANNAN.R,Independent,29,0,29,0.02,Tamil Nadu-Mylapore
19,RANGARAJAN.R,Independent,93,0,93,0.06,Tamil Nadu-Mylapore
20,RADHA M (TRANSGENDER),Independent,203,0,203,0.13,Tamil Nadu-Mylapore
21,VARATHARAJAN.V.S,Independent,49,1,50,0.03,Tamil Nadu-Mylapore
22,V. VIJAYA KRISHNA,Independent,38,0,38,0.02,Tamil Nadu-Mylapore
23,VENKATESH,Independent,24,0,24,0.02,Tamil Nadu-Mylapore
24,NOTA,None of the Above,1279,8,1287,0.84,Tamil Nadu-Mylapore
1,Thanka.kathiravan,All India Anna Dravida Munnetra Kazhagam,58729,314,59043,41.13,Tamil Nadu-Nagapattinam
2,S.Augustine Arputharaj,Naam Tamilar Katchi,9931,45,9976,6.95,Tamil Nadu-Nagapattinam
3,T. Singaravadivelan,Shiv Sena,105,0,105,0.07,Tamil Nadu-Nagapattinam
4,Syed Anas Mohideen Sahip,Makkal Needhi Maiam,2523,17,2540,1.77,Tamil Nadu-Nagapattinam
5,J.V. Durai,Makkalatchi Katchi,96,2,98,0.07,Tamil Nadu-Nagapattinam
6,C.Manjula,Amma Makkal Munnettra Kazagam,3457,46,3503,2.44,Tamil Nadu-Nagapattinam
7,Mayilarasi,Naadaalum Makkal Katchi,256,0,256,0.18,Tamil Nadu-Nagapattinam
8,J. Mohamed Shanavas,Viduthalai Chiruthaigal Katchi,65587,694,66281,46.17,Tamil Nadu-Nagapattinam
9,V. Canagaradjou,Independent,208,1,209,0.15,Tamil Nadu-Nagapattinam
10,Durai. Selvakumar,Independent,110,3,113,0.08,Tamil Nadu-Nagapattinam
11,N P Bhashgaran,Independent,180,4,184,0.13,Tamil Nadu-Nagapattinam
12,S. Prem,Independent,105,0,105,0.07,Tamil Nadu-Nagapattinam
13,V. Manikandan,Independent,252,0,252,0.18,Tamil Nadu-Nagapattinam
14,NOTA,None of the Above,893,2,895,0.62,Tamil Nadu-Nagapattinam
1,Gandhi M.R.,Bharatiya Janata Party,87805,999,88804,48.21,Tamil Nadu-Nagercoil
2,Suresh Rajan N.,Dravida Munnetra Kazhagam,75387,1748,77135,41.88,Tamil Nadu-Nagercoil
3,Ammu Anto I.,Amma Makkal Munnettra Kazagam,1079,15,1094,0.59,Tamil Nadu-Nagercoil
4,Satheesh Kumar D.,Anaithu Makkal Arasiyal Katchi,70,0,70,0.04,Tamil Nadu-Nagercoil
5,Sunil Kumar S.,Anaithu Makkal Puratchi Katchi,314,1,315,0.17,Tamil Nadu-Nagercoil
6,Maria Jacob Stani Raja S.,Makkal Needhi Maiam,4007,30,4037,2.19,Tamil Nadu-Nagercoil
7,Vijayaragavan,Naam Tamilar Katchi,10666,87,10753,5.84,Tamil Nadu-Nagercoil
8,Usha P.,Independent,132,2,134,0.07,Tamil Nadu-Nagercoil
9,Kannan M.,Independent,102,1,103,0.06,Tamil Nadu-Nagercoil
10,Gandhi L.,Independent,73,0,73,0.04,Tamil Nadu-Nagercoil
11,Gandhi Raj C.,Independent,182,1,183,0.1,Tamil Nadu-Nagercoil
12,Bala Sivanesan J.,Independent,238,4,242,0.13,Tamil Nadu-Nagercoil
13,Pravin Raj P.,Independent,97,0,97,0.05,Tamil Nadu-Nagercoil
14,Mahizhchi P.,Independent,80,1,81,0.04,Tamil Nadu-Nagercoil
15,Rathinam A.T.,Independent,133,1,134,0.07,Tamil Nadu-Nagercoil
16,NOTA,None of the Above,919,11,930,0.5,Tamil Nadu-Nagercoil
1,RAMASAMY P,Bahujan Samaj Party,254,7,261,0.13,Tamil Nadu-Namakkal
2,SARAVANAN A,National People's Party,130,2,132,0.06,Tamil Nadu-Namakkal
3,SELVI K,Desiya Murpokku Dravida Kazhagam,960,12,972,0.47,Tamil Nadu-Namakkal
4,BASKAR K.P.P.,All India Anna Dravida Munnetra Kazhagam,77043,1590,78633,38.03,Tamil Nadu-Namakkal
5,RAMALINGAM P,Dravida Munnetra Kazhagam,103480,3014,106494,51.51,Tamil Nadu-Namakkal
6,ADHAM FAROOK S,Makkal Needhi Maiam,5530,59,5589,2.7,Tamil Nadu-Namakkal
7,RAMESH T,Ahimsa Socialist Party,307,6,313,0.15,Tamil Nadu-Namakkal
8,KANAKARAJ K,Ganasangam Party of India,169,6,175,0.08,Tamil Nadu-Namakkal
9,SARAVANAN S,Naadaalum Makkal Katchi,57,1,58,0.03,Tamil Nadu-Namakkal
10,SIVAKUMAR D,Anna Puratchi Thalaivar Amma Dravida Munnetra Kazhagam,76,2,78,0.04,Tamil Nadu-Namakkal
11,SELVAKUMAR E,Manitha Urimaigal Kalaagam,144,5,149,0.07,Tamil Nadu-Namakkal
12,TAMIZHVANAN K,Tamilaga Makkal Thannurimai Katchi,428,5,433,0.21,Tamil Nadu-Namakkal
13,THIYAGARAJAN R,Samaniya Makkal Nala Katchi,189,4,193,0.09,Tamil Nadu-Namakkal
14,BASKAR B,Naam Tamilar Katchi,10008,114,10122,4.9,Tamil Nadu-Namakkal
15,MADHESWARAN A.S,My India Party,113,1,114,0.06,Tamil Nadu-Namakkal
16,ARUL SELVAN,Independent,287,4,291,0.14,Tamil Nadu-Namakkal
17,ANBUMANI,Independent,220,3,223,0.11,Tamil Nadu-Namakkal
18,KUPPUSAMY M,Independent,43,2,45,0.02,Tamil Nadu-Namakkal
19,SURESH KUMAR L,Independent,104,3,107,0.05,Tamil Nadu-Namakkal
20,SELVAKUMAR R,Independent,197,1,198,0.1,Tamil Nadu-Namakkal
21,CHO V,Independent,252,1,253,0.12,Tamil Nadu-Namakkal
22,DEEPAN CHAKKRAVARTHI S,Independent,247,2,249,0.12,Tamil Nadu-Namakkal
23,MUTHUSAMY S,Independent,84,3,87,0.04,Tamil Nadu-Namakkal
24,RAMALINGAM K,Independent,114,4,118,0.06,Tamil Nadu-Namakkal
25,JAWAHAR,Independent,85,1,86,0.04,Tamil Nadu-Namakkal
26,JAYARAMACHANDRAN P,Independent,100,1,101,0.05,Tamil Nadu-Namakkal
27,NOTA,None of the Above,1266,19,1285,0.62,Tamil Nadu-Namakkal
1,GANESARAJA,All India Anna Dravida Munnetra Kazhagam,59045,371,59416,30.86,Tamil Nadu-Nanguneri
2,SUBBULAKSHMI,Bahujan Samaj Party,697,3,700,0.36,Tamil Nadu-Nanguneri
3,RUBY R MANOHARAN,Indian National Congress,74493,1409,75902,39.43,Tamil Nadu-Nanguneri
4,KANDHAN,Anaithu Ulaga Tamilargal Munnetra Kalagam,495,2,497,0.26,Tamil Nadu-Nanguneri
5,SHUNMUGA SUNDARAM,Naam Indiar Party,441,0,441,0.23,Tamil Nadu-Nanguneri
6,PARAMASIVA IYYAPPAN,Amma Makkal Munnettra Kazagam,31708,162,31870,16.55,Tamil Nadu-Nanguneri
7,PRABAKARAN,Veerath Thiyagi Viswanathadoss Thozhilalarkal Katchi,429,1,430,0.22,Tamil Nadu-Nanguneri
8,VEERAPANDI,Naam Tamilar Katchi,17543,111,17654,9.17,Tamil Nadu-Nanguneri
9,ASHOK KUMAR,Independent,619,6,625,0.32,Tamil Nadu-Nanguneri
10,KATHIRAVAN,Independent,1151,3,1154,0.6,Tamil Nadu-Nanguneri
11,KANDASAMY,Independent,428,4,432,0.22,Tamil Nadu-Nanguneri
12,GNANA BALAJI,Independent,806,7,813,0.42,Tamil Nadu-Nanguneri
13,MUTHUDURAI,Independent,160,1,161,0.08,Tamil Nadu-Nanguneri
14,MUTHURAJ,Independent,434,2,436,0.23,Tamil Nadu-Nanguneri
15,LENIN,Independent,449,5,454,0.24,Tamil Nadu-Nanguneri
16,NOTA,None of the Above,1531,6,1537,0.8,Tamil Nadu-Nanguneri
1,KAMARAJ R,All India Anna Dravida Munnetra Kazhagam,103236,401,103637,46.7,Tamil Nadu-Nannilam
2,RAVICHANDRAN  R,Bahujan Samaj Party,711,0,711,0.32,Tamil Nadu-Nannilam
3,JOTHIRAMAN  S,Dravida Munnetra Kazhagam,98409,804,99213,44.7,Tamil Nadu-Nannilam
4,RAMACHANDRAN   N,Amma Makkal Munnettra Kazagam,2070,6,2076,0.94,Tamil Nadu-Nannilam
5,GANESAN  D,Indiya Jananayaka Katchi,379,2,381,0.17,Tamil Nadu-Nannilam
6,NITHIYANANTHAM  S,Anaithu Makkal Arasiyal Katchi,81,0,81,0.04,Tamil Nadu-Nannilam
7,PANASAIARAGAN K N,Desiya Makkal Sakthi Katchi,111,0,111,0.05,Tamil Nadu-Nannilam
8,FATHIMA FARHANA  S,Naam Tamilar Katchi,13377,42,13419,6.05,Tamil Nadu-Nannilam
9,MURUGAVEL  M,Anna Dravidar Kazhagam,163,1,164,0.07,Tamil Nadu-Nannilam
10,ANUSHA  T,Independent,203,3,206,0.09,Tamil Nadu-Nannilam
11,KRISHNAN  K,Independent,46,1,47,0.02,Tamil Nadu-Nannilam
12,KUMARAN  R,Independent,77,1,78,0.04,Tamil Nadu-Nannilam
13,TAMILSELVAN  R,Independent,153,0,153,0.07,Tamil Nadu-Nannilam
14,NATARAJAN  C,Independent,352,0,352,0.16,Tamil Nadu-Nannilam
15,RAJA S,Independent,125,0,125,0.06,Tamil Nadu-Nannilam
16,NOTA,None of the Above,1188,2,1190,0.54,Tamil Nadu-Nannilam
1,M.A.ANDI AMBALAM,Dravida Munnetra Kazhagam,94968,862,95830,42.54,Tamil Nadu-Natham
2,P.ANDISAMY,Bahujan Samaj Party,676,2,678,0.3,Tamil Nadu-Natham
3,NATHAM.R.VISWANATHAN,All India Anna Dravida Munnetra Kazhagam,107255,507,107762,47.84,Tamil Nadu-Natham
4,R.A.SARANRAJ,Indiya Jananayaka Katchi,1019,6,1025,0.46,Tamil Nadu-Natham
5,DOCTOR.V.SIVASANKARAN,Naam Tamilar Katchi,14673,89,14762,6.55,Tamil Nadu-Natham
6,N.RAJA,Amma Makkal Munnettra Kazagam,1713,8,1721,0.76,Tamil Nadu-Natham
7,V.VEMBARASAN,My India Party,164,2,166,0.07,Tamil Nadu-Natham
8,A.KARNAN,Independent,335,0,335,0.15,Tamil Nadu-Natham
9,C.GURUSAMY,Independent,95,1,96,0.04,Tamil Nadu-Natham
10,M.XAVIER JOSEPH KENNEDY,Independent,189,5,194,0.09,Tamil Nadu-Natham
11,K.DHANDAPANI,Independent,321,1,322,0.14,Tamil Nadu-Natham
12,A.BALASUBRAMANI,Independent,112,0,112,0.05,Tamil Nadu-Natham
13,K.MURUGESAN,Independent,224,0,224,0.1,Tamil Nadu-Natham
14,S.JEYAKUMAR,Independent,383,0,383,0.17,Tamil Nadu-Natham
15,JEYAPAUL R,Independent,190,0,190,0.08,Tamil Nadu-Natham
16,NOTA,None of the Above,1438,6,1444,0.64,Tamil Nadu-Natham
1,KANAGARAJI.C,Bahujan Samaj Party,450,5,455,0.28,Tamil Nadu-Neyveli
2,SABA.RAJENDRAN,Dravida Munnetra Kazhagam,74189,988,75177,45.8,Tamil Nadu-Neyveli
3,ILANGOVAN.R,Indiya Jananayaka Katchi,1006,5,1011,0.62,Tamil Nadu-Neyveli
4,BAKTHARATCHAGAN.R,Amma Makkal Munnettra Kazagam,2221,9,2230,1.36,Tamil Nadu-Neyveli
5,RAMESH.K,Naam Tamilar Katchi,7763,22,7785,4.74,Tamil Nadu-Neyveli
6,JAGAN.K,Pattali Makkal Katchi,73544,656,74200,45.21,Tamil Nadu-Neyveli
7,DHANASEKARAN.S,Independent,333,1,334,0.2,Tamil Nadu-Neyveli
8,DHILIBAN.U,Independent,392,0,392,0.24,Tamil Nadu-Neyveli
9,DHURGA.K,Independent,204,5,209,0.13,Tamil Nadu-Neyveli
10,BOOBALAN.E,Independent,91,0,91,0.06,Tamil Nadu-Neyveli
11,RAJENDRAN .B,Independent,552,4,556,0.34,Tamil Nadu-Neyveli
12,VADUGANATHAN.R,Independent,519,0,519,0.32,Tamil Nadu-Neyveli
13,NOTA,None of the Above,1164,7,1171,0.71,Tamil Nadu-Neyveli
1,K.Ramasamy,Desiya Murpokku Dravida Kazhagam,3684,20,3704,2,Tamil Nadu-Nilakkottai
2,S.Thenmozhi,All India Anna Dravida Munnetra Kazhagam,90857,604,91461,49.49,Tamil Nadu-Nilakkottai
3,P.Nagendran,Bahujan Samaj Party,664,2,666,0.36,Tamil Nadu-Nilakkottai
4,K.Murugavelrajan,Dravida Munnetra Kazhagam,62593,1250,63843,34.55,Tamil Nadu-Nilakkottai
5,V.K.Aiyyar,Puthiya Tamilagam,478,6,484,0.26,Tamil Nadu-Nilakkottai
6,Ananth,Makkal Needhi Maiam,3146,35,3181,1.72,Tamil Nadu-Nilakkottai
7,V.Revadhi,My India Party,155,3,158,0.09,Tamil Nadu-Nilakkottai
8,G.Vasanthadevi,Naam Tamilar Katchi,17363,142,17505,9.47,Tamil Nadu-Nilakkottai
9,A.Alappan,Independent,340,3,343,0.19,Tamil Nadu-Nilakkottai
10,M.Kalimuthu,Independent,61,0,61,0.03,Tamil Nadu-Nilakkottai
11,P.Sivakami,Independent,76,1,77,0.04,Tamil Nadu-Nilakkottai
12,P.Nagajothi,Independent,511,4,515,0.28,Tamil Nadu-Nilakkottai
13,S.Nithya,Independent,126,2,128,0.07,Tamil Nadu-Nilakkottai
14,M.Pandi,Independent,135,2,137,0.07,Tamil Nadu-Nilakkottai
15,V.Balasubramani,Independent,163,1,164,0.09,Tamil Nadu-Nilakkottai
16,N.Perumal,Independent,252,0,252,0.14,Tamil Nadu-Nilakkottai
17,P.Pothumanickam,Independent,372,3,375,0.2,Tamil Nadu-Nilakkottai
18,V.Vinoth,Independent,491,0,491,0.27,Tamil Nadu-Nilakkottai
19,NOTA,None of the Above,1248,12,1260,0.68,Tamil Nadu-Nilakkottai
1,SAKKARAPANI R,Dravida Munnetra Kazhagam,108990,980,109970,54.51,Tamil Nadu-Oddanchatram
2,SIVA KUMAR M,Desiya Murpokku Dravida Kazhagam,1417,10,1427,0.71,Tamil Nadu-Oddanchatram
3,NATARAJ N.P,All India Anna Dravida Munnetra Kazhagam,80819,409,81228,40.26,Tamil Nadu-Oddanchatram
4,MURUGARAJ P,Bahujan Samaj Party,527,2,529,0.26,Tamil Nadu-Oddanchatram
5,ABDUL HADI A,Makkal Needhi Maiam,1069,13,1082,0.54,Tamil Nadu-Oddanchatram
6,SAKTHI DEVI T,Naam Tamilar Katchi,4892,52,4944,2.45,Tamil Nadu-Oddanchatram
7,RAVI M,Anaithu Makkal Puratchi Katchi,61,0,61,0.03,Tamil Nadu-Oddanchatram
8,RAVICHANDRAN K,My India Party,52,0,52,0.03,Tamil Nadu-Oddanchatram
9,SHANMUGAVEL P,Independent,40,0,40,0.02,Tamil Nadu-Oddanchatram
10,SIVAPRAKASH S,Independent,44,0,44,0.02,Tamil Nadu-Oddanchatram
11,SIVANESAN K,Independent,59,0,59,0.03,Tamil Nadu-Oddanchatram
12,CHELLAMUTHU K,Independent,100,0,100,0.05,Tamil Nadu-Oddanchatram
13,BALASUBRAMANI S,Independent,356,0,356,0.18,Tamil Nadu-Oddanchatram
14,MARIMUTHU T.S,Independent,406,1,407,0.2,Tamil Nadu-Oddanchatram
15,NOTA,None of the Above,1451,6,1457,0.72,Tamil Nadu-Oddanchatram
1,N.V.THOMAS,Bahujan Samaj Party,804,8,812,0.33,Tamil Nadu-Omalur
2,R.MANI,All India Anna Dravida Munnetra Kazhagam,141527,961,142488,57.22,Tamil Nadu-Omalur
3,RANGARAJAN MOHAN KUMARAMANGALAM,Indian National Congress,85826,1368,87194,35.01,Tamil Nadu-Omalur
4,M.KARUNAKARAN,Tamil Nadu Ilangyar Katchi,1204,24,1228,0.49,Tamil Nadu-Omalur
5,V.SRINIVASAN,Makkal Needhi Maiam,2888,42,2930,1.18,Tamil Nadu-Omalur
6,S.DHIVYA,Dhesiya Makkal Kazhagam,277,4,281,0.11,Tamil Nadu-Omalur
7,K.K.MADHESWARAN,Amma Makkal Munnettra Kazagam,1188,14,1202,0.48,Tamil Nadu-Omalur
8,A.RAJA,Naam Tamilar Katchi,9341,75,9416,3.78,Tamil Nadu-Omalur
9,K.GOVINDARAJU,Independent,116,2,118,0.05,Tamil Nadu-Omalur
10,T.SURESH,Independent,104,0,104,0.04,Tamil Nadu-Omalur
11,E.MANI,Independent,104,7,111,0.04,Tamil Nadu-Omalur
12,S.MANI,Independent,144,5,149,0.06,Tamil Nadu-Omalur
13,R.MANI,Independent,282,2,284,0.11,Tamil Nadu-Omalur
14,R.MURUGAN,Independent,676,0,676,0.27,Tamil Nadu-Omalur
15,P.RAJA,Independent,433,1,434,0.17,Tamil Nadu-Omalur
16,NOTA,None of the Above,1581,19,1600,0.64,Tamil Nadu-Omalur
1,"RAMCHANDRAN, M.",Dravida Munnetra Kazhagam,60471,757,61228,31.92,Tamil Nadu-Orathanadu
2,"VAITHILINGAM, R.",All India Anna Dravida Munnetra Kazhagam,89516,547,90063,46.95,Tamil Nadu-Orathanadu
3,"STALIN, R.",Bahujan Samaj Party,550,0,550,0.29,Tamil Nadu-Orathanadu
4,"KANDHASAMY, M.",Naam Tamilar Katchi,9013,37,9050,4.72,Tamil Nadu-Orathanadu
5,"SEKAR, M.",Amma Makkal Munnettra Kazagam,25854,168,26022,13.56,Tamil Nadu-Orathanadu
6,"THANRAJ, R.",United States of India Party,229,0,229,0.12,Tamil Nadu-Orathanadu
7,"PRABAKARAN, U.",Anaithu Makkal Puratchi Katchi,99,0,99,0.05,Tamil Nadu-Orathanadu
8,"RENGASAMY, G.",Makkal Needhi Maiam,709,12,721,0.38,Tamil Nadu-Orathanadu
9,"ARUNKUMAR, K.",Independent,220,3,223,0.12,Tamil Nadu-Orathanadu
10,"MOOKKAIYAN, V.",Independent,2031,10,2041,1.06,Tamil Nadu-Orathanadu
11,"RENGARAJ, S.",Independent,317,2,319,0.17,Tamil Nadu-Orathanadu
12,"JAYASOORIYAN, T.",Independent,428,0,428,0.22,Tamil Nadu-Orathanadu
13,NOTA,None of the Above,861,6,867,0.45,Tamil Nadu-Orathanadu
1,ARUMUGANAINAR S,Desiya Murpokku Dravida Kazhagam,5276,51,5327,3,Tamil Nadu-Ottapidaram
2,SHUNMUGAIAH C,Dravida Munnetra Kazhagam,71605,1505,73110,41.11,Tamil Nadu-Ottapidaram
3,MOHAN P,All India Anna Dravida Munnetra Kazhagam,63907,693,64600,36.32,Tamil Nadu-Ottapidaram
4,ARUNADEVI R,Indiya Jananayaka Katchi,1890,23,1913,1.08,Tamil Nadu-Ottapidaram
5,Dr.K.KRISHNASAMY,Puthiya Tamilagam,6418,126,6544,3.68,Tamil Nadu-Ottapidaram
6,MAHARAJAN A,Bahujan Dravida Party,155,2,157,0.09,Tamil Nadu-Ottapidaram
7,MURUGAN P,Naam Indiar Party,517,3,520,0.29,Tamil Nadu-Ottapidaram
8,VAIKUNDAMARI M,Naam Tamilar Katchi,22104,309,22413,12.6,Tamil Nadu-Ottapidaram
9,ELAMBIRAI MANIMARAN P,Independent,148,4,152,0.09,Tamil Nadu-Ottapidaram
10,GANESHKUMAR M,Independent,83,1,84,0.05,Tamil Nadu-Ottapidaram
11,KARUPPARAJA,Independent,84,2,86,0.05,Tamil Nadu-Ottapidaram
12,GUNASEKARAN,Independent,97,3,100,0.06,Tamil Nadu-Ottapidaram
13,SASI MURUGAN C,Independent,133,0,133,0.07,Tamil Nadu-Ottapidaram
14,SAMUTHIRAM P,Independent,396,3,399,0.22,Tamil Nadu-Ottapidaram
15,M.A.DHARMAR,Independent,318,2,320,0.18,Tamil Nadu-Ottapidaram
16,RAJ V,Independent,315,1,316,0.18,Tamil Nadu-Ottapidaram
17,VELMURUGAN,Independent,98,0,98,0.06,Tamil Nadu-Ottapidaram
18,NOTA,None of the Above,1540,28,1568,0.88,Tamil Nadu-Ottapidaram
1,"Mano Thangaraj, T.",Dravida Munnetra Kazhagam,86193,1551,87744,51.57,Tamil Nadu-Padmanabhapuram
2,"Latha, P.",Bahujan Samaj Party,1253,19,1272,0.75,Tamil Nadu-Padmanabhapuram
3,"John Thankam, D.",All India Anna Dravida Munnetra Kazhagam,60100,759,60859,35.77,Tamil Nadu-Padmanabhapuram
4,Seelan,Naam Tamilar Katchi,13709,190,13899,8.17,Tamil Nadu-Padmanabhapuram
5,"Jenkins, D.",Amma Makkal Munnettra Kazagam,3192,42,3234,1.9,Tamil Nadu-Padmanabhapuram
6,"Jeyaraj, M.",Makkal Needhi Maiam,962,19,981,0.58,Tamil Nadu-Padmanabhapuram
7,"Anchalose, Y.",Independent,55,0,55,0.03,Tamil Nadu-Padmanabhapuram
8,"Glory Selvi, T.",Independent,262,9,271,0.16,Tamil Nadu-Padmanabhapuram
9,"SyedAli, A.",Independent,321,3,324,0.19,Tamil Nadu-Padmanabhapuram
10,"Nagarajan, M.",Independent,128,1,129,0.08,Tamil Nadu-Padmanabhapuram
11,"Mathan, F.",Independent,173,4,177,0.1,Tamil Nadu-Padmanabhapuram
12,"Robert Singh, I.",Independent,175,0,175,0.1,Tamil Nadu-Padmanabhapuram
13,NOTA,None of the Above,1023,13,1036,0.61,Tamil Nadu-Padmanabhapuram
1,HARI.R.,Bahujan Samaj Party,580,5,585,0.28,Tamil Nadu-Palacode
2,ANBALAGAN.K.P.,All India Anna Dravida Munnetra Kazhagam,109105,965,110070,53.28,Tamil Nadu-Palacode
3,MURUGAN.P.K.,Dravida Munnetra Kazhagam,81035,935,81970,39.68,Tamil Nadu-Palacode
4,VIJAYASANKAR.P.,Desiya Murpokku Dravida Kazhagam,2394,15,2409,1.17,Tamil Nadu-Palacode
5,KALAISELVI.G.,Naam Tamilar Katchi,7647,57,7704,3.73,Tamil Nadu-Palacode
6,RAJASEKAR.D.,Makkal Needhi Maiam,1168,8,1176,0.57,Tamil Nadu-Palacode
7,ANBARASU.D.,Independent,79,1,80,0.04,Tamil Nadu-Palacode
8,SHARAVANAN.M.P.,Independent,90,0,90,0.04,Tamil Nadu-Palacode
9,MURUGAN.K.,Independent,115,5,120,0.06,Tamil Nadu-Palacode
10,MURUGAN.K.G.,Independent,169,0,169,0.08,Tamil Nadu-Palacode
11,RAJKUMAR.T.,Independent,406,0,406,0.2,Tamil Nadu-Palacode
12,VADIVEL.M.,Independent,464,1,465,0.23,Tamil Nadu-Palacode
13,NOTA,None of the Above,1348,3,1351,0.65,Tamil Nadu-Palacode
1,SENTHIL KUMAR I.P,Dravida Munnetra Kazhagam,107049,1517,108566,52.86,Tamil Nadu-Palani
2,NACHIMUTHU S,Bahujan Samaj Party,442,1,443,0.22,Tamil Nadu-Palani
3,RAVI MANOHARAN K,All India Anna Dravida Munnetra Kazhagam,77951,559,78510,38.23,Tamil Nadu-Palani
4,SIVABALA MOORTHI K,Akhil Bharat Hindu Mahasabha,598,3,601,0.29,Tamil Nadu-Palani
5,THANGAVEL B,My India Party,76,1,77,0.04,Tamil Nadu-Palani
6,POOVENDHAN T,Makkal Needhi Maiam,3669,63,3732,1.82,Tamil Nadu-Palani
7,VINOTH RAJASEKARAN G,Naam Tamilar Katchi,7563,93,7656,3.73,Tamil Nadu-Palani
8,VEERAKUMAR V,Amma Makkal Munnettra Kazagam,2231,24,2255,1.1,Tamil Nadu-Palani
9,AZHAGUMALAI A,Independent,43,0,43,0.02,Tamil Nadu-Palani
10,ANANTHAN S. P,Independent,92,0,92,0.04,Tamil Nadu-Palani
11,KARUPPUSAMY P,Independent,37,1,38,0.02,Tamil Nadu-Palani
12,KALIAPPAN K,Independent,47,2,49,0.02,Tamil Nadu-Palani
13,SHAHUL HAMEED,Independent,147,2,149,0.07,Tamil Nadu-Palani
14,SAMIAPPA GOUNDER P,Independent,195,0,195,0.09,Tamil Nadu-Palani
15,SIDDIQ M,Independent,110,0,110,0.05,Tamil Nadu-Palani
16,SUDHA R B,Independent,520,2,522,0.25,Tamil Nadu-Palani
17,SURESH M,Independent,462,0,462,0.22,Tamil Nadu-Palani
18,THANGAVEL A,Independent,58,0,58,0.03,Tamil Nadu-Palani
19,NAGENDRAN G,Independent,308,2,310,0.15,Tamil Nadu-Palani
20,PANDEESWARAN M,Independent,68,0,68,0.03,Tamil Nadu-Palani
21,PERIYADURAI M,Independent,94,1,95,0.05,Tamil Nadu-Palani
22,MUNISHRAJA M,Independent,73,0,73,0.04,Tamil Nadu-Palani
23,RASULBEEVI SAHABUDEEN,Independent,64,0,64,0.03,Tamil Nadu-Palani
24,LATHIKA,Independent,105,1,106,0.05,Tamil Nadu-Palani
25,NOTA,None of the Above,1088,22,1110,0.54,Tamil Nadu-Palani
1,ABDUL WAHAB .M,Dravida Munnetra Kazhagam,86869,2248,89117,55.32,Tamil Nadu-Palayamkottai
2,GERALD .G,All India Anna Dravida Munnetra Kazhagam,36393,583,36976,22.95,Tamil Nadu-Palayamkottai
3,FATHIMA .A,Naam Tamilar Katchi,11515,150,11665,7.24,Tamil Nadu-Palayamkottai
4,PREMNATH. D,Makkal Needhi Maiam,8002,105,8107,5.03,Tamil Nadu-Palayamkottai
5,MOHAMED MUBARAK .V.M.S.,SOCIAL DEMOCRATIC PARTY OF INDIA,12126,115,12241,7.6,Tamil Nadu-Palayamkottai
6,RAJA .S,Veerath Thiyagi Viswanathadoss Thozhilalarkal Katchi,294,4,298,0.18,Tamil Nadu-Palayamkottai
7,VEERASUBRAMANIYAN .S,Aanaithinthiya Jananayaka Pathukappu Kazhagam,226,5,231,0.14,Tamil Nadu-Palayamkottai
8,SADAGOPAN .K,Independent,387,8,395,0.25,Tamil Nadu-Palayamkottai
9,LEO INFANT RAJ .M,Independent,195,7,202,0.13,Tamil Nadu-Palayamkottai
10,JOHN SAMUVEL JESUPATHAM .D,Independent,209,3,212,0.13,Tamil Nadu-Palayamkottai
11,NOTA,None of the Above,1620,27,1647,1.02,Tamil Nadu-Palayamkottai
1,ANNADURAI R,Bahujan Samaj Party,607,3,610,0.23,Tamil Nadu-Palladam
2,ANANDAN M S M,All India Anna Dravida Munnetra Kazhagam,126437,466,126903,48.53,Tamil Nadu-Palladam
3,MUTHURATHINAM K,Dravida Munnetra Kazhagam,93216,996,94212,36.03,Tamil Nadu-Palladam
4,ANTONY MARIARAJ A,Tamil Nadu Ilangyar Katchi,530,0,530,0.2,Tamil Nadu-Palladam
5,UMANATH R,United States of India Party,307,2,309,0.12,Tamil Nadu-Palladam
6,SIVAKUMAR G,Anna Puratchi Thalaivar Amma Dravida Munnetra Kazhagam,162,0,162,0.06,Tamil Nadu-Palladam
7,SUBRAMANIAN S,Naam Tamilar Katchi,20470,54,20524,7.85,Tamil Nadu-Palladam
8,THINAKARAN K,Anna Dravidar Kazhagam,130,0,130,0.05,Tamil Nadu-Palladam
9,MAYILSAMY G,Makkal Needhi Maiam,10195,32,10227,3.91,Tamil Nadu-Palladam
10,JOTHIMANI R,Amma Makkal Munnettra Kazagam,2606,12,2618,1,Tamil Nadu-Palladam
11,SHAHUL HAMEED M,Independent,86,0,86,0.03,Tamil Nadu-Palladam
12,SARATHA T,Independent,112,0,112,0.04,Tamil Nadu-Palladam
13,THANGARAJ A,Independent,212,3,215,0.08,Tamil Nadu-Palladam
14,THUYAMANI R,Independent,690,3,693,0.26,Tamil Nadu-Palladam
15,MARUTHASALAM V,Independent,365,0,365,0.14,Tamil Nadu-Palladam
16,MUTHURATHINAM M,Independent,720,2,722,0.28,Tamil Nadu-Palladam
17,MUTHURATHINAM L,Independent,171,0,171,0.07,Tamil Nadu-Palladam
18,MURUGESAN K,Independent,584,3,587,0.22,Tamil Nadu-Palladam
19,RAMESH V,Independent,314,1,315,0.12,Tamil Nadu-Palladam
20,VIJIYAKUMAR M,Independent,214,4,218,0.08,Tamil Nadu-Palladam
21,NOTA,None of the Above,1793,9,1802,0.69,Tamil Nadu-Palladam
1,RAJENDRAN,All India Anna Dravida Munnetra Kazhagam,88312,334,88646,33.3,Tamil Nadu-Pallavaram
2,KARUNANITHI,Dravida Munnetra Kazhagam,125705,722,126427,47.49,Tamil Nadu-Pallavaram
3,KARTHICK,Bahujan Samaj Party,519,0,519,0.19,Tamil Nadu-Pallavaram
4,MURUGESAN,Desiya Murpokku Dravida Kazhagam,3713,5,3718,1.4,Tamil Nadu-Pallavaram
5,AJITHKUMAR,Puthiya Tamilagam,200,2,202,0.08,Tamil Nadu-Pallavaram
6,KUMAR,Anna MGR Dravida Makkal Kalgam,58,1,59,0.02,Tamil Nadu-Pallavaram
7,GOKULKRISHNAN,Tamil Nadu Ilangyar Katchi,430,2,432,0.16,Tamil Nadu-Pallavaram
8,SASIKUMAR LAKSHMIPATHY,National Democratic Party of South India,84,1,85,0.03,Tamil Nadu-Pallavaram
9,SATHYASEELAN,Lok Jan Shakti Party,232,2,234,0.09,Tamil Nadu-Pallavaram
10,SENTHIL KUMAR,Makkal Needhi Maiam,20567,45,20612,7.74,Tamil Nadu-Pallavaram
11,SERMA SELVARAJ,Desiya Makkal Sakthi Katchi,525,0,525,0.2,Tamil Nadu-Pallavaram
12,MINISHREE KANAGARAJ,Naam Tamilar Katchi,21322,40,21362,8.02,Tamil Nadu-Pallavaram
13,VEERALAKSHMI,My India Party,171,0,171,0.06,Tamil Nadu-Pallavaram
14,SRIDHARAN,Dravida Murpokku Makkal Katchi,69,0,69,0.03,Tamil Nadu-Pallavaram
15,KANAGARAJ,Independent,133,0,133,0.05,Tamil Nadu-Pallavaram
16,KUMARA DOSS,Independent,274,0,274,0.1,Tamil Nadu-Pallavaram
17,SADAM HUSSAIN,Independent,266,1,267,0.1,Tamil Nadu-Pallavaram
18,BALAJI,Independent,166,1,167,0.06,Tamil Nadu-Pallavaram
19,BHASKARAN,Independent,40,1,41,0.02,Tamil Nadu-Pallavaram
20,PERUMAL,Independent,86,0,86,0.03,Tamil Nadu-Pallavaram
21,MICHAEL,Independent,124,0,124,0.05,Tamil Nadu-Pallavaram
22,RAMACHANDRAN.R,Independent,96,0,96,0.04,Tamil Nadu-Pallavaram
23,NOTA,None of the Above,1935,10,1945,0.73,Tamil Nadu-Pallavaram
1,RAJENDRAN.R,All India Anna Dravida Munnetra Kazhagam,88489,615,89104,45.22,Tamil Nadu-Panruti
2,SIVAKOZHUNDU.P,Desiya Murpokku Dravida Kazhagam,3357,5,3362,1.71,Tamil Nadu-Panruti
3,VELMURUGAN.T,Dravida Munnetra Kazhagam,92917,884,93801,47.6,Tamil Nadu-Panruti
4,SUBHASHINI.R,Naam Tamilar Katchi,6511,36,6547,3.32,Tamil Nadu-Panruti
5,JAYLANI,Makkal Needhi Maiam,1657,13,1670,0.85,Tamil Nadu-Panruti
6,ARULKUMAR.R,Independent,159,0,159,0.08,Tamil Nadu-Panruti
7,KAMADEVAN.S,Independent,69,0,69,0.04,Tamil Nadu-Panruti
8,KRISHNARAJ.S,Independent,67,1,68,0.03,Tamil Nadu-Panruti
9,KUMAR.D,Independent,45,3,48,0.02,Tamil Nadu-Panruti
10,GOVINDASAMY.S,Independent,42,0,42,0.02,Tamil Nadu-Panruti
11,SUMATHI.V,Independent,106,10,116,0.06,Tamil Nadu-Panruti
12,NAGAMANI.M,Independent,45,0,45,0.02,Tamil Nadu-Panruti
13,PRAKASH.R,Independent,125,0,125,0.06,Tamil Nadu-Panruti
14,VELMURUGAN.K,Independent,418,0,418,0.21,Tamil Nadu-Panruti
15,VELMURUGAN.R,Independent,152,0,152,0.08,Tamil Nadu-Panruti
16,NOTA,None of the Above,1320,3,1323,0.67,Tamil Nadu-Panruti
1,"GOPINATHAN, K.",All India Anna Dravida Munnetra Kazhagam,69809,485,70294,35.69,Tamil Nadu-Papanasam
2,"Dr.JAWAHIRULLAH, M.H.",Dravida Munnetra Kazhagam,85401,1166,86567,43.95,Tamil Nadu-Papanasam
3,"KRISHNAKUMAR, N.",Naam Tamilar Katchi,14645,79,14724,7.47,Tamil Nadu-Papanasam
4,"SHANTHA, K.",Makkal Needhi Maiam,2010,22,2032,1.03,Tamil Nadu-Papanasam
5,"MUTHUKUMAR, R.",Anaithu Makkal Puratchi Katchi,251,1,252,0.13,Tamil Nadu-Papanasam
6,"MEHRAJ BANU, N.",All India Jananayaka Makkal Kazhagam,166,3,169,0.09,Tamil Nadu-Papanasam
7,"RENGASAMY, M.",Amma Makkal Munnettra Kazagam,19593,185,19778,10.04,Tamil Nadu-Papanasam
8,"GOPI, N.",Independent,200,11,211,0.11,Tamil Nadu-Papanasam
9,"GOPINATHAN, R.",Independent,559,8,567,0.29,Tamil Nadu-Papanasam
10,"XAVIER, S.",Independent,159,4,163,0.08,Tamil Nadu-Papanasam
11,"THIYAGARAJAN, V.",Independent,130,2,132,0.07,Tamil Nadu-Papanasam
12,"RAJA, A.",Independent,474,3,477,0.24,Tamil Nadu-Papanasam
13,"RAJA, A.M.",Independent,411,1,412,0.21,Tamil Nadu-Papanasam
14,NOTA,None of the Above,1190,14,1204,0.61,Tamil Nadu-Papanasam
1,GOPI.K,Bahujan Samaj Party,623,2,625,0.28,Tamil Nadu-Pappireddipatti
2,GOVINDASAMY.A,All India Anna Dravida Munnetra Kazhagam,113397,1110,114507,51.81,Tamil Nadu-Pappireddipatti
3,PRABHURAJASEKAR.M,Dravida Munnetra Kazhagam,75831,1733,77564,35.1,Tamil Nadu-Pappireddipatti
4,SRINIVASAN,Makkal Needhi Maiam,1720,9,1729,0.78,Tamil Nadu-Pappireddipatti
5,PALANIAPPAN.P,Amma Makkal Munnettra Kazagam,15597,266,15863,7.18,Tamil Nadu-Pappireddipatti
6,MURUGAN.R,Anaithu Makkal Puratchi Katchi,149,1,150,0.07,Tamil Nadu-Pappireddipatti
7,RAMESH.R,Naam Tamilar Katchi,7490,83,7573,3.43,Tamil Nadu-Pappireddipatti
8,ANAND KUMAR.K,Independent,186,1,187,0.08,Tamil Nadu-Pappireddipatti
9,ELANGO.S,Independent,130,0,130,0.06,Tamil Nadu-Pappireddipatti
10,GOVINDASAMY.R,Independent,426,6,432,0.2,Tamil Nadu-Pappireddipatti
11,SELVAM.P,Independent,89,5,94,0.04,Tamil Nadu-Pappireddipatti
12,PALANIYAPPAN.R,Independent,120,2,122,0.06,Tamil Nadu-Pappireddipatti
13,MANIVANNAN.K,Independent,121,2,123,0.06,Tamil Nadu-Pappireddipatti
14,MURUGAN.S,Independent,299,1,300,0.14,Tamil Nadu-Pappireddipatti
15,VEERAMANI.T,Independent,257,0,257,0.12,Tamil Nadu-Pappireddipatti
16,NOTA,None of the Above,1330,8,1338,0.61,Tamil Nadu-Pappireddipatti
1,GOVINDAN V,Bahujan Samaj Party,416,9,425,0.23,Tamil Nadu-Paramakudi
2,SADHAN PRABHAKAR N,All India Anna Dravida Munnetra Kazhagam,70488,1091,71579,39.3,Tamil Nadu-Paramakudi
3,SELVI U,Desiya Murpokku Dravida Kazhagam,1988,21,2009,1.1,Tamil Nadu-Paramakudi
4,MURUGESAN S,Dravida Munnetra Kazhagam,83016,1848,84864,46.59,Tamil Nadu-Paramakudi
5,KARUPPU RAJA M,Makkal Needhi Maiam,3447,41,3488,1.91,Tamil Nadu-Paramakudi
6,SASIKALA S,Naam Tamilar Katchi,16262,168,16430,9.02,Tamil Nadu-Paramakudi
7,PARTHASARATHI M,My India Party,187,1,188,0.1,Tamil Nadu-Paramakudi
8,RAMAPANDI C,Independent,184,2,186,0.1,Tamil Nadu-Paramakudi
9,UDHAYAKUMAR M,Independent,208,0,208,0.11,Tamil Nadu-Paramakudi
10,UDAYAKUMAR,Independent,96,0,96,0.05,Tamil Nadu-Paramakudi
11,KUMAR S,Independent,78,1,79,0.04,Tamil Nadu-Paramakudi
12,BALAMURUGAN S,Independent,196,2,198,0.11,Tamil Nadu-Paramakudi
13,MURUKESAN K,Independent,684,3,687,0.38,Tamil Nadu-Paramakudi
14,RAVISANKAR V,Independent,109,0,109,0.06,Tamil Nadu-Paramakudi
15,RAJIV GANDHI K,Independent,350,4,354,0.19,Tamil Nadu-Paramakudi
16,NOTA,None of the Above,1242,16,1258,0.69,Tamil Nadu-Paramakudi
1,RAMAN V,Bahujan Samaj Party,495,0,495,0.27,Tamil Nadu-Paramathi-Velur
2,SEKAR S,All India Anna Dravida Munnetra Kazhagam,84593,1441,86034,46.83,Tamil Nadu-Paramathi-Velur
3,MOORTHIY K S,Dravida Munnetra Kazhagam,76062,2310,78372,42.66,Tamil Nadu-Paramathi-Velur
4,SAMINATHAN P P,Amma Makkal Munnettra Kazagam,1321,8,1329,0.72,Tamil Nadu-Paramathi-Velur
5,SUNDARAM S,United States of India Party,132,4,136,0.07,Tamil Nadu-Paramathi-Velur
6,NATARAJAN K,Makkal Needhi Maiam,1858,24,1882,1.02,Tamil Nadu-Paramathi-Velur
7,MANI K,Ganasangam Party of India,128,4,132,0.07,Tamil Nadu-Paramathi-Velur
8,UVARANI K,Naam Tamilar Katchi,11554,130,11684,6.36,Tamil Nadu-Paramathi-Velur
9,KARTHIKEYAN N,Independent,69,1,70,0.04,Tamil Nadu-Paramathi-Velur
10,KUZHANDAIVEL K,Independent,65,0,65,0.04,Tamil Nadu-Paramathi-Velur
11,SATHISKUMAR D,Independent,66,1,67,0.04,Tamil Nadu-Paramathi-Velur
12,SAMYNATHAN G,Independent,67,1,68,0.04,Tamil Nadu-Paramathi-Velur
13,SEERANGAN P,Independent,155,1,156,0.08,Tamil Nadu-Paramathi-Velur
14,SUNDARAM N,Independent,280,0,280,0.15,Tamil Nadu-Paramathi-Velur
15,SEKAR N,Independent,269,1,270,0.15,Tamil Nadu-Paramathi-Velur
16,SEKAR R,Independent,367,1,368,0.2,Tamil Nadu-Paramathi-Velur
17,THANGARASU M,Independent,177,1,178,0.1,Tamil Nadu-Paramathi-Velur
18,DEVANDRAN G,Independent,259,0,259,0.14,Tamil Nadu-Paramathi-Velur
19,NALLAPPAN K,Independent,219,0,219,0.12,Tamil Nadu-Paramathi-Velur
20,PAPATHI R,Independent,232,0,232,0.13,Tamil Nadu-Paramathi-Velur
21,PARTHASARATHY S,Independent,88,0,88,0.05,Tamil Nadu-Paramathi-Velur
22,BALASUBRAMANIAN A,Independent,21,0,21,0.01,Tamil Nadu-Paramathi-Velur
23,BALAJI R,Independent,33,2,35,0.02,Tamil Nadu-Paramathi-Velur
24,PRABHAHARAN M,Independent,41,1,42,0.02,Tamil Nadu-Paramathi-Velur
25,PERIASAMY R,Independent,52,0,52,0.03,Tamil Nadu-Paramathi-Velur
26,MOORTHY M,Independent,86,1,87,0.05,Tamil Nadu-Paramathi-Velur
27,JAYAKUMAR K,Independent,112,0,112,0.06,Tamil Nadu-Paramathi-Velur
28,NOTA,None of the Above,952,12,964,0.52,Tamil Nadu-Paramathi-Velur
1,"ANNADURAI, K.",Dravida Munnetra Kazhagam,78060,1005,79065,44.62,Tamil Nadu-Pattukkottai
2,"RENGARAJAN, N.R.",All India Anna Dravida Munnetra Kazhagam,53521,275,53796,30.36,Tamil Nadu-Pattukkottai
3,KEERTHIKA ANBU,Naam Tamilar Katchi,10694,36,10730,6.06,Tamil Nadu-Pattukkottai
4,"SADASIVAM, B.",Makkal Needhi Maiam,3070,18,3088,1.74,Tamil Nadu-Pattukkottai
5,"SUNDARRAJ, M.",Anaithu Makkal Puratchi Katchi,178,1,179,0.1,Tamil Nadu-Pattukkottai
6,"SELVAM, S.D.S.",Amma Makkal Munnettra Kazagam,5191,32,5223,2.95,Tamil Nadu-Pattukkottai
7,"MEIKKAPPAN, T.",Anna Dravidar Kazhagam,322,0,322,0.18,Tamil Nadu-Pattukkottai
8,"BALAKRISHNAN, V.",Independent,23704,67,23771,13.41,Tamil Nadu-Pattukkottai
9,NOTA,None of the Above,1019,7,1026,0.58,Tamil Nadu-Pattukkottai
1,INBASEKARAN. P.N.P,Dravida Munnetra Kazhagam,83765,1172,84937,40.39,Tamil Nadu-Pennagaram
2,UTHAYAKUMAR. R,Desiya Murpokku Dravida Kazhagam,2910,11,2921,1.39,Tamil Nadu-Pennagaram
3,MOORTHI. S,Bahujan Samaj Party,238,7,245,0.12,Tamil Nadu-Pennagaram
4,ANNADURAI. C,Desiya Makkal Sakthi Katchi,208,3,211,0.1,Tamil Nadu-Pennagaram
5,TAMILAZHAGAN. R,Naam Tamilar Katchi,8890,55,8945,4.25,Tamil Nadu-Pennagaram
6,MANI. G.K,Pattali Makkal Katchi,105250,873,106123,50.46,Tamil Nadu-Pennagaram
7,SHAKILA. K,Makkal Needhi Maiam,1451,20,1471,0.7,Tamil Nadu-Pennagaram
8,ANNADURAI. V,Independent,207,0,207,0.1,Tamil Nadu-Pennagaram
9,SIVALINGAM. N,Independent,139,3,142,0.07,Tamil Nadu-Pennagaram
10,DHARUMAN. K,Independent,242,1,243,0.12,Tamil Nadu-Pennagaram
11,THIRUMURUGAN. P,Independent,450,1,451,0.21,Tamil Nadu-Pennagaram
12,PERIYANANJAPPAN. A,Independent,1959,9,1968,0.94,Tamil Nadu-Pennagaram
13,MANI. K.G.,Independent,211,1,212,0.1,Tamil Nadu-Pennagaram
14,MANI. P,Independent,202,3,205,0.1,Tamil Nadu-Pennagaram
15,MUNUSAMY. S,Independent,263,2,265,0.13,Tamil Nadu-Pennagaram
16,NOTA,None of the Above,1754,5,1759,0.84,Tamil Nadu-Pennagaram
1,"RAJENDRAN, K.",Bahujan Samaj Party,519,1,520,0.22,Tamil Nadu-Perambalur
2,"GUNASEKARAN, A.",Nationalist Congress Party,405,4,409,0.17,Tamil Nadu-Perambalur
3,"THAMIZHSELVAN, R.",All India Anna Dravida Munnetra Kazhagam,90325,731,91056,37.94,Tamil Nadu-Perambalur
4,"PRABHAHARAN, M.",Dravida Munnetra Kazhagam,119636,2454,122090,50.87,Tamil Nadu-Perambalur
5,"RAJENDRAN, K.",Desiya Murpokku Dravida Kazhagam,2918,14,2932,1.22,Tamil Nadu-Perambalur
6,"SASIKALA, M.",Indiya Jananayaka Katchi,1073,7,1080,0.45,Tamil Nadu-Perambalur
7,"MAHESHWARI, M.",Naam Tamilar Katchi,18592,81,18673,7.78,Tamil Nadu-Perambalur
8,"RADHIKA, T.",Puthiya Tamilagam,994,9,1003,0.42,Tamil Nadu-Perambalur
9,"SATHISH, S.",Independent,379,0,379,0.16,Tamil Nadu-Perambalur
10,NOTA,None of the Above,1867,17,1884,0.78,Tamil Nadu-Perambalur
1,SURESH. C,Bahujan Samaj Party,515,0,515,0.26,Tamil Nadu-Perambur
2,SHEKAR. R.D,Dravida Munnetra Kazhagam,104580,687,105267,52.53,Tamil Nadu-Perambur
3,DHANAPALAN N.R,All India Anna Dravida Munnetra Kazhagam,50093,198,50291,25.1,Tamil Nadu-Perambur
4,SOOSAI. M.A,Republican Party of India (Athawale),296,0,296,0.15,Tamil Nadu-Perambur
5,SEBASTIN. J,SOCIALIST UNITY CENTRE OF INDIA (COMMUNIST),194,0,194,0.1,Tamil Nadu-Perambur
6,PONNUSAMY. A,Makkal Needhi Maiam,17026,46,17072,8.52,Tamil Nadu-Perambur
7,MERLIN SUGANTHI. S,Naam Tamilar Katchi,19787,34,19821,9.89,Tamil Nadu-Perambur
8,LAKSHMI NARAYANAN. E,Amma Makkal Munnettra Kazagam,4039,3,4042,2.02,Tamil Nadu-Perambur
9,UDAYAKUMAR. S,Independent,59,1,60,0.03,Tamil Nadu-Perambur
10,KADHIRAVAN. M,Independent,48,0,48,0.02,Tamil Nadu-Perambur
11,SATHISHKUMAR. S,Independent,106,0,106,0.05,Tamil Nadu-Perambur
12,SATHEESH. J,Independent,174,0,174,0.09,Tamil Nadu-Perambur
13,SARAVANA PERUMAL. R,Independent,65,0,65,0.03,Tamil Nadu-Perambur
14,SELVARAJ. R,Independent,86,1,87,0.04,Tamil Nadu-Perambur
15,SEKAR. P,Independent,166,0,166,0.08,Tamil Nadu-Perambur
16,PARTHIPAN. P,Independent,172,0,172,0.09,Tamil Nadu-Perambur
17,PREM ANAND. J,Independent,112,0,112,0.06,Tamil Nadu-Perambur
18,RAJESH. K,Independent,163,0,163,0.08,Tamil Nadu-Perambur
19,RAJESH KUMAR. S,Independent,90,0,90,0.04,Tamil Nadu-Perambur
20,VASANTHA KUMAR. M,Independent,40,0,40,0.02,Tamil Nadu-Perambur
21,VINOTHKUMAR. G,Independent,45,0,45,0.02,Tamil Nadu-Perambur
22,VENKATESH. L,Independent,46,0,46,0.02,Tamil Nadu-Perambur
23,NOTA,None of the Above,1508,7,1515,0.76,Tamil Nadu-Perambur
1,"ASHOKKUMAR, N.",Dravida Munnetra Kazhagam,88102,1028,89130,52.17,Tamil Nadu-Peravurani
2,"SIVAKUMAR, M.",Desiya Murpokku Dravida Kazhagam,1618,5,1623,0.95,Tamil Nadu-Peravurani
3,"THIRUGNANASAMBANDAM, S.V.",All India Anna Dravida Munnetra Kazhagam,65395,232,65627,38.41,Tamil Nadu-Peravurani
4,"DURAIRAJ, G.",Bahujan Samaj Party,493,1,494,0.29,Tamil Nadu-Peravurani
5,"DELIPAN, K.",Naam Tamilar Katchi,12109,45,12154,7.11,Tamil Nadu-Peravurani
6,"PACHAMUTHU, P.",Indiya Jananayaka Katchi,552,2,554,0.32,Tamil Nadu-Peravurani
7,"ELANGOVAN, G.",Independent,236,0,236,0.14,Tamil Nadu-Peravurani
8,"UTHAYAKUMAR, U.",Independent,260,2,262,0.15,Tamil Nadu-Peravurani
9,NOTA,None of the Above,768,2,770,0.45,Tamil Nadu-Peravurani
1,K.S.SARAVANAKUMAAR,Dravida Munnetra Kazhagam,90360,1891,92251,45.71,Tamil Nadu-Periyakulam
2,M Murugan,All India Anna Dravida Munnetra Kazhagam,70444,486,70930,35.15,Tamil Nadu-Periyakulam
3,Dr.K.Kathirkamu,Amma Makkal Munnettra Kazagam,16317,107,16424,8.14,Tamil Nadu-Periyakulam
4,S.Chinnamuthu,My India Party,299,2,301,0.15,Tamil Nadu-Periyakulam
5,S.PANDIYARAJAN,Makkal Needhi Maiam,5626,54,5680,2.81,Tamil Nadu-Periyakulam
6,A.Murugesan,SOCIALIST UNITY CENTRE OF INDIA (COMMUNIST),201,1,202,0.1,Tamil Nadu-Periyakulam
7,Vimala,Naam Tamilar Katchi,11660,134,11794,5.84,Tamil Nadu-Periyakulam
8,MADHU BHARATHI,Independent,622,6,628,0.31,Tamil Nadu-Periyakulam
9,C.MAYAZHAKU,Independent,56,1,57,0.03,Tamil Nadu-Periyakulam
10,MURUGAN,Independent,335,4,339,0.17,Tamil Nadu-Periyakulam
11,M.Muniyappan,Independent,94,0,94,0.05,Tamil Nadu-Periyakulam
12,M.Muneeswaran,Independent,143,0,143,0.07,Tamil Nadu-Periyakulam
13,"A.C.MOHAN RAJ B.P.T.,",Independent,148,1,149,0.07,Tamil Nadu-Periyakulam
14,P.RAMAIYA,Independent,112,0,112,0.06,Tamil Nadu-Periyakulam
15,M.RAJENDRAN,Independent,237,5,242,0.12,Tamil Nadu-Periyakulam
16,NOTA,None of the Above,2414,37,2451,1.21,Tamil Nadu-Periyakulam
1,"KULANDAIVEL, P. R.",Desiya Murpokku Dravida Kazhagam,857,1,858,0.45,Tamil Nadu-Perundurai
2,KKC BALU,Dravida Munnetra Kazhagam,69569,1049,70618,37.2,Tamil Nadu-Perundurai
3,"THAMBI, M.",Bahujan Samaj Party,1612,8,1620,0.85,Tamil Nadu-Perundurai
4,"JAYAKUMAR, S.",All India Anna Dravida Munnetra Kazhagam,84532,593,85125,44.84,Tamil Nadu-Perundurai
5,"DHAKSHINAMURTHI, K. S.",Desiya Makkal Sakthi Katchi,617,1,618,0.33,Tamil Nadu-Perundurai
6,"NANDHAKUMAR, C. K.",Makkal Needhi Maiam,3506,27,3533,1.86,Tamil Nadu-Perundurai
7,"PRABAKARAN, D.",All India Jananayaka Makkal Kazhagam,102,0,102,0.05,Tamil Nadu-Perundurai
8,"RAMESH, M.",Namathu Kongu Munnetra Kalagam,89,1,90,0.05,Tamil Nadu-Perundurai
9,"LOGANATHAN, C.",Naam Tamilar Katchi,10243,51,10294,5.42,Tamil Nadu-Perundurai
10,"VELUSAMY, P.",Anna Puratchi Thalaivar Amma Dravida Munnetra Kazhagam,107,0,107,0.06,Tamil Nadu-Perundurai
11,"KARTHI, M.",Independent,169,0,169,0.09,Tamil Nadu-Perundurai
12,"KRISHNAN, S.",Independent,79,0,79,0.04,Tamil Nadu-Perundurai
13,"GOPALAKRISHNAN, J.",Independent,182,0,182,0.1,Tamil Nadu-Perundurai
14,SHANKARSAMY,Independent,3328,8,3336,1.76,Tamil Nadu-Perundurai
15,"SATHISHKUMAR, N.",Independent,799,0,799,0.42,Tamil Nadu-Perundurai
16,"SAMPATH KUMAR, K.",Independent,245,0,245,0.13,Tamil Nadu-Perundurai
17,"DEVENDARAMANICKAM, S. R.",Independent,176,4,180,0.09,Tamil Nadu-Perundurai
18,THOPPU VENKATACHALAM (A) N.D .VENKATACHALAM,Independent,9815,80,9895,5.21,Tamil Nadu-Perundurai
19,"BALASUBRAMANI, V. M.",Independent,128,0,128,0.07,Tamil Nadu-Perundurai
20,"BALAMURUGAN, M.",Independent,129,0,129,0.07,Tamil Nadu-Perundurai
21,"MYILSAMY, M.",Independent,85,1,86,0.05,Tamil Nadu-Perundurai
22,"VENKATACHALAM, K.",Independent,59,1,60,0.03,Tamil Nadu-Perundurai
23,"VENKADACHALAM, P. R.",Independent,219,2,221,0.12,Tamil Nadu-Perundurai
24,"JEEVA, N.",Independent,74,0,74,0.04,Tamil Nadu-Perundurai
25,"JOTHIMURUGAN, P.",Independent,106,0,106,0.06,Tamil Nadu-Perundurai
26,NOTA,None of the Above,1179,10,1189,0.63,Tamil Nadu-Perundurai
1,"Aruchamy, C.M.",Bahujan Samaj Party,488,3,491,0.28,Tamil Nadu-Pollachi
2,Pollachi V. Jayaraman,All India Anna Dravida Munnetra Kazhagam,79906,661,80567,45.44,Tamil Nadu-Pollachi
3,"Dr. Varadharajan, K.",Dravida Munnetra Kazhagam,77882,960,78842,44.47,Tamil Nadu-Pollachi
4,"Sathieshkumar, V.T.",Makkal Needhi Maiam,7548,41,7589,4.28,Tamil Nadu-Pollachi
5,"Sugumar, K.",Amma Makkal Munnettra Kazagam,1135,6,1141,0.64,Tamil Nadu-Pollachi
6,"Logeswari, N.",Naam Tamilar Katchi,6375,27,6402,3.61,Tamil Nadu-Pollachi
7,"Shanthu Mohamed, A.",Independent,368,0,368,0.21,Tamil Nadu-Pollachi
8,"Muthukumarasamy, R.",Independent,361,1,362,0.2,Tamil Nadu-Pollachi
9,NOTA,None of the Above,1533,13,1546,0.87,Tamil Nadu-Pollachi
1,Ezhilarasu. M,Bahujan Samaj Party,600,4,604,0.3,Tamil Nadu-Polur
2,Agri KRISHNAMURTHY. S S,All India Anna Dravida Munnetra Kazhagam,96878,854,97732,48.38,Tamil Nadu-Polur
3,SEKARAN. K.V,Dravida Munnetra Kazhagam,86544,1463,88007,43.57,Tamil Nadu-Polur
4,KALAVATHI. G,Makkal Needhi Maiam,1561,19,1580,0.78,Tamil Nadu-Polur
5,LAVANYA. L,Naam Tamilar Katchi,10065,132,10197,5.05,Tamil Nadu-Polur
6,VIJAYAKUMAR. C,Amma Makkal Munnettra Kazagam,646,10,656,0.32,Tamil Nadu-Polur
7,GANESAN. C,Independent,55,0,55,0.03,Tamil Nadu-Polur
8,KALAIMANI. S,Independent,56,0,56,0.03,Tamil Nadu-Polur
9,KRISHNAMURTHI. K,Independent,50,0,50,0.02,Tamil Nadu-Polur
10,Shanmugasundaram. E,Independent,82,8,90,0.04,Tamil Nadu-Polur
11,SATHIYARAJ. P,Independent,77,10,87,0.04,Tamil Nadu-Polur
12,CHIDAMBARAM. V,Independent,71,1,72,0.04,Tamil Nadu-Polur
13,SIVA. A,Independent,216,0,216,0.11,Tamil Nadu-Polur
14,DAKSNAMOORTHY. R,Independent,1188,0,1188,0.59,Tamil Nadu-Polur
15,MURUGESAN. D,Independent,278,0,278,0.14,Tamil Nadu-Polur
16,NOTA,None of the Above,1131,13,1144,0.57,Tamil Nadu-Polur
1,DURAI. CHANDRASEKAR,Indian National Congress,93669,859,94528,44.94,Tamil Nadu-Ponneri
2,BALARAMAN. P,All India Anna Dravida Munnetra Kazhagam,84534,305,84839,40.33,Tamil Nadu-Ponneri
3,BHAVANI ILAVENIL. J,Bahujan Samaj Party,1102,4,1106,0.53,Tamil Nadu-Ponneri
4,DESINGURAJAN. D,Makkal Needhi Maiam,5372,22,5394,2.56,Tamil Nadu-Ponneri
5,MAHESWARI. A,Naam Tamilar Katchi,18973,54,19027,9.05,Tamil Nadu-Ponneri
6,PON. RAJA,Amma Makkal Munnettra Kazagam,2813,19,2832,1.35,Tamil Nadu-Ponneri
7,VIJAYAKUMAR. V,Anna MGR Dravida Makkal Kalgam,189,1,190,0.09,Tamil Nadu-Ponneri
8,ASHOK PRIYADARSHAN. S,Independent,470,0,470,0.22,Tamil Nadu-Ponneri
9,SAMBATH KUMAR.C.H,Independent,116,0,116,0.06,Tamil Nadu-Ponneri
10,SUGUMAR. K,Independent,298,0,298,0.14,Tamil Nadu-Ponneri
11,NOTA,None of the Above,1551,3,1554,0.74,Tamil Nadu-Ponneri
1,T. Ilanchezhian,Bahujan Samaj Party,496,4,500,0.24,Tamil Nadu-Poompuhar
2,S.Pavunraj,All India Anna Dravida Munnetra Kazhagam,92299,504,92803,44.65,Tamil Nadu-Poompuhar
3,Nivedha M. Murugan,Dravida Munnetra Kazhagam,95161,941,96102,46.24,Tamil Nadu-Poompuhar
4,P. Kaliyammal,Naam Tamilar Katchi,14783,40,14823,7.13,Tamil Nadu-Poompuhar
5,S.Senthamizhan,Amma Makkal Munnettra Kazagam,1212,8,1220,0.59,Tamil Nadu-Poompuhar
6,M.H.Meharajdeen,Makkal Needhi Maiam,946,4,950,0.46,Tamil Nadu-Poompuhar
7,A. Kalaivanan,Independent,102,0,102,0.05,Tamil Nadu-Poompuhar
8,S.Pandiyarajan,Independent,343,0,343,0.17,Tamil Nadu-Poompuhar
9,S.Murugan,Independent,261,1,262,0.13,Tamil Nadu-Poompuhar
10,NOTA,None of the Above,727,6,733,0.35,Tamil Nadu-Poompuhar
1,Krishnaswamy A,Dravida Munnetra Kazhagam,148383,1195,149578,56.72,Tamil Nadu-Poonamallee
2,Sathyamurthy A C,Bahujan Samaj Party,2880,11,2891,1.1,Tamil Nadu-Poonamallee
3,Rajamannar S X,Pattali Makkal Katchi,55249,219,55468,21.03,Tamil Nadu-Poonamallee
4,Elumalai T.A.,Amma Makkal Munnettra Kazagam,8771,34,8805,3.34,Tamil Nadu-Poonamallee
5,Boshya Gayathri M,My India Party,288,2,290,0.11,Tamil Nadu-Poonamallee
6,Manimekalai A,Naam Tamilar Katchi,29804,67,29871,11.33,Tamil Nadu-Poonamallee
7,Revathi Manimegalai J,Makkal Needhi Maiam,11877,50,11927,4.52,Tamil Nadu-Poonamallee
8,Sivakumar S,Independent,403,0,403,0.15,Tamil Nadu-Poonamallee
9,Dhasarathan R,Independent,173,0,173,0.07,Tamil Nadu-Poonamallee
10,Purushothaman B,Independent,173,2,175,0.07,Tamil Nadu-Poonamallee
11,Ravikumar M,Independent,448,0,448,0.17,Tamil Nadu-Poonamallee
12,Rajesh P,Independent,241,0,241,0.09,Tamil Nadu-Poonamallee
13,Venkatesan J,Independent,240,0,240,0.09,Tamil Nadu-Poonamallee
14,Velu S,Independent,359,0,359,0.14,Tamil Nadu-Poonamallee
15,NOTA,None of the Above,2849,18,2867,1.09,Tamil Nadu-Poonamallee
1,KARTHIK THONDAIMAN,All India Anna Dravida Munnetra Kazhagam,72247,554,72801,40.47,Tamil Nadu-Pudukkottai
2,M . SUBRAMANIAN,Desiya Murpokku Dravida Kazhagam,1857,16,1873,1.04,Tamil Nadu-Pudukkottai
3,V . MUTHURAJA,Dravida Munnetra Kazhagam,83792,2010,85802,47.7,Tamil Nadu-Pudukkottai
4,VENGADESHWARAN,Bahujan Samaj Party,456,7,463,0.26,Tamil Nadu-Pudukkottai
5,KUMAR,My India Party,95,0,95,0.05,Tamil Nadu-Pudukkottai
6,SASIKUMAR,Naam Tamilar Katchi,11411,92,11503,6.39,Tamil Nadu-Pudukkottai
7,M. SARAVANA DEVA,Namadhu Makkal Katchi,416,8,424,0.24,Tamil Nadu-Pudukkottai
8,S . MOORTHY,Makkal Needhi Maiam,3920,28,3948,2.19,Tamil Nadu-Pudukkottai
9,I . ABDULLAH,Independent,41,0,41,0.02,Tamil Nadu-Pudukkottai
10,KARUPPAIAH . C,Independent,103,1,104,0.06,Tamil Nadu-Pudukkottai
11,S . KARTHIKEYAN,Independent,58,0,58,0.03,Tamil Nadu-Pudukkottai
12,KARTHIKEYAN,Independent,388,5,393,0.22,Tamil Nadu-Pudukkottai
13,S . SAHUL AMEEDU,Independent,88,1,89,0.05,Tamil Nadu-Pudukkottai
14,S . SOUNDAR RAJA,Independent,204,1,205,0.11,Tamil Nadu-Pudukkottai
15,K . DHANAGOPAL,Independent,180,0,180,0.1,Tamil Nadu-Pudukkottai
16,DURAI GUNA,Independent,475,1,476,0.26,Tamil Nadu-Pudukkottai
17,V. N. MUTHUKUMAR,Independent,380,0,380,0.21,Tamil Nadu-Pudukkottai
18,M . RAJINIKANTH,Independent,90,0,90,0.05,Tamil Nadu-Pudukkottai
19,A. RAJASEKAR,Independent,250,0,250,0.14,Tamil Nadu-Pudukkottai
20,P. VIJAYAKUMAR,Independent,71,0,71,0.04,Tamil Nadu-Pudukkottai
21,N. VEERIAH,Independent,42,0,42,0.02,Tamil Nadu-Pudukkottai
22,NOTA,None of the Above,596,8,604,0.34,Tamil Nadu-Pudukkottai
1,M.Appavu,Dravida Munnetra Kazhagam,80241,2090,82331,43.95,Tamil Nadu-Radhapuram
2,E.Esakkiammal,Bahujan Samaj Party,460,4,464,0.25,Tamil Nadu-Radhapuram
3,I.S.Inbadurai,All India Anna Dravida Munnetra Kazhagam,75749,657,76406,40.79,Tamil Nadu-Radhapuram
4,K.Jeyabalan,Desiya Murpokku Dravida Kazhagam,2409,23,2432,1.3,Tamil Nadu-Radhapuram
5,N.Godfrey Washington Noble,Aanaithinthiya Jananayaka Pathukappu Kazhagam,235,0,235,0.13,Tamil Nadu-Radhapuram
6,M.Chandran,Veerath Thiyagi Viswanathadoss Thozhilalarkal Katchi,291,4,295,0.16,Tamil Nadu-Radhapuram
7,J.Jesu Rajendran,Naam Indiar Party,328,1,329,0.18,Tamil Nadu-Radhapuram
8,R.Jesu Dhasan,Naam Tamilar Katchi,19271,100,19371,10.34,Tamil Nadu-Radhapuram
9,M.Antony Rossary,Independent,98,0,98,0.05,Tamil Nadu-Radhapuram
10,S.Abinanth Ram,Independent,68,1,69,0.04,Tamil Nadu-Radhapuram
11,D.Arunraj,Independent,139,0,139,0.07,Tamil Nadu-Radhapuram
12,S.Katteri Perumal,Independent,59,0,59,0.03,Tamil Nadu-Radhapuram
13,N.Kannan,Independent,191,2,193,0.1,Tamil Nadu-Radhapuram
14,A.Kumar,Independent,309,9,318,0.17,Tamil Nadu-Radhapuram
15,M.Saswathan,Independent,116,1,117,0.06,Tamil Nadu-Radhapuram
16,R.Sudalaimani,Independent,466,4,470,0.25,Tamil Nadu-Radhapuram
17,K.Subburaj,Independent,518,0,518,0.28,Tamil Nadu-Radhapuram
18,D.Sheik Syed Ali,Independent,95,0,95,0.05,Tamil Nadu-Radhapuram
19,T.Sermadurai,Independent,455,1,456,0.24,Tamil Nadu-Radhapuram
20,G.Deva Peran,Independent,1221,3,1224,0.65,Tamil Nadu-Radhapuram
21,S.Manikandan,Independent,52,0,52,0.03,Tamil Nadu-Radhapuram
22,T.Muthu Selvi,Independent,308,2,310,0.17,Tamil Nadu-Radhapuram
23,T.Rethina Pandi,Independent,59,0,59,0.03,Tamil Nadu-Radhapuram
24,M.Vijayakumar,Independent,143,0,143,0.08,Tamil Nadu-Radhapuram
25,T.Venus Veera Arasu,Independent,222,2,224,0.12,Tamil Nadu-Radhapuram
26,NOTA,None of the Above,894,9,903,0.48,Tamil Nadu-Radhapuram
1,THANGAPANDIAN S.,Dravida Munnetra Kazhagam,72712,1446,74158,41.5,Tamil Nadu-Rajapalayam
2,RAJENTHRABHALAJI K.T,All India Anna Dravida Munnetra Kazhagam,69870,390,70260,39.32,Tamil Nadu-Rajapalayam
3,AYYAR V.K.,Puthiya Tamilagam,3348,40,3388,1.9,Tamil Nadu-Rajapalayam
4,KALIMUTHU K.,Amma Makkal Munnettra Kazagam,7607,53,7660,4.29,Tamil Nadu-Rajapalayam
5,DHARMALINGAM K.,Republican Party of India (Athawale),106,3,109,0.06,Tamil Nadu-Rajapalayam
6,VIVEKANANTHAN S.,Makkal Needhi Maiam,4023,36,4059,2.27,Tamil Nadu-Rajapalayam
7,JEYARAJ V.,Naam Tamilar Katchi,15448,145,15593,8.73,Tamil Nadu-Rajapalayam
8,KALIMUTHU K.,Independent,120,0,120,0.07,Tamil Nadu-Rajapalayam
9,SELVARAJ G.,Independent,84,2,86,0.05,Tamil Nadu-Rajapalayam
10,THANGAPANDI B.,Independent,111,1,112,0.06,Tamil Nadu-Rajapalayam
11,THANGAPANDI S.,Independent,261,3,264,0.15,Tamil Nadu-Rajapalayam
12,MANIKUMAR M.,Independent,546,2,548,0.31,Tamil Nadu-Rajapalayam
13,VIJAYAKUMAR E.,Independent,140,0,140,0.08,Tamil Nadu-Rajapalayam
14,JEYAPRAKASH I.,Independent,335,1,336,0.19,Tamil Nadu-Rajapalayam
15,NOTA,None of the Above,1869,6,1875,1.05,Tamil Nadu-Rajapalayam
1,ALLAPICHAI,Bahujan Samaj Party,634,2,636,0.3,Tamil Nadu-Ramanathapuram
2,KATHARBATCHA MUTHURAMALINGAM,Dravida Munnetra Kazhagam,109712,1370,111082,51.88,Tamil Nadu-Ramanathapuram
3,D.KUPPURAMU,Bharatiya Janata Party,60262,341,60603,28.31,Tamil Nadu-Ramanathapuram
4,AMUTHAN,Namadhu Makkal Katchi,382,1,383,0.18,Tamil Nadu-Ramanathapuram
5,K.ILANGO,Naam Tamilar Katchi,16960,86,17046,7.96,Tamil Nadu-Ramanathapuram
6,K.P SARAVANAN,Makkal Needhi Maiam,1962,23,1985,0.93,Tamil Nadu-Ramanathapuram
7,G.MUNIYASAMY,Amma Makkal Munnettra Kazagam,6710,50,6760,3.16,Tamil Nadu-Ramanathapuram
8,R.S.WILHELM BENJAMIN ANAND,Bahujan Dravida Party,77,1,78,0.04,Tamil Nadu-Ramanathapuram
9,V.JAYAPRAKASH,My India Party,133,0,133,0.06,Tamil Nadu-Ramanathapuram
10,ASANALI,Independent,77,1,78,0.04,Tamil Nadu-Ramanathapuram
11,K.KURUNTHAPPAN,Independent,245,1,246,0.11,Tamil Nadu-Ramanathapuram
12,SALEEM,Independent,125,3,128,0.06,Tamil Nadu-Ramanathapuram
13,S.SURESH,Independent,190,0,190,0.09,Tamil Nadu-Ramanathapuram
14,SURYAPRAKASH,Independent,1000,2,1002,0.47,Tamil Nadu-Ramanathapuram
15,P.MALAICHAMY,Independent,10808,14,10822,5.05,Tamil Nadu-Ramanathapuram
16,MISRA G,Independent,493,2,495,0.23,Tamil Nadu-Ramanathapuram
17,N MUNIYASAMI,Independent,119,0,119,0.06,Tamil Nadu-Ramanathapuram
18,E VINOTH,Independent,1216,0,1216,0.57,Tamil Nadu-Ramanathapuram
19,B VIJAYAPRAKASH,Independent,343,0,343,0.16,Tamil Nadu-Ramanathapuram
20,NOTA,None of the Above,747,6,753,0.35,Tamil Nadu-Ramanathapuram
1,R.GANDHI,Dravida Munnetra Kazhagam,102273,1018,103291,49.79,Tamil Nadu-Ranipet
2,S.M.SUGUMAR,All India Anna Dravida Munnetra Kazhagam,86339,454,86793,41.84,Tamil Nadu-Ranipet
3,A.YUVARAJ,Bahujan Samaj Party,664,5,669,0.32,Tamil Nadu-Ranipet
4,M.ATHAM BASHA,Makkal Needhi Maiam,2746,16,2762,1.33,Tamil Nadu-Ranipet
5,Dr.K.SATHIYARAJ,Tamil Nadu Ilangyar Katchi,273,2,275,0.13,Tamil Nadu-Ranipet
6,V.SHYLAJA,Naam Tamilar Katchi,10152,82,10234,4.93,Tamil Nadu-Ranipet
7,G.VEERAMANI,Amma Makkal Munnettra Kazagam,627,10,637,0.31,Tamil Nadu-Ranipet
8,S.GANDHI,Independent,63,1,64,0.03,Tamil Nadu-Ranipet
9,K.SAKTHIVEL NATHAN,Independent,48,0,48,0.02,Tamil Nadu-Ranipet
10,N.SUGUMAR,Independent,63,0,63,0.03,Tamil Nadu-Ranipet
11,A.MANIKANDAN,Independent,267,1,268,0.13,Tamil Nadu-Ranipet
12,A.MANSUR BASHA,Independent,194,0,194,0.09,Tamil Nadu-Ranipet
13,S.YUVARAJ,Independent,106,1,107,0.05,Tamil Nadu-Ranipet
14,S.JAYAKUMAR,Independent,425,0,425,0.2,Tamil Nadu-Ranipet
15,NOTA,None of the Above,1625,7,1632,0.79,Tamil Nadu-Ranipet
1,SAROJA V. Dr,All India Anna Dravida Munnetra Kazhagam,87851,924,88775,45.09,Tamil Nadu-Rasipuram
2,MATHIVENTHAN M,Dravida Munnetra Kazhagam,88612,2115,90727,46.08,Tamil Nadu-Rasipuram
3,VIJAYA K,Bahujan Samaj Party,346,5,351,0.18,Tamil Nadu-Rasipuram
4,ARULMOZHIDEVAN P,Tamilaga Makkal Thannurimai Katchi,216,1,217,0.11,Tamil Nadu-Rasipuram
5,ANBALAGAN S,Amma Makkal Munnettra Kazagam,1042,9,1051,0.53,Tamil Nadu-Rasipuram
6,RAMKUMAR R,Indiya Jananayaka Katchi,1119,14,1133,0.58,Tamil Nadu-Rasipuram
7,SILAMBARASI K,Naam Tamilar Katchi,11140,155,11295,5.74,Tamil Nadu-Rasipuram
8,CHINNUSAMY P,Ganasangam Party of India,146,1,147,0.07,Tamil Nadu-Rasipuram
9,JAYANTHI M,Ambedkarite Party of India,140,2,142,0.07,Tamil Nadu-Rasipuram
10,SEERANGAN P,Independent,62,1,63,0.03,Tamil Nadu-Rasipuram
11,PALANIVEL S,Independent,150,1,151,0.08,Tamil Nadu-Rasipuram
12,POONGODI S,Independent,88,0,88,0.04,Tamil Nadu-Rasipuram
13,MANIVANNAN A,Independent,81,0,81,0.04,Tamil Nadu-Rasipuram
14,MADHIYAZHAGAN D,Independent,123,0,123,0.06,Tamil Nadu-Rasipuram
15,MUNIYAPPAN M,Independent,449,1,450,0.23,Tamil Nadu-Rasipuram
16,NOTA,None of the Above,2088,22,2110,1.07,Tamil Nadu-Rasipuram
1,KARTHIKEYAN K,Dravida Munnetra Kazhagam,112998,914,113912,52.96,Tamil Nadu-Rishivandiyam
2,SANTHOSH S A,All India Anna Dravida Munnetra Kazhagam,71921,263,72184,33.56,Tamil Nadu-Rishivandiyam
3,VEERAN S,Bahujan Samaj Party,424,2,426,0.2,Tamil Nadu-Rishivandiyam
4,SHANMUGASUNDARAM K,Makkal Needhi Maiam,637,3,640,0.3,Tamil Nadu-Rishivandiyam
5,SURESH MANIVANNAN R,Naam Tamilar Katchi,12041,25,12066,5.61,Tamil Nadu-Rishivandiyam
6,TAMILVANAN M,My India Party,150,1,151,0.07,Tamil Nadu-Rishivandiyam
7,NARAYANAN A,Anna MGR Dravida Makkal Kalgam,141,1,142,0.07,Tamil Nadu-Rishivandiyam
8,PRABHU S,Amma Makkal Munnettra Kazagam,10367,20,10387,4.83,Tamil Nadu-Rishivandiyam
9,RADHAKRISHNAN K,Makkal Munnetra Peravai,127,2,129,0.06,Tamil Nadu-Rishivandiyam
10,VENKATRAMAN J,Naadaalum Makkal Katchi,149,0,149,0.07,Tamil Nadu-Rishivandiyam
11,KARTHIK G,Independent,129,0,129,0.06,Tamil Nadu-Rishivandiyam
12,GURU K,Independent,267,1,268,0.12,Tamil Nadu-Rishivandiyam
13,CHANDRASEKARAN V,Independent,287,0,287,0.13,Tamil Nadu-Rishivandiyam
14,SANTHOSH M,Independent,308,0,308,0.14,Tamil Nadu-Rishivandiyam
15,MURUGAN K,Independent,1508,0,1508,0.7,Tamil Nadu-Rishivandiyam
16,NOTA,None of the Above,2419,1,2420,1.13,Tamil Nadu-Rishivandiyam
1,KUMAR.S,Bahujan Samaj Party,180,0,180,0.15,Tamil Nadu-Royapuram
2,MURTHY.R.IDREAM,Dravida Munnetra Kazhagam,64095,329,64424,53.16,Tamil Nadu-Royapuram
3,JAYAKUMAR.D,All India Anna Dravida Munnetra Kazhagam,36458,187,36645,30.24,Tamil Nadu-Royapuram
4,KAMALI.S,Naam Tamilar Katchi,7923,30,7953,6.56,Tamil Nadu-Royapuram
5,GUNASEKARAN.S,Makkal Needhi Maiam,8139,27,8166,6.74,Tamil Nadu-Royapuram
6,MOHAN.A,Tipu Sultan Party,172,0,172,0.14,Tamil Nadu-Royapuram
7,RAMAJAYAM.C,Amma Makkal Munnettra Kazagam,1124,4,1128,0.93,Tamil Nadu-Royapuram
8,JAMES MARTIN.M,Tamil Nadu Ilangyar Katchi,554,3,557,0.46,Tamil Nadu-Royapuram
9,KARUNAKARAN.H,Independent,26,0,26,0.02,Tamil Nadu-Royapuram
10,KARTHICK.V,Independent,21,0,21,0.02,Tamil Nadu-Royapuram
11,KALIDASS.K.R,Independent,27,0,27,0.02,Tamil Nadu-Royapuram
12,GOKUL.G,Independent,52,0,52,0.04,Tamil Nadu-Royapuram
13,SATHISH.S,Independent,30,0,30,0.02,Tamil Nadu-Royapuram
14,SUGANTHAN.T,Independent,205,0,205,0.17,Tamil Nadu-Royapuram
15,SUNDARAPANDIAN.R,Independent,60,0,60,0.05,Tamil Nadu-Royapuram
16,SUBRAMANI.S.N,Independent,85,0,85,0.07,Tamil Nadu-Royapuram
17,CHELLAPPPAN.T,Independent,50,0,50,0.04,Tamil Nadu-Royapuram
18,SELVAKUMAR.J,Independent,133,0,133,0.11,Tamil Nadu-Royapuram
19,DHANASEKARAN.G,Independent,109,0,109,0.09,Tamil Nadu-Royapuram
20,DINAKARAN.S,Independent,56,0,56,0.05,Tamil Nadu-Royapuram
21,PRASATH.K,Independent,58,0,58,0.05,Tamil Nadu-Royapuram
22,PRABHAKARAN.V,Independent,55,0,55,0.05,Tamil Nadu-Royapuram
23,PRABHU.D,Independent,18,0,18,0.01,Tamil Nadu-Royapuram
24,MURTHY.T.C.S,Independent,42,1,43,0.04,Tamil Nadu-Royapuram
25,VINDHAN.A,Independent,10,0,10,0.01,Tamil Nadu-Royapuram
26,VELU.G,Independent,27,0,27,0.02,Tamil Nadu-Royapuram
27,NOTA,None of the Above,896,5,901,0.74,Tamil Nadu-Royapuram
1,KOTTUR KUMAR. R,Bahujan Samaj Party,274,0,274,0.17,Tamil Nadu-Saidapet
2,SUBRAMANIAN. MA,Dravida Munnetra Kazhagam,79715,479,80194,50.02,Tamil Nadu-Saidapet
3,SAIDAI DURAISAMY,All India Anna Dravida Munnetra Kazhagam,50633,153,50786,31.68,Tamil Nadu-Saidapet
4,SAGAYAMARY. N,Republican Party of India (Athawale),208,1,209,0.13,Tamil Nadu-Saidapet
5,SIVAGNANASAMBANDAN. T,Desiya Makkal Sakthi Katchi,87,2,89,0.06,Tamil Nadu-Saidapet
6,SNEGAPRIYA,Makkal Needhi Maiam,13413,41,13454,8.39,Tamil Nadu-Saidapet
7,SURESH KUMAR. B,Naam Tamilar Katchi,10687,30,10717,6.68,Tamil Nadu-Saidapet
8,SENTHAMIZHAN. G,Amma Makkal Munnettra Kazagam,2076,5,2081,1.3,Tamil Nadu-Saidapet
9,ASHOK KUMAR. V,Independent,38,0,38,0.02,Tamil Nadu-Saidapet
10,ARUN KUMAR. M,Independent,30,0,30,0.02,Tamil Nadu-Saidapet
11,ALAGANATHAN. B,Independent,18,0,18,0.01,Tamil Nadu-Saidapet
12,IMRAN KHAN. M,Independent,47,0,47,0.03,Tamil Nadu-Saidapet
13,ELANGO. K,Independent,22,1,23,0.01,Tamil Nadu-Saidapet
14,KANDHASAMY. R,Independent,141,0,141,0.09,Tamil Nadu-Saidapet
15,KOTHANDAPANI. K,Independent,48,0,48,0.03,Tamil Nadu-Saidapet
16,SATHISH KUMAR. S,Independent,121,0,121,0.08,Tamil Nadu-Saidapet
17,SARAVANAN. D,Independent,91,0,91,0.06,Tamil Nadu-Saidapet
18,SIVASANKAR. S. R,Independent,182,0,182,0.11,Tamil Nadu-Saidapet
19,BALAJI. V,Independent,145,0,145,0.09,Tamil Nadu-Saidapet
20,PRAKASH. C,Independent,20,0,20,0.01,Tamil Nadu-Saidapet
21,PREM KUMAR. A,Independent,40,0,40,0.02,Tamil Nadu-Saidapet
22,MANIMARAN. S,Independent,43,0,43,0.03,Tamil Nadu-Saidapet
23,MURTHI. R,Independent,125,0,125,0.08,Tamil Nadu-Saidapet
24,RAJESH. N,Independent,23,0,23,0.01,Tamil Nadu-Saidapet
25,RISHI KUMAR. A,Independent,31,0,31,0.02,Tamil Nadu-Saidapet
26,LOGANATHAN. J,Independent,34,0,34,0.02,Tamil Nadu-Saidapet
27,VASANTH. H,Independent,30,0,30,0.02,Tamil Nadu-Saidapet
28,VIJAYA KUMAR. R,Independent,37,0,37,0.02,Tamil Nadu-Saidapet
29,VENKATESH. K,Independent,32,0,32,0.02,Tamil Nadu-Saidapet
30,JOTHI SAIRAM. S,Independent,66,0,66,0.04,Tamil Nadu-Saidapet
31,NOTA,None of the Above,1155,3,1158,0.72,Tamil Nadu-Saidapet
1,R. RAJENDRAN,Dravida Munnetra Kazhagam,91222,2210,93432,46.17,Tamil Nadu-Salem (North)
2,M.P.PANNEER SELVAM,National People's Party,338,7,345,0.17,Tamil Nadu-Salem (North)
3,G.VENKATACHALAM,All India Anna Dravida Munnetra Kazhagam,85026,818,85844,42.42,Tamil Nadu-Salem (North)
4,S VELAN,Bahujan Samaj Party,299,1,300,0.15,Tamil Nadu-Salem (North)
5,M AHAMEDSHAHJAHAN,MGR Makkal Katchi,95,1,96,0.05,Tamil Nadu-Salem (North)
6,IMAYAESWARAN N,Naam Tamilar Katchi,8079,76,8155,4.03,Tamil Nadu-Salem (North)
7,R S GURU CHAKRAVARTHY,Makkal Needhi Maiam,10610,108,10718,5.3,Tamil Nadu-Salem (North)
8,C NATARAJAN,Amma Makkal Munnettra Kazagam,800,5,805,0.4,Tamil Nadu-Salem (North)
9,S. BABU,My India Party,39,0,39,0.02,Tamil Nadu-Salem (North)
10,D.MURALI,Dhesiya Makkal Kazhagam,24,1,25,0.01,Tamil Nadu-Salem (North)
11,VAATHIAR C MURUGAN,Ambedkarite Party of India,54,1,55,0.03,Tamil Nadu-Salem (North)
12,M.SHANMUGA SUNDARAM,Independent,69,4,73,0.04,Tamil Nadu-Salem (North)
13,R SENTHILKUMAR,Independent,62,1,63,0.03,Tamil Nadu-Salem (North)
14,N DEVARAJ,Independent,165,2,167,0.08,Tamil Nadu-Salem (North)
15,M.R.NAWAZUDIEEN,Independent,50,0,50,0.02,Tamil Nadu-Salem (North)
16,R PALANISAMY,Independent,208,0,208,0.1,Tamil Nadu-Salem (North)
17,A RAMESHKUMAR,Independent,213,0,213,0.11,Tamil Nadu-Salem (North)
18,P.RAMACHANDRAN,Independent,27,0,27,0.01,Tamil Nadu-Salem (North)
19,S RAJASEKAR,Independent,177,0,177,0.09,Tamil Nadu-Salem (North)
20,T.VIJAYA RAJ,Independent,44,1,45,0.02,Tamil Nadu-Salem (North)
21,NOTA,None of the Above,1505,34,1539,0.76,Tamil Nadu-Salem (North)
1,A.S.SARAVANAN,Dravida Munnetra Kazhagam,73694,1203,74897,37.45,Tamil Nadu-Salem (South)
2,E.BALASUBRAMANIAN,All India Anna Dravida Munnetra Kazhagam,96787,719,97506,48.76,Tamil Nadu-Salem (South)
3,S.MURALI,Bahujan Samaj Party,397,3,400,0.2,Tamil Nadu-Salem (South)
4,R.ELAVARASAN,Veerath Thiyagi Viswanathadoss Thozhilalarkal Katchi,74,1,75,0.04,Tamil Nadu-Salem (South)
5,SATHIYAPRIYA,Republican Party of India (Athawale),78,1,79,0.04,Tamil Nadu-Salem (South)
6,M.SUNDAR,Ambedkarite Party of India,86,1,87,0.04,Tamil Nadu-Salem (South)
7,M.PRABU MANIKANDAN,Makkal Needhi Maiam,10308,60,10368,5.18,Tamil Nadu-Salem (South)
8,S.MARIAMMA,Naam Tamilar Katchi,10128,48,10176,5.09,Tamil Nadu-Salem (South)
9,S.RAJI,Dhesiya Makkal Kazhagam,60,1,61,0.03,Tamil Nadu-Salem (South)
10,SE.VENKATAJALAM,Amma Makkal Munnettra Kazagam,2952,18,2970,1.49,Tamil Nadu-Salem (South)
11,R.VELMURUGAN,Communist Party of India  (Marxist-Leninist)  (Liberation),130,3,133,0.07,Tamil Nadu-Salem (South)
12,S.KRISHNAKUMAR,Independent,45,1,46,0.02,Tamil Nadu-Salem (South)
13,M.KUMAR,Independent,61,1,62,0.03,Tamil Nadu-Salem (South)
14,S.SARAVANAN,Independent,61,2,63,0.03,Tamil Nadu-Salem (South)
15,SAMUNDESWARI.V,Independent,148,1,149,0.07,Tamil Nadu-Salem (South)
16,R.SUNDARAM,Independent,311,0,311,0.16,Tamil Nadu-Salem (South)
17,K.SELVARAJ,Independent,210,0,210,0.11,Tamil Nadu-Salem (South)
18,B.DEVI,Independent,224,0,224,0.11,Tamil Nadu-Salem (South)
19,M.PERIYASAMY,Independent,61,0,61,0.03,Tamil Nadu-Salem (South)
20,N.MAYAKANNAN,Independent,58,0,58,0.03,Tamil Nadu-Salem (South)
21,K.MARIAPPAN,Independent,22,0,22,0.01,Tamil Nadu-Salem (South)
22,D.M.MOHAMMAD NAZEERUDEEN,Independent,25,1,26,0.01,Tamil Nadu-Salem (South)
23,K.YASIN BASHA,Independent,26,0,26,0.01,Tamil Nadu-Salem (South)
24,K.N.VEERASENAN,Independent,111,1,112,0.06,Tamil Nadu-Salem (South)
25,NOTA,None of the Above,1832,28,1860,0.93,Tamil Nadu-Salem (South)
1,ALAGAAPURAM R. MOHANRAJ,Desiya Murpokku Dravida Kazhagam,2280,27,2307,1.06,Tamil Nadu-Salem (West)
2,TAMIL SELVAN. S,Bahujan Samaj Party,277,6,283,0.13,Tamil Nadu-Salem (West)
3,RAJENDRAN. A,Dravida Munnetra Kazhagam,82389,1595,83984,38.77,Tamil Nadu-Salem (West)
4,ARUL. R,Pattali Makkal Katchi,104728,755,105483,48.69,Tamil Nadu-Salem (West)
5,KATHIRVEL. A,My India Party,329,1,330,0.15,Tamil Nadu-Salem (West)
6,KARTHIKEYAN. J,Tamil Nadu Ilangyar Katchi,576,4,580,0.27,Tamil Nadu-Salem (West)
7,SENTHILKUMAR. A,Anaithu Makkal Puratchi Katchi,97,2,99,0.05,Tamil Nadu-Salem (West)
8,THIYAGARAJAN. A,Makkal Needhi Maiam,7867,72,7939,3.66,Tamil Nadu-Salem (West)
9,NAGAMMAL. S,Naam Tamilar Katchi,10592,76,10668,4.92,Tamil Nadu-Salem (West)
10,MUTHUSAMY. R,Tamilaga Makkal Thannurimai Katchi,156,8,164,0.08,Tamil Nadu-Salem (West)
11,VIJAYAKUMAR. R,Dhesiya Makkal Kazhagam,637,2,639,0.29,Tamil Nadu-Salem (West)
12,INBARAJ. A,Independent,108,2,110,0.05,Tamil Nadu-Salem (West)
13,KATHAVARAYAN. S,Independent,230,2,232,0.11,Tamil Nadu-Salem (West)
14,GOPI. M,Independent,211,0,211,0.1,Tamil Nadu-Salem (West)
15,GOPINATH. R,Independent,68,0,68,0.03,Tamil Nadu-Salem (West)
16,CHANDRASEKARAN. G,Independent,191,0,191,0.09,Tamil Nadu-Salem (West)
17,SABBAPATHI. M,Independent,93,0,93,0.04,Tamil Nadu-Salem (West)
18,SARATHKUMAR. S,Independent,240,1,241,0.11,Tamil Nadu-Salem (West)
19,SIVARAMAN. S,Independent,221,1,222,0.1,Tamil Nadu-Salem (West)
20,THIYAGARAJAN. M,Independent,315,0,315,0.15,Tamil Nadu-Salem (West)
21,NATARAJAN. C,Independent,105,0,105,0.05,Tamil Nadu-Salem (West)
22,BALAJI. D,Independent,36,0,36,0.02,Tamil Nadu-Salem (West)
23,MAYAKANNAN. M,Independent,57,0,57,0.03,Tamil Nadu-Salem (West)
24,MARIMUTHU. M,Independent,120,0,120,0.06,Tamil Nadu-Salem (West)
25,MURUGAN. A,Independent,78,1,79,0.04,Tamil Nadu-Salem (West)
26,RAMKUMAR. R,Independent,128,0,128,0.06,Tamil Nadu-Salem (West)
27,RAJENDIRAN. B,Independent,132,0,132,0.06,Tamil Nadu-Salem (West)
28,JEEVANANTHAM. M,Independent,128,1,129,0.06,Tamil Nadu-Salem (West)
29,NOTA,None of the Above,1663,20,1683,0.78,Tamil Nadu-Salem (West)
1,RAJALAKSHMI V M,All India Anna Dravida Munnetra Kazhagam,65677,373,66050,36.03,Tamil Nadu-Sankarankovil
2,RAJA E,Dravida Munnetra Kazhagam,70144,1203,71347,38.92,Tamil Nadu-Sankarankovil
3,ANNADURAI R,Amma Makkal Munnettra Kazagam,22278,404,22682,12.37,Tamil Nadu-Sankarankovil
4,SUBRAMANIAM V,Puthiya Tamilagam,1912,29,1941,1.06,Tamil Nadu-Sankarankovil
5,PANEERSELVAM U,Tamizhaga Murpokku Makkal Katchi,186,1,187,0.1,Tamil Nadu-Sankarankovil
6,BALAMURUGESAN M,Bahujan Dravida Party,94,3,97,0.05,Tamil Nadu-Sankarankovil
7,PRABHU K,Makkal Needhi Maiam,2319,19,2338,1.28,Tamil Nadu-Sankarankovil
8,MAHENDRAKUMARI P,Naam Tamilar Katchi,13683,168,13851,7.55,Tamil Nadu-Sankarankovil
9,MATHANKUMAR K,My India Party,168,3,171,0.09,Tamil Nadu-Sankarankovil
10,GANESAN A,Independent,106,1,107,0.06,Tamil Nadu-Sankarankovil
11,KARUTHAPANDIYAN R,Independent,408,0,408,0.22,Tamil Nadu-Sankarankovil
12,GURURAJ P,Independent,303,0,303,0.17,Tamil Nadu-Sankarankovil
13,MUTHUKKUTTI S,Independent,389,0,389,0.21,Tamil Nadu-Sankarankovil
14,VALLIAMMAL M,Independent,888,2,890,0.49,Tamil Nadu-Sankarankovil
15,VETRIMARAN A,Independent,620,0,620,0.34,Tamil Nadu-Sankarankovil
16,NOTA,None of the Above,1937,20,1957,1.07,Tamil Nadu-Sankarankovil
1,UDHAYASURIYAN T,Dravida Munnetra Kazhagam,119487,1699,121186,56.16,Tamil Nadu-Sankarapuram
2,Sakthivel S,Bahujan Samaj Party,807,3,810,0.38,Tamil Nadu-Sankarapuram
3,ARUNKENNADI A P,All  India  Pattali  Munnetra Katchi,203,0,203,0.09,Tamil Nadu-Sankarapuram
4,OVIYAR ANANDH C,Lok Jan Shakti Party,256,1,257,0.12,Tamil Nadu-Sankarapuram
5,MUJIBUR RAGIMAN M,All India Majlis-E-Ittehadul Muslimeen,377,2,379,0.18,Tamil Nadu-Sankarapuram
6,RAMESH G,Indiya Jananayaka Katchi,458,2,460,0.21,Tamil Nadu-Sankarapuram
7,RAJIYAMA B,Naam Tamilar Katchi,9824,49,9873,4.58,Tamil Nadu-Sankarapuram
8,Dr.RAJA G,Pattali Makkal Katchi,74702,521,75223,34.86,Tamil Nadu-Sankarapuram
9,VIMALAMARY S,Anna MGR Dravida Makkal Kalgam,603,6,609,0.28,Tamil Nadu-Sankarapuram
10,ARUL P,Independent,2119,1,2120,0.98,Tamil Nadu-Sankarapuram
11,UTHAYAKUMAR A,Independent,165,1,166,0.08,Tamil Nadu-Sankarapuram
12,KUBENDIRAN A,Independent,428,0,428,0.2,Tamil Nadu-Sankarapuram
13,GOPINATH E,Independent,272,0,272,0.13,Tamil Nadu-Sankarapuram
14,DHANAM K,Independent,348,0,348,0.16,Tamil Nadu-Sankarapuram
15,BABUGANESH S,Independent,292,1,293,0.14,Tamil Nadu-Sankarapuram
16,MANNAN M P,Independent,1155,1,1156,0.54,Tamil Nadu-Sankarapuram
17,MAYILAMPARAI MARI A,Independent,844,0,844,0.39,Tamil Nadu-Sankarapuram
18,RAJKUMAR  E,Independent,88,0,88,0.04,Tamil Nadu-Sankarapuram
19,JAYAPRAKASH K,Independent,134,0,134,0.06,Tamil Nadu-Sankarapuram
20,NOTA,None of the Above,944,9,953,0.44,Tamil Nadu-Sankarapuram
1,"SUNDARARAJAN, S.",All India Anna Dravida Munnetra Kazhagam,114376,1096,115472,49.72,Tamil Nadu-Sankari
2,"RAJESH, K.M.",Dravida Munnetra Kazhagam,93897,1530,95427,41.09,Tamil Nadu-Sankari
3,"SIVALINGAM, C.",Tamilaga Makkal Thannurimai Katchi,812,2,814,0.35,Tamil Nadu-Sankari
4,"SENGODAN, K.",Makkal Needhi Maiam,3140,35,3175,1.37,Tamil Nadu-Sankari
5,"CHELLAMUTHU, A.",Amma Makkal Munnettra Kazagam,1462,9,1471,0.63,Tamil Nadu-Sankari
6,"SETTU, K.",My India Party,96,0,96,0.04,Tamil Nadu-Sankari
7,"SHOBANA, S.",Naam Tamilar Katchi,10788,74,10862,4.68,Tamil Nadu-Sankari
8,"RAVIKUMAR, P.",Ganasangam Party of India,197,3,200,0.09,Tamil Nadu-Sankari
9,"AROKIASAMI, A.",Independent,135,0,135,0.06,Tamil Nadu-Sankari
10,"GUNASEKARAN, M.",Independent,92,3,95,0.04,Tamil Nadu-Sankari
11,"GOPALAKRISHNAN, S.",Independent,166,0,166,0.07,Tamil Nadu-Sankari
12,"SATHISHKUMAR, V.",Independent,87,2,89,0.04,Tamil Nadu-Sankari
13,"SENGOTEN, R.",Independent,97,0,97,0.04,Tamil Nadu-Sankari
14,"DURAIRAJ, C.",Independent,209,2,211,0.09,Tamil Nadu-Sankari
15,"PALANIYAPPAN, M.",Independent,524,1,525,0.23,Tamil Nadu-Sankari
16,"BAKKIYAMANI, M.",Independent,846,1,847,0.36,Tamil Nadu-Sankari
17,"PRABHU, K.",Independent,481,0,481,0.21,Tamil Nadu-Sankari
18,"MANIVEL, P.",Independent,276,2,278,0.12,Tamil Nadu-Sankari
19,"VIJAYAKUMAR, P.",Independent,55,0,55,0.02,Tamil Nadu-Sankari
20,"VIJI @ VIJAYAN, K.",Independent,30,1,31,0.01,Tamil Nadu-Sankari
21,"VENGADACHALAM, T.",Independent,33,0,33,0.01,Tamil Nadu-Sankari
22,"JAGANATHAN, I.",Independent,99,0,99,0.04,Tamil Nadu-Sankari
23,"JAGANNATHAN, M.",Independent,119,0,119,0.05,Tamil Nadu-Sankari
24,NOTA,None of the Above,1453,16,1469,0.63,Tamil Nadu-Sankari
1,"RAGHURAMAN,  A.R.R.",Dravida Munnetra Kazhagam,72949,1225,74174,38.68,Tamil Nadu-Sattur
2,"RAVICHANDHRAN, R.K.",All India Anna Dravida Munnetra Kazhagam,62701,294,62995,32.85,Tamil Nadu-Sattur
3,"ANGUSAMY,  S.",Anaithu Makkal Puratchi Katchi,411,3,414,0.22,Tamil Nadu-Sattur
4,"SUBBURAMAN, P.",All India MGR Makkal Munnetra Kazhagam,153,3,156,0.08,Tamil Nadu-Sattur
5,"PALANICHAMY, P.",Bahujan Dravida Party,96,1,97,0.05,Tamil Nadu-Sattur
6,"PANDI, K.",Naam Tamilar Katchi,12478,148,12626,6.58,Tamil Nadu-Sattur
7,"BHARATHI, M.",Indiya Jananayaka Katchi,1722,29,1751,0.91,Tamil Nadu-Sattur
8,"MARIKANNAN, G.",Puthiya Tamilagam,1584,15,1599,0.83,Tamil Nadu-Sattur
9,"RAJAVARMAN, M.S.R.",Amma Makkal Munnettra Kazagam,32693,223,32916,17.16,Tamil Nadu-Sattur
10,"RAJKUMAR, R.",My India Party,186,2,188,0.1,Tamil Nadu-Sattur
11,"JEYAGANESH, K.",Veerath Thiyagi Viswanathadoss Thozhilalarkal Katchi,166,0,166,0.09,Tamil Nadu-Sattur
12,"ANTHONYRAJ,  A.",Independent,57,0,57,0.03,Tamil Nadu-Sattur
13,"KARUTHAPANDIAN, S.",Independent,136,0,136,0.07,Tamil Nadu-Sattur
14,"GURUSAMY, P.",Independent,94,0,94,0.05,Tamil Nadu-Sattur
15,"SARAVANAKUMAR, M.",Independent,634,1,635,0.33,Tamil Nadu-Sattur
16,"SUBRAMANIAN, S.",Independent,551,0,551,0.29,Tamil Nadu-Sattur
17,"SENTHUR PANDIAN, R.",Independent,405,1,406,0.21,Tamil Nadu-Sattur
18,"CHELLAPANDIAN,  P.",Independent,368,1,369,0.19,Tamil Nadu-Sattur
19,"DHAMODHARAN,  S.",Independent,118,1,119,0.06,Tamil Nadu-Sattur
20,"BALA SUBRAMANIAN, R.",Independent,61,1,62,0.03,Tamil Nadu-Sattur
21,"BALAMURUGAN, K.",Independent,156,1,157,0.08,Tamil Nadu-Sattur
22,"PRABAKARAN, J.",Independent,60,0,60,0.03,Tamil Nadu-Sattur
23,"MAHESKUMAR, M",Independent,41,0,41,0.02,Tamil Nadu-Sattur
24,"MANOHARAN, V.",Independent,51,0,51,0.03,Tamil Nadu-Sattur
25,"MARIAPPAN, M.",Independent,123,1,124,0.06,Tamil Nadu-Sattur
26,"RAGU, B.",Independent,331,1,332,0.17,Tamil Nadu-Sattur
27,"RAMESH, A.",Independent,210,0,210,0.11,Tamil Nadu-Sattur
28,NOTA,None of the Above,1280,17,1297,0.68,Tamil Nadu-Sattur
1,CHANDRAN S,All India Anna Dravida Munnetra Kazhagam,79703,485,80188,40.25,Tamil Nadu-Senthamangalam
2,PONNUSAMY K,Dravida Munnetra Kazhagam,89146,1535,90681,45.51,Tamil Nadu-Senthamangalam
3,CHANDRAN P,Amma Makkal Munnettra Kazagam,827,4,831,0.42,Tamil Nadu-Senthamangalam
4,SELVARAJ V,Indiya Jananayaka Katchi,428,3,431,0.22,Tamil Nadu-Senthamangalam
5,ROHINI T,Naam Tamilar Katchi,11534,120,11654,5.85,Tamil Nadu-Senthamangalam
6,SANKAR P,Independent,194,1,195,0.1,Tamil Nadu-Senthamangalam
7,CHANDRASEKARAN C,Independent,11328,43,11371,5.71,Tamil Nadu-Senthamangalam
8,THIYAGARAJAN C,Independent,202,0,202,0.1,Tamil Nadu-Senthamangalam
9,DINESH C,Independent,87,0,87,0.04,Tamil Nadu-Senthamangalam
10,DURAIRAJ S,Independent,131,0,131,0.07,Tamil Nadu-Senthamangalam
11,PRASATH S,Independent,116,3,119,0.06,Tamil Nadu-Senthamangalam
12,MUTHUSAMY C,Independent,227,0,227,0.11,Tamil Nadu-Senthamangalam
13,RANCHITH C,Independent,136,1,137,0.07,Tamil Nadu-Senthamangalam
14,RAMESH R,Independent,250,1,251,0.13,Tamil Nadu-Senthamangalam
15,RAMASAMY K.V,Independent,672,0,672,0.34,Tamil Nadu-Senthamangalam
16,NOTA,None of the Above,2044,14,2058,1.03,Tamil Nadu-Senthamangalam
1,MANICKAM K,All India Anna Dravida Munnetra Kazhagam,66792,403,67195,38.32,Tamil Nadu-Sholavandan
2,VENKATESAN A,Dravida Munnetra Kazhagam,83247,993,84240,48.04,Tamil Nadu-Sholavandan
3,JEYALAKSHMI M,Desiya Murpokku Dravida Kazhagam,3534,48,3582,2.04,Tamil Nadu-Sholavandan
4,INDURANI S,Puthiya Tamilagam,248,2,250,0.14,Tamil Nadu-Sholavandan
5,ESWARI T,Communist Party of India  (Marxist-Leninist)  (Liberation),121,4,125,0.07,Tamil Nadu-Sholavandan
6,SILAMBARASAN P,Bahujan Dravida Party,143,3,146,0.08,Tamil Nadu-Sholavandan
7,SENGANNAN G,Naam Tamilar Katchi,13783,153,13936,7.95,Tamil Nadu-Sholavandan
8,YOGANATHAN S,Makkal Needhi Maiam,3000,31,3031,1.73,Tamil Nadu-Sholavandan
9,RAJKUMAR K,My India Party,71,0,71,0.04,Tamil Nadu-Sholavandan
10,KATHIRESAN P,Independent,102,2,104,0.06,Tamil Nadu-Sholavandan
11,KANDAVEL S,Independent,292,2,294,0.17,Tamil Nadu-Sholavandan
12,KRISHNASAMY P,Independent,81,3,84,0.05,Tamil Nadu-Sholavandan
13,SEKAR N,Independent,70,0,70,0.04,Tamil Nadu-Sholavandan
14,DHANAGOPAL S,Independent,86,2,88,0.05,Tamil Nadu-Sholavandan
15,MALAICHAMY A,Independent,133,0,133,0.08,Tamil Nadu-Sholavandan
16,MOORTHY P,Independent,200,0,200,0.11,Tamil Nadu-Sholavandan
17,MOORTHI M,Independent,363,0,363,0.21,Tamil Nadu-Sholavandan
18,RAJKUMAR V,Independent,347,6,353,0.2,Tamil Nadu-Sholavandan
19,VARATHARAJAN C,Independent,89,0,89,0.05,Tamil Nadu-Sholavandan
20,VETRIVEL J,Independent,46,0,46,0.03,Tamil Nadu-Sholavandan
21,NOTA,None of the Above,946,15,961,0.55,Tamil Nadu-Sholavandan
1,M.GIRIDHARAN,Bahujan Samaj Party,611,3,614,0.27,Tamil Nadu-Sholinghur
2,A.M.MUNIRATHINAM,Indian National Congress,109138,1090,110228,49.18,Tamil Nadu-Sholinghur
3,A.M.KRISHNAN,Pattali Makkal Katchi,82919,611,83530,37.27,Tamil Nadu-Sholinghur
4,N.G.PARTHIBAN,Amma Makkal Munnettra Kazagam,12877,102,12979,5.79,Tamil Nadu-Sholinghur
5,Y.R.PAVENDHAN,Naam Tamilar Katchi,9580,76,9656,4.31,Tamil Nadu-Sholinghur
6,R.VINOTH,Veerath Thiyagi Viswanathadoss Thozhilalarkal Katchi,131,1,132,0.06,Tamil Nadu-Sholinghur
7,G.VIJAYAKUMAR,Desiya Sirupanmayinar Makkal Iyakkam,222,0,222,0.1,Tamil Nadu-Sholinghur
8,R.JAWAHAR,Makkal Needhi Maiam,1649,15,1664,0.74,Tamil Nadu-Sholinghur
9,T.RAJENDRAN,Independent,1014,1,1015,0.45,Tamil Nadu-Sholinghur
10,R.ELUMALAI,Independent,111,1,112,0.05,Tamil Nadu-Sholinghur
11,K.SEKAR,Independent,121,0,121,0.05,Tamil Nadu-Sholinghur
12,A.PALANI,Independent,466,0,466,0.21,Tamil Nadu-Sholinghur
13,P.PARTHIBAN,Independent,204,1,205,0.09,Tamil Nadu-Sholinghur
14,J.BALAJI,Independent,464,3,467,0.21,Tamil Nadu-Sholinghur
15,K.MANI,Independent,369,3,372,0.17,Tamil Nadu-Sholinghur
16,N.MANI,Independent,326,0,326,0.15,Tamil Nadu-Sholinghur
17,C.MUNIRATHINAM,Independent,174,0,174,0.08,Tamil Nadu-Sholinghur
18,M.MUNIRATHINAM,Independent,585,2,587,0.26,Tamil Nadu-Sholinghur
19,NOTA,None of the Above,1234,5,1239,0.55,Tamil Nadu-Sholinghur
1,S.ARAVINDRAMESH,Dravida Munnetra Kazhagam,170675,883,171558,44.18,Tamil Nadu-Shozhinganallur
2,K.P.KANDAN,All India Anna Dravida Munnetra Kazhagam,135834,319,136153,35.06,Tamil Nadu-Shozhinganallur
3,G.PRAKASH ROBERT,Bahujan Samaj Party,551,3,554,0.14,Tamil Nadu-Shozhinganallur
4,R.MURUGAN,Desiya Murpokku Dravida Kazhagam,3903,9,3912,1.01,Tamil Nadu-Shozhinganallur
5,T.ELUMALAI,Anna MGR Dravida Munnetra Kazhagam,160,0,160,0.04,Tamil Nadu-Shozhinganallur
6,S.MICHAEL,Naam Tamilar Katchi,38825,47,38872,10.01,Tamil Nadu-Shozhinganallur
7,RAJIV KUMAR,Makkal Needhi Maiam,30229,55,30284,7.8,Tamil Nadu-Shozhinganallur
8,M.RAJESWARIPRIYA,Anaithu Makkal Arasiyal Katchi,426,1,427,0.11,Tamil Nadu-Shozhinganallur
9,A.I.AHAMED SHAH,Independent,171,1,172,0.04,Tamil Nadu-Shozhinganallur
10,H.ARAVINDHKUMAR,Independent,448,4,452,0.12,Tamil Nadu-Shozhinganallur
11,P.ARULRAJ,Independent,67,5,72,0.02,Tamil Nadu-Shozhinganallur
12,R.RAVICHANDRAN,Independent,95,0,95,0.02,Tamil Nadu-Shozhinganallur
13,Dr. V.KANDAN,Independent,146,1,147,0.04,Tamil Nadu-Shozhinganallur
14,D.KALANITHI,Independent,96,0,96,0.02,Tamil Nadu-Shozhinganallur
15,D.SRINIVASAN,Independent,149,0,149,0.04,Tamil Nadu-Shozhinganallur
16,K.SURJITHKUMAR,Independent,674,2,676,0.17,Tamil Nadu-Shozhinganallur
17,S.SENTHIL,Independent,477,0,477,0.12,Tamil Nadu-Shozhinganallur
18,K.SENTHILKUMAR,Independent,310,0,310,0.08,Tamil Nadu-Shozhinganallur
19,R.SELVAVIGNESH,Independent,176,0,176,0.05,Tamil Nadu-Shozhinganallur
20,A.DHANASEKAR,Independent,57,0,57,0.01,Tamil Nadu-Shozhinganallur
21,K.NARASIMMAN,Independent,58,0,58,0.01,Tamil Nadu-Shozhinganallur
22,S.PRITHIVIRAJ,Independent,45,0,45,0.01,Tamil Nadu-Shozhinganallur
23,A.MOHAMMED GANI,Independent,45,0,45,0.01,Tamil Nadu-Shozhinganallur
24,E.RAJESH,Independent,127,0,127,0.03,Tamil Nadu-Shozhinganallur
25,D.VENUGOPAL,Independent,117,0,117,0.03,Tamil Nadu-Shozhinganallur
26,G.VELAVAN,Independent,134,0,134,0.03,Tamil Nadu-Shozhinganallur
27,NOTA,None of the Above,3021,9,3030,0.78,Tamil Nadu-Shozhinganallur
1,"Karthik, N",Dravida Munnetra Kazhagam,68984,1406,70390,34.84,Tamil Nadu-Singanallur
2,"Jayaram, K.R",All India Anna Dravida Munnetra Kazhagam,80437,807,81244,40.22,Tamil Nadu-Singanallur
3,"Sasikumar, M",Anna Dravidar Kazhagam,209,2,211,0.1,Tamil Nadu-Singanallur
4,"SenthilKumar, S",United States of India Party,94,0,94,0.05,Tamil Nadu-Singanallur
5,"Selva, S.R",Amma Makkal Munnettra Kazagam,1722,11,1733,0.86,Tamil Nadu-Singanallur
6,"Narmadha, R",Naam Tamilar Katchi,8311,55,8366,4.14,Tamil Nadu-Singanallur
7,"Palanisamy, N",My India Party,112,1,113,0.06,Tamil Nadu-Singanallur
8,"Mahendran, R",Makkal Needhi Maiam,36553,302,36855,18.24,Tamil Nadu-Singanallur
9,"Akbar Ali, A",Independent,86,0,86,0.04,Tamil Nadu-Singanallur
10,"Karthick, N",Independent,72,1,73,0.04,Tamil Nadu-Singanallur
11,"Karthik, N",Independent,132,3,135,0.07,Tamil Nadu-Singanallur
12,"Krishnan, V",Independent,30,0,30,0.01,Tamil Nadu-Singanallur
13,"Kumar babu, K",Independent,87,0,87,0.04,Tamil Nadu-Singanallur
14,"Gowtham, P",Independent,65,2,67,0.03,Tamil Nadu-Singanallur
15,"Chanthirika, R",Independent,200,1,201,0.1,Tamil Nadu-Singanallur
16,"Nabas Sherif, M",Independent,257,0,257,0.13,Tamil Nadu-Singanallur
17,"Nagarajan, J",Independent,163,0,163,0.08,Tamil Nadu-Singanallur
18,Praveen Venkatachalam,Independent,187,1,188,0.09,Tamil Nadu-Singanallur
19,"Maniraj, K",Independent,87,2,89,0.04,Tamil Nadu-Singanallur
20,"Mohandass, N",Independent,121,0,121,0.06,Tamil Nadu-Singanallur
21,"Viju Alban Prakash, V",Independent,86,0,86,0.04,Tamil Nadu-Singanallur
22,NOTA,None of the Above,1415,17,1432,0.71,Tamil Nadu-Singanallur
1,PANNEERSELVAM,Dravida Munnetra Kazhagam,92866,1191,94057,49.16,Tamil Nadu-Sirkazhi
2,P.V.BHARATHI,All India Anna Dravida Munnetra Kazhagam,81235,674,81909,42.81,Tamil Nadu-Sirkazhi
3,SRITHAR,Bahujan Samaj Party,490,5,495,0.26,Tamil Nadu-Sirkazhi
4,Kamban,Anaithu Makkal Arasiyal Katchi,76,3,79,0.04,Tamil Nadu-Sirkazhi
5,Kavitha,Naam Tamilar Katchi,10966,47,11013,5.76,Tamil Nadu-Sirkazhi
6,BALU,Amma Makkal Munnettra Kazagam,1301,7,1308,0.68,Tamil Nadu-Sirkazhi
7,PRABU,Makkal Needhi Maiam,990,10,1000,0.52,Tamil Nadu-Sirkazhi
8,ANUSUYA,Independent,76,1,77,0.04,Tamil Nadu-Sirkazhi
9,Silambarasan,Independent,121,1,122,0.06,Tamil Nadu-Sirkazhi
10,BARATHI,Independent,287,1,288,0.15,Tamil Nadu-Sirkazhi
11,NOTA,None of the Above,974,3,977,0.51,Tamil Nadu-Sirkazhi
1,S. Gunasekaran,Communist Party of India,69101,1799,70900,35.09,Tamil Nadu-Sivaganga
2,PR. Senthilnathan,All India Anna Dravida Munnetra Kazhagam,81267,886,82153,40.66,Tamil Nadu-Sivaganga
3,K. Anbarasan,Amma Makkal Munnettra Kazagam,19631,193,19824,9.81,Tamil Nadu-Sivaganga
4,N. Pandimuthu,My India Party,369,4,373,0.18,Tamil Nadu-Sivaganga
5,R. Mallika,Naam Tamilar Katchi,22301,199,22500,11.14,Tamil Nadu-Sivaganga
6,Vadivel. C,Anaithu Makkal Puratchi Katchi,239,2,241,0.12,Tamil Nadu-Sivaganga
7,Joseph. C,Makkal Needhi Maiam,2076,29,2105,1.04,Tamil Nadu-Sivaganga
8,K. Kalaiselvam,Independent,120,3,123,0.06,Tamil Nadu-Sivaganga
9,C. Kaningprabhu,Independent,109,3,112,0.06,Tamil Nadu-Sivaganga
10,R. Gunasekaran,Independent,145,10,155,0.08,Tamil Nadu-Sivaganga
11,M. Thirukumaran,Independent,124,3,127,0.06,Tamil Nadu-Sivaganga
12,Dr. A. Parthasarathy,Independent,342,3,345,0.17,Tamil Nadu-Sivaganga
13,M. Ravi,Independent,175,0,175,0.09,Tamil Nadu-Sivaganga
14,Vimalraj,Independent,307,2,309,0.15,Tamil Nadu-Sivaganga
15,P. Viswanathan,Independent,1318,14,1332,0.66,Tamil Nadu-Sivaganga
16,NOTA,None of the Above,1258,12,1270,0.63,Tamil Nadu-Sivaganga
1,Ashokan.G,Indian National Congress,77788,1159,78947,42.66,Tamil Nadu-Sivakasi
2,Ananthalakshmi,Bahujan Samaj Party,432,6,438,0.24,Tamil Nadu-Sivakasi
3,Lakshmi Ganesan,All India Anna Dravida Munnetra Kazhagam,61367,261,61628,33.3,Tamil Nadu-Sivakasi
4,KANNAN.K,Veerath Thiyagi Viswanathadoss Thozhilalarkal Katchi,423,3,426,0.23,Tamil Nadu-Sivakasi
5,KARUPPASAMY.S,Anaithu Makkal Puratchi Katchi,314,2,316,0.17,Tamil Nadu-Sivakasi
6,KALYANASUNDARI.M,My India Party,188,3,191,0.1,Tamil Nadu-Sivakasi
7,Kanagapriya.R,Naam Tamilar Katchi,20754,111,20865,11.28,Tamil Nadu-Sivakasi
8,Samikkalai.G,Amma Makkal Munnettra Kazagam,9751,142,9893,5.35,Tamil Nadu-Sivakasi
9,MGR NAMBBI,All India MGR Makkal Munnetra Kazhagam,107,0,107,0.06,Tamil Nadu-Sivakasi
10,PALANICHAMY.P,Bahujan Dravida Party,61,0,61,0.03,Tamil Nadu-Sivakasi
11,Mugunthan.S,Makkal Needhi Maiam,6053,37,6090,3.29,Tamil Nadu-Sivakasi
12,JEEVANANTHAM.G,Republican Party of India (Athawale),77,1,78,0.04,Tamil Nadu-Sivakasi
13,Ashokkumar.C,Independent,86,2,88,0.05,Tamil Nadu-Sivakasi
14,Anbalagan.P,Independent,125,1,126,0.07,Tamil Nadu-Sivakasi
15,GANESAN.R,Independent,151,1,152,0.08,Tamil Nadu-Sivakasi
16,Karthik.N,Independent,319,0,319,0.17,Tamil Nadu-Sivakasi
17,KESAVAKUMAR.D,Independent,442,0,442,0.24,Tamil Nadu-Sivakasi
18,Thangaraj.S,Independent,233,1,234,0.13,Tamil Nadu-Sivakasi
19,DHARMALINGAM.M,Independent,330,0,330,0.18,Tamil Nadu-Sivakasi
20,Pandiarajan.S,Independent,113,1,114,0.06,Tamil Nadu-Sivakasi
21,Balakrishnan.N,Independent,405,9,414,0.22,Tamil Nadu-Sivakasi
22,MAYILVAGANAN.G,Independent,100,1,101,0.05,Tamil Nadu-Sivakasi
23,MARIMUTHU.M,Independent,220,1,221,0.12,Tamil Nadu-Sivakasi
24,LAKSHMANAN.E,Independent,1410,20,1430,0.77,Tamil Nadu-Sivakasi
25,VINOTHKUMAR.M,Independent,245,0,245,0.13,Tamil Nadu-Sivakasi
26,JOYSMARY.T,Independent,64,0,64,0.03,Tamil Nadu-Sivakasi
27,NOTA,None of the Above,1709,18,1727,0.93,Tamil Nadu-Sivakasi
1,SELVAPERUNTHAGAI,Indian National Congress,114554,799,115353,43.65,Tamil Nadu-Sriperumbudur
2,PALANI,All India Anna Dravida Munnetra Kazhagam,104017,457,104474,39.53,Tamil Nadu-Sriperumbudur
3,VINOTH,Bahujan Samaj Party,802,1,803,0.3,Tamil Nadu-Sriperumbudur
4,THANIGAIVEL,Makkal Needhi Maiam,8838,32,8870,3.36,Tamil Nadu-Sriperumbudur
5,PUSHPARAJ,Naam Tamilar Katchi,21998,36,22034,8.34,Tamil Nadu-Sriperumbudur
6,PERUMAL,Amma Makkal Munnettra Kazagam,3125,19,3144,1.19,Tamil Nadu-Sriperumbudur
7,LOKESH,Desiya Makkal Sakthi Katchi,123,0,123,0.05,Tamil Nadu-Sriperumbudur
8,SAROJA,Independent,280,2,282,0.11,Tamil Nadu-Sriperumbudur
9,SUDHAKAR,Independent,88,12,100,0.04,Tamil Nadu-Sriperumbudur
10,DEVARAJAN,Independent,114,15,129,0.05,Tamil Nadu-Sriperumbudur
11,PARTHIBAN,Independent,74,0,74,0.03,Tamil Nadu-Sriperumbudur
12,LEENA,Independent,138,0,138,0.05,Tamil Nadu-Sriperumbudur
13,VASANTHI,Independent,123,1,124,0.05,Tamil Nadu-Sriperumbudur
14,VEDHAGIRI,Independent,132,3,135,0.05,Tamil Nadu-Sriperumbudur
15,VAIRAMUTHU,Independent,6325,15,6340,2.4,Tamil Nadu-Sriperumbudur
16,NOTA,None of the Above,2132,7,2139,0.81,Tamil Nadu-Sriperumbudur
1,KuPa Krishnan,All India Anna Dravida Munnetra Kazhagam,93131,858,93989,39.12,Tamil Nadu-Srirangam
2,G.Selvakumar,Bahujan Samaj Party,805,6,811,0.34,Tamil Nadu-Srirangam
3,Palaniyandi.M,Dravida Munnetra Kazhagam,112009,1895,113904,47.41,Tamil Nadu-Srirangam
4,Annalakshmi,Desiya Makkal Sakthi Katchi,606,2,608,0.25,Tamil Nadu-Srirangam
5,Sarubala.R.Thondaiman,Amma Makkal Munnettra Kazagam,3448,39,3487,1.45,Tamil Nadu-Srirangam
6,K.Selvarathi,Naam Tamilar Katchi,17793,118,17911,7.46,Tamil Nadu-Srirangam
7,Daniel Jude Martin,Makkal Munnetra Peravai,207,3,210,0.09,Tamil Nadu-Srirangam
8,P.Balasubramanian,Samaniya Makkal Nala Katchi,88,1,89,0.04,Tamil Nadu-Srirangam
9,S.Francis Mery,Indiya Jananayaka Katchi,1062,5,1067,0.44,Tamil Nadu-Srirangam
10,M.Amsavalli,Independent,95,2,97,0.04,Tamil Nadu-Srirangam
11,R.Uma,Independent,157,6,163,0.07,Tamil Nadu-Srirangam
12,S.Suresh,Independent,386,2,388,0.16,Tamil Nadu-Srirangam
13,V.Sethumadhavan,Independent,594,0,594,0.25,Tamil Nadu-Srirangam
14,P.Ravichandran,Independent,422,1,423,0.18,Tamil Nadu-Srirangam
15,Y.Jacob,Independent,4031,51,4082,1.7,Tamil Nadu-Srirangam
16,NOTA,None of the Above,2391,26,2417,1.01,Tamil Nadu-Srirangam
1,Amirtharaj .S,Indian National Congress,75086,1757,76843,46.75,Tamil Nadu-Srivaikuntam
2,S.P.SHUNMUGANATHAN,All India Anna Dravida Munnetra Kazhagam,58583,888,59471,36.18,Tamil Nadu-Srivaikuntam
3,Arun B,Puthiya Tamilagam,437,7,444,0.27,Tamil Nadu-Srivaikuntam
4,Arulmathi Yesuvadiyal,Aanaithinthiya Jananayaka Pathukappu Kazhagam,95,1,96,0.06,Tamil Nadu-Srivaikuntam
5,ERAL S. RAMESH,Amma Makkal Munnettra Kazagam,10074,129,10203,6.21,Tamil Nadu-Srivaikuntam
6,R.Chandra Sekar,Makkal Needhi Maiam,1345,10,1355,0.82,Tamil Nadu-Srivaikuntam
7,P.Subbiah Pandian,Naam Tamilar Katchi,12552,154,12706,7.73,Tamil Nadu-Srivaikuntam
8,SURESH PERUMAL S,Naam Indiar Party,232,1,233,0.14,Tamil Nadu-Srivaikuntam
9,Jegan,Anna Dravidar Kazhagam,104,2,106,0.06,Tamil Nadu-Srivaikuntam
10,ALLWIN DURAISINGH P,Independent,51,1,52,0.03,Tamil Nadu-Srivaikuntam
11,Esakki Raja K,Independent,336,5,341,0.21,Tamil Nadu-Srivaikuntam
12,Kirushnavel R,Independent,103,0,103,0.06,Tamil Nadu-Srivaikuntam
13,Sankara Subramanian M,Independent,129,0,129,0.08,Tamil Nadu-Srivaikuntam
14,SARAVANAN G,Independent,79,1,80,0.05,Tamil Nadu-Srivaikuntam
15,Sudalaimuthu Perumal,Independent,139,1,140,0.09,Tamil Nadu-Srivaikuntam
16,Sethuramalingam S,Independent,311,1,312,0.19,Tamil Nadu-Srivaikuntam
17,Durai Singh J,Independent,493,1,494,0.3,Tamil Nadu-Srivaikuntam
18,Ponnudurai I,Independent,297,0,297,0.18,Tamil Nadu-Srivaikuntam
19,Malaiandi R,Independent,56,0,56,0.03,Tamil Nadu-Srivaikuntam
20,VINSTON ANTO S,Independent,37,1,38,0.02,Tamil Nadu-Srivaikuntam
21,Joseph Leon,Independent,126,5,131,0.08,Tamil Nadu-Srivaikuntam
22,NOTA,None of the Above,749,7,756,0.46,Tamil Nadu-Srivaikuntam
1,"MADHAVARAO, P.S.W.",Indian National Congress,56450,1287,57737,31.2,Tamil Nadu-Srivilliputhur
2,"MANRAJ, E.M.",All India Anna Dravida Munnetra Kazhagam,70081,394,70475,38.09,Tamil Nadu-Srivilliputhur
3,"ABINAYA, B.",Naam Tamilar Katchi,20038,310,20348,11,Tamil Nadu-Srivilliputhur
4,"IRULANDI, Dr. V.",Tamil Nadu Ilangyar Katchi,935,7,942,0.51,Tamil Nadu-Srivilliputhur
5,"GURUVAIYA, K.",Makkal Needhi Maiam,3468,44,3512,1.9,Tamil Nadu-Srivilliputhur
6,"SANGEETHAPRIYA, S.",Amma Makkal Munnettra Kazagam,23479,203,23682,12.8,Tamil Nadu-Srivilliputhur
7,"SHANTHI, S.",Puthiya Tamilagam,4917,68,4985,2.69,Tamil Nadu-Srivilliputhur
8,"PANDIYARAJ, K.",Anaithu Makkal Puratchi Katchi,209,0,209,0.11,Tamil Nadu-Srivilliputhur
9,"VEERAPANDI, K.",My India Party,175,2,177,0.1,Tamil Nadu-Srivilliputhur
10,"KANNAN, A.",Independent,237,1,238,0.13,Tamil Nadu-Srivilliputhur
11,"GURUVAIYA, G.",Independent,148,0,148,0.08,Tamil Nadu-Srivilliputhur
12,"THAMARAISELVAM, K.",Independent,163,1,164,0.09,Tamil Nadu-Srivilliputhur
13,"PRABHAKARAN, P.",Independent,201,1,202,0.11,Tamil Nadu-Srivilliputhur
14,"MAHALAKSHMI, M.",Independent,189,2,191,0.1,Tamil Nadu-Srivilliputhur
15,"MUTHULAKSHMI,R.",Independent,362,1,363,0.2,Tamil Nadu-Srivilliputhur
16,NOTA,None of the Above,1642,24,1666,0.9,Tamil Nadu-Srivilliputhur
1,KANDASAMY V.P.,All India Anna Dravida Munnetra Kazhagam,118221,747,118968,49.23,Tamil Nadu-Sulur
2,PREMIER SELVAM (a)KALICHAMY M,Dravida Munnetra Kazhagam,85919,1117,87036,36.02,Tamil Nadu-Sulur
3,ELANGOVAN. G,Naam Tamilar Katchi,14376,50,14426,5.97,Tamil Nadu-Sulur
4,SENTHIL KUMAR. S.A.,Amma Makkal Munnettra Kazagam,4087,24,4111,1.7,Tamil Nadu-Sulur
5,NAGARAJ. K,Ganasangam Party of India,240,1,241,0.1,Tamil Nadu-Sulur
6,RANGANATHAN. A,Makkal Needhi Maiam,12592,66,12658,5.24,Tamil Nadu-Sulur
7,JAGADHEESH. S,My India Party,126,2,128,0.05,Tamil Nadu-Sulur
8,KANDASAMY T,Independent,82,1,83,0.03,Tamil Nadu-Sulur
9,KARTHIKEYAN P,Independent,209,0,209,0.09,Tamil Nadu-Sulur
10,SHANKAR GURU. M,Independent,191,5,196,0.08,Tamil Nadu-Sulur
11,SHANMUGAM R,Independent,112,4,116,0.05,Tamil Nadu-Sulur
12,SENTHIL KUMAR. S.A.P.,Independent,100,1,101,0.04,Tamil Nadu-Sulur
13,SELVA KUMAR D,Independent,213,0,213,0.09,Tamil Nadu-Sulur
14,SELVAN S,Independent,176,1,177,0.07,Tamil Nadu-Sulur
15,PREM KUMAR P,Independent,380,0,380,0.16,Tamil Nadu-Sulur
16,NOTA,None of the Above,2588,22,2610,1.08,Tamil Nadu-Sulur
1,Raja.S.R,Dravida Munnetra Kazhagam,115721,1119,116840,46.93,Tamil Nadu-Tambaram
2,Chinnaiyah.T.K.M,All India Anna Dravida Munnetra Kazhagam,79509,507,80016,32.14,Tamil Nadu-Tambaram
3,Harikrishnan.R,Bahujan Samaj Party,314,3,317,0.13,Tamil Nadu-Tambaram
4,Abdulnazar P A,Tamil Nadu Ilangyar Katchi,1348,3,1351,0.54,Tamil Nadu-Tambaram
5,Elango.Siva,Makkal Needhi Maiam,22466,64,22530,9.05,Tamil Nadu-Tambaram
6,Karikalan.M,Amma Makkal Munnettra Kazagam,4194,13,4207,1.69,Tamil Nadu-Tambaram
7,KAMATCHI U.,Anaithu Makkal Arasiyal Katchi,199,0,199,0.08,Tamil Nadu-Tambaram
8,Sureshkumar.T,Naam Tamilar Katchi,19463,31,19494,7.83,Tamil Nadu-Tambaram
9,Manojkumar A.,Shiv Sena,85,3,88,0.04,Tamil Nadu-Tambaram
10,Ramu A,National Democratic Party of South India,53,3,56,0.02,Tamil Nadu-Tambaram
11,Venkatesan.C,Veerath Thiyagi Viswanathadoss Thozhilalarkal Katchi,73,0,73,0.03,Tamil Nadu-Tambaram
12,Justin Charles.P,Republican Party of India (Athawale),64,0,64,0.03,Tamil Nadu-Tambaram
13,Anand Prabhu B.,Independent,122,0,122,0.05,Tamil Nadu-Tambaram
14,Laksmanan N.,Independent,264,0,264,0.11,Tamil Nadu-Tambaram
15,Kannairam.B,Independent,116,1,117,0.05,Tamil Nadu-Tambaram
16,KRISHNA T V N H S R.,Independent,212,3,215,0.09,Tamil Nadu-Tambaram
17,Sigamani S,Independent,247,0,247,0.1,Tamil Nadu-Tambaram
18,Sivaraman.S,Independent,168,1,169,0.07,Tamil Nadu-Tambaram
19,Thangaraj V.,Independent,46,1,47,0.02,Tamil Nadu-Tambaram
20,Balakrishnan G.,Independent,46,0,46,0.02,Tamil Nadu-Tambaram
21,Rathinakumar R.,Independent,149,2,151,0.06,Tamil Nadu-Tambaram
22,Venkatesan Balaji B.,Independent,71,0,71,0.03,Tamil Nadu-Tambaram
23,NOTA,None of the Above,2276,8,2284,0.92,Tamil Nadu-Tambaram
1,SELVA MOHANDAS PANDIAN.S,All India Anna Dravida Munnetra Kazhagam,88271,674,88945,41.54,Tamil Nadu-Tenkasi
2,PALANI NADAR.S,Indian National Congress,87706,1609,89315,41.71,Tamil Nadu-Tenkasi
3,UDHAYAKUMAR.K.M,Anna Dravidar Kazhagam,685,5,690,0.32,Tamil Nadu-Tenkasi
4,CHANDRASEGAR.S,Puthiya Tamilagam,857,21,878,0.41,Tamil Nadu-Tenkasi
5,SURESHKUMAR.S,Anna Puratchi Thalaivar Amma Dravida Munnetra Kazhagam,119,0,119,0.06,Tamil Nadu-Tenkasi
6,SELVAKUMAR.R,Naam Indiar Party,317,2,319,0.15,Tamil Nadu-Tenkasi
7,THIRUMALAIMUTHU.R,Makkal Needhi Maiam,2169,19,2188,1.02,Tamil Nadu-Tenkasi
8,MOHAMED.S,Amma Makkal Munnettra Kazagam,9839,105,9944,4.64,Tamil Nadu-Tenkasi
9,MUGUNDHAN.K,My India Party,194,1,195,0.09,Tamil Nadu-Tenkasi
10,VINCENTRAJ.R,Naam Tamilar Katchi,15213,123,15336,7.16,Tamil Nadu-Tenkasi
11,JEGANATHAN.M,Anaithu Makkal Puratchi Katchi,409,7,416,0.19,Tamil Nadu-Tenkasi
12,AROKKIYA PRABHU.J,Independent,426,2,428,0.2,Tamil Nadu-Tenkasi
13,DOCTOR. KARUPPASAMY.S,Independent,214,2,216,0.1,Tamil Nadu-Tenkasi
14,PALANIKUMAR.A,Independent,174,1,175,0.08,Tamil Nadu-Tenkasi
15,PALANIMURUGAN.P,Independent,627,1,628,0.29,Tamil Nadu-Tenkasi
16,MADASAMY.A,Independent,1974,4,1978,0.92,Tamil Nadu-Tenkasi
17,RAMESH.R,Independent,684,0,684,0.32,Tamil Nadu-Tenkasi
18,REEGANKUMAR. M,Independent,495,0,495,0.23,Tamil Nadu-Tenkasi
19,NOTA,None of the Above,1146,13,1159,0.54,Tamil Nadu-Tenkasi
1,RAMACHANDRAN.T,Communist Party of India,119621,1020,120641,62.18,Tamil Nadu-Thalli
2,Dr.NAGESH KUMAR.C,Bharatiya Janata Party,64131,284,64415,33.2,Tamil Nadu-Thalli
3,ASHOK KUMAR.V,Indiya Jananayaka Katchi,782,6,788,0.41,Tamil Nadu-Thalli
4,USHA.M,New Generation Peopleâ€™s Party,208,1,209,0.11,Tamil Nadu-Thalli
5,SEKAR.M.V,Amma Makkal Munnettra Kazagam,342,4,346,0.18,Tamil Nadu-Thalli
6,MARY SELVARANI.R,Naam Tamilar Katchi,3760,16,3776,1.95,Tamil Nadu-Thalli
7,RAVI.G,Samajwadi Party,162,0,162,0.08,Tamil Nadu-Thalli
8,JANAKI.G,Veerath Thiyagi Viswanathadoss Thozhilalarkal Katchi,137,1,138,0.07,Tamil Nadu-Thalli
9,KUMAR.M,Independent,419,3,422,0.22,Tamil Nadu-Thalli
10,DEVAPPA@DEVAGOWDA.Y,Independent,219,3,222,0.11,Tamil Nadu-Thalli
11,RAVI MUNISWAMY,Independent,352,1,353,0.18,Tamil Nadu-Thalli
12,VASANTHAMMA.N,Independent,582,2,584,0.3,Tamil Nadu-Thalli
13,NOTA,None of the Above,1963,3,1966,1.01,Tamil Nadu-Thalli
1,"ARIVUDAINAMBI, V.",All India Anna Dravida Munnetra Kazhagam,56173,450,56623,29.06,Tamil Nadu-Thanjavur
2,"DR.RAMANATHAN, P.",Desiya Murpokku Dravida Kazhagam,4190,56,4246,2.18,Tamil Nadu-Thanjavur
3,"KARIKALA CHOLAN, S.",Nationalist Congress Party,274,7,281,0.14,Tamil Nadu-Thanjavur
4,"NEELAMEGAM, T.K.G.",Dravida Munnetra Kazhagam,100786,2986,103772,53.25,Tamil Nadu-Thanjavur
5,"SUNDARAMOHAN, G.",Makkal Needhi Maiam,9600,81,9681,4.97,Tamil Nadu-Thanjavur
6,"SUBADEVI, R.",Naam Tamilar Katchi,17220,146,17366,8.91,Tamil Nadu-Thanjavur
7,"XAVIER, A.",People's Party of India(secular),214,3,217,0.11,Tamil Nadu-Thanjavur
8,"SANTHOSH, M.",Independent,119,3,122,0.06,Tamil Nadu-Thanjavur
9,"SABTHAGIRI, R.",Independent,100,1,101,0.05,Tamil Nadu-Thanjavur
10,"DINESH BABU, D.",Independent,141,1,142,0.07,Tamil Nadu-Thanjavur
11,"BHARATH, B.",Independent,105,5,110,0.06,Tamil Nadu-Thanjavur
12,"VASUKI, N.",Independent,256,4,260,0.13,Tamil Nadu-Thanjavur
13,NOTA,None of the Above,1915,23,1938,0.99,Tamil Nadu-Thanjavur
1,KALYANI.P.L,All India Anna Dravida Munnetra Kazhagam,26602,112,26714,19.98,Tamil Nadu-Thiru-Vi-Ka-Nagar
2,SIVAKUMAR.P,Dravida Munnetra Kazhagam,81283,444,81727,61.13,Tamil Nadu-Thiru-Vi-Ka-Nagar
3,SEKAR.M.P,Desiya Murpokku Dravida Kazhagam,1785,2,1787,1.34,Tamil Nadu-Thiru-Vi-Ka-Nagar
4,BAGAVATH SINGH.M,Bahujan Samaj Party,352,3,355,0.27,Tamil Nadu-Thiru-Vi-Ka-Nagar
5,ILLAVANJI.Dr.R,Naam Tamilar Katchi,10892,29,10921,8.17,Tamil Nadu-Thiru-Vi-Ka-Nagar
6,OBATH.S,Makkal Needhi Maiam,9670,40,9710,7.26,Tamil Nadu-Thiru-Vi-Ka-Nagar
7,PRABHAKARAN.K,Makkalatchi Katchi,78,1,79,0.06,Tamil Nadu-Thiru-Vi-Ka-Nagar
8,RAVIKUMAR.S,Republican Party of India  (Sivaraj),62,0,62,0.05,Tamil Nadu-Thiru-Vi-Ka-Nagar
9,RAVIPARAIYANAR.D,Republican Party of India (Athawale),41,0,41,0.03,Tamil Nadu-Thiru-Vi-Ka-Nagar
10,UDAYA CHANDRAN .R,Independent,76,1,77,0.06,Tamil Nadu-Thiru-Vi-Ka-Nagar
11,KALYANI.K,Independent,128,1,129,0.1,Tamil Nadu-Thiru-Vi-Ka-Nagar
12,KOLANJI.M,Independent,85,0,85,0.06,Tamil Nadu-Thiru-Vi-Ka-Nagar
13,GOVINDARAJ.G,Independent,33,0,33,0.02,Tamil Nadu-Thiru-Vi-Ka-Nagar
14,SANTHANU.S,Independent,38,0,38,0.03,Tamil Nadu-Thiru-Vi-Ka-Nagar
15,SIHAMANI.G,Independent,213,1,214,0.16,Tamil Nadu-Thiru-Vi-Ka-Nagar
16,SUNDAR.G,Independent,144,0,144,0.11,Tamil Nadu-Thiru-Vi-Ka-Nagar
17,SELVAKUMAR.A,Independent,136,0,136,0.1,Tamil Nadu-Thiru-Vi-Ka-Nagar
18,SEKAR.E,Independent,124,1,125,0.09,Tamil Nadu-Thiru-Vi-Ka-Nagar
19,PREMKUMAR.G,Independent,44,0,44,0.03,Tamil Nadu-Thiru-Vi-Ka-Nagar
20,BIRLABOSE.M,Independent,29,0,29,0.02,Tamil Nadu-Thiru-Vi-Ka-Nagar
21,MALATHI.S,Independent,57,0,57,0.04,Tamil Nadu-Thiru-Vi-Ka-Nagar
22,RANGANATHAN.M,Independent,37,0,37,0.03,Tamil Nadu-Thiru-Vi-Ka-Nagar
23,RAMESH BABU.M,Independent,105,1,106,0.08,Tamil Nadu-Thiru-Vi-Ka-Nagar
24,NOTA,None of the Above,1042,4,1046,0.78,Tamil Nadu-Thiru-Vi-Ka-Nagar
1,UDHAYAKUMAR R B,All India Anna Dravida Munnetra Kazhagam,99294,1044,100338,45.51,Tamil Nadu-Thirumangalam
2,MANIMARAN M,Dravida Munnetra Kazhagam,84381,1870,86251,39.12,Tamil Nadu-Thirumangalam
3,ATHI NARAYANAN K,Amma Makkal Munnettra Kazagam,13554,226,13780,6.25,Tamil Nadu-Thirumangalam
4,ARUMUGAM K,Lok Jan Shakti Party,119,3,122,0.06,Tamil Nadu-Thirumangalam
5,SARAL M,Naam Tamilar Katchi,11375,218,11593,5.26,Tamil Nadu-Thirumangalam
6,NIRMAL M,My India Party,119,3,122,0.06,Tamil Nadu-Thirumangalam
7,MARIKANNAN A,National Democratic Party of South India,95,3,98,0.04,Tamil Nadu-Thirumangalam
8,RAMKUMAR M,Makkal Needhi Maiam,2748,27,2775,1.26,Tamil Nadu-Thirumangalam
9,ALAGARSAMY M,Independent,71,0,71,0.03,Tamil Nadu-Thirumangalam
10,KALI A,Independent,44,1,45,0.02,Tamil Nadu-Thirumangalam
11,CHANDRASEKARAN R,Independent,42,2,44,0.02,Tamil Nadu-Thirumangalam
12,THIRALIPANDI N,Independent,78,4,82,0.04,Tamil Nadu-Thirumangalam
13,DURAIPANDI B,Independent,61,1,62,0.03,Tamil Nadu-Thirumangalam
14,BALAMURUGAN N R,Independent,129,2,131,0.06,Tamil Nadu-Thirumangalam
15,MUTHURAJA M,Independent,187,3,190,0.09,Tamil Nadu-Thirumangalam
16,MUTHUVELRAJ P,Independent,501,2,503,0.23,Tamil Nadu-Thirumangalam
17,RAMANATHAN A,Independent,683,1,684,0.31,Tamil Nadu-Thirumangalam
18,RAMANATHAN M,Independent,433,0,433,0.2,Tamil Nadu-Thirumangalam
19,RAMAMOORTHI R,Independent,163,2,165,0.07,Tamil Nadu-Thirumangalam
20,RAJANBABU P,Independent,276,2,278,0.13,Tamil Nadu-Thirumangalam
21,VEERANAN S,Independent,1566,10,1576,0.71,Tamil Nadu-Thirumangalam
22,VEERAMANI V,Independent,41,1,42,0.02,Tamil Nadu-Thirumangalam
23,VAIRASEEMAN G,Independent,64,0,64,0.03,Tamil Nadu-Thirumangalam
24,JEGADEESH KUMAR R,Independent,74,1,75,0.03,Tamil Nadu-Thirumangalam
25,NOTA,None of the Above,958,13,971,0.44,Tamil Nadu-Thirumangalam
1,S.REGUPATHY,Dravida Munnetra Kazhagam,70594,755,71349,41,Tamil Nadu-Thirumayam
2,P.K.VAIRAMUTHU,All India Anna Dravida Munnetra Kazhagam,69595,372,69967,40.2,Tamil Nadu-Thirumayam
3,S. GANDIPAN,My India Party,554,0,554,0.32,Tamil Nadu-Thirumayam
4,R.SIVAKUMAR,Puthiya Tamilagam,236,2,238,0.14,Tamil Nadu-Thirumayam
5,U.SIVARAMAN,Naam Tamilar Katchi,11019,42,11061,6.36,Tamil Nadu-Thirumayam
6,R.THIRUMENI,Makkal Needhi Maiam,1350,6,1356,0.78,Tamil Nadu-Thirumayam
7,S.PURACHIBALAN,Anna Dravidar Kazhagam,74,0,74,0.04,Tamil Nadu-Thirumayam
8,S.MUNIARAJU,Amma Makkal Munnettra Kazagam,1485,18,1503,0.86,Tamil Nadu-Thirumayam
9,C. ALAGU SUBBIAH,Independent,408,4,412,0.24,Tamil Nadu-Thirumayam
10,M.KARTHICK,Independent,65,0,65,0.04,Tamil Nadu-Thirumayam
11,R.SUNDARAM,Independent,69,1,70,0.04,Tamil Nadu-Thirumayam
12,K.SELVAKUMAR,Independent,54,0,54,0.03,Tamil Nadu-Thirumayam
13,M.SELVAKUMAR,Independent,87,0,87,0.05,Tamil Nadu-Thirumayam
14,S.SELVAKUMAR,Independent,109,0,109,0.06,Tamil Nadu-Thirumayam
15,M.SELVAKUMAR,Independent,315,0,315,0.18,Tamil Nadu-Thirumayam
16,K.SELVAKUMAR,Independent,15111,33,15144,8.7,Tamil Nadu-Thirumayam
17,M.SELVAKUMAR,Independent,456,0,456,0.26,Tamil Nadu-Thirumayam
18,M. DURAIRAJAN,Independent,365,0,365,0.21,Tamil Nadu-Thirumayam
19,R. PALANIYAPPAN,Independent,92,0,92,0.05,Tamil Nadu-Thirumayam
20,S.MANIKANDAN,Independent,66,0,66,0.04,Tamil Nadu-Thirumayam
21,AL.MATHIALAGAN,Independent,51,0,51,0.03,Tamil Nadu-Thirumayam
22,MUTHUADAIKKAN @ ADAIKKALAM,Independent,73,1,74,0.04,Tamil Nadu-Thirumayam
23,NOTA,None of the Above,568,1,569,0.33,Tamil Nadu-Thirumayam
1,PONNUTHAI,Communist Party of India  (Marxist),73032,1162,74194,31.46,Tamil Nadu-Thiruparankundram
2,"RAJANCHELLAPPA, V.V.",All India Anna Dravida Munnetra Kazhagam,103059,624,103683,43.96,Tamil Nadu-Thiruparankundram
3,"SAVITHA, R.",Anna MGR Dravida Makkal Kalgam,591,1,592,0.25,Tamil Nadu-Thiruparankundram
4,"DAVID ANNADURAI, K.",Amma Makkal Munnettra Kazagam,10120,70,10190,4.32,Tamil Nadu-Thiruparankundram
5,"BHARANIRAJAN, M.",Makkal Needhi Maiam,16662,88,16750,7.1,Tamil Nadu-Thiruparankundram
6,"PALANIKUMAR, M.",Ambedkar Political Party,173,4,177,0.08,Tamil Nadu-Thiruparankundram
7,"MURUGESAN, A.",My India Party,131,0,131,0.06,Tamil Nadu-Thiruparankundram
8,"RAJAMANI, V.",Namadhu Makkal Katchi,537,1,538,0.23,Tamil Nadu-Thiruparankundram
9,"REVATHY, R.",Naam Tamilar Katchi,22582,140,22722,9.63,Tamil Nadu-Thiruparankundram
10,"ARUMUGAM, V.",Independent,2002,3,2005,0.85,Tamil Nadu-Thiruparankundram
11,"ILANGOVAN, P.",Independent,114,0,114,0.05,Tamil Nadu-Thiruparankundram
12,"UKKRA PANDIYAN, S.",Independent,301,1,302,0.13,Tamil Nadu-Thiruparankundram
13,"KARUNAKARAN, M.",Independent,246,0,246,0.1,Tamil Nadu-Thiruparankundram
14,"SANKAR THAYAL SHARMA, M.",Independent,80,0,80,0.03,Tamil Nadu-Thiruparankundram
15,"SEKAR, S.",Independent,200,0,200,0.08,Tamil Nadu-Thiruparankundram
16,"PACKIYASELVI, K.",Independent,401,1,402,0.17,Tamil Nadu-Thiruparankundram
17,"BALAMURUGAN, R.",Independent,256,1,257,0.11,Tamil Nadu-Thiruparankundram
18,"PILLAI, M.M.",Independent,283,1,284,0.12,Tamil Nadu-Thiruparankundram
19,"MANIKANDAN, S.",Independent,81,1,82,0.03,Tamil Nadu-Thiruparankundram
20,"MOHIDEEN ABDUL KADAR, M.K.",Independent,98,0,98,0.04,Tamil Nadu-Thiruparankundram
21,"MURUGAN, K.R.",Independent,555,7,562,0.24,Tamil Nadu-Thiruparankundram
22,"RADHA (A) GUNASEKARAN, M.",Independent,114,0,114,0.05,Tamil Nadu-Thiruparankundram
23,"RAMACHANDRAN, K.",Independent,52,1,53,0.02,Tamil Nadu-Thiruparankundram
24,NOTA,None of the Above,2039,34,2073,0.88,Tamil Nadu-Thiruparankundram
1,V.K.Pakkiri Ambadkar,Bahujan Samaj Party,1129,6,1135,0.5,Tamil Nadu-Thiruporur
2,Arumugam.K,Pattali Makkal Katchi,91388,619,92007,40.58,Tamil Nadu-Thiruporur
3,Kothandapani.M,Amma Makkal Munnettra Kazagam,7629,33,7662,3.38,Tamil Nadu-Thiruporur
4,S.S.Balaji,Viduthalai Chiruthaigal Katchi,92987,967,93954,41.44,Tamil Nadu-Thiruporur
5,Mohana Sundari.S,Naam Tamilar Katchi,20354,74,20428,9.01,Tamil Nadu-Thiruporur
6,Lavanya.N,Makkal Needhi Maiam,8125,69,8194,3.61,Tamil Nadu-Thiruporur
7,U.Akbar Bhasha,Independent,267,1,268,0.12,Tamil Nadu-Thiruporur
8,M.Duraisamy,Independent,190,3,193,0.09,Tamil Nadu-Thiruporur
9,S.Nataraj,Independent,268,3,271,0.12,Tamil Nadu-Thiruporur
10,D.Ravi,Independent,266,2,268,0.12,Tamil Nadu-Thiruporur
11,A.Joshva,Independent,367,0,367,0.16,Tamil Nadu-Thiruporur
12,NOTA,None of the Above,1971,11,1982,0.87,Tamil Nadu-Thiruporur
1,SURESH KUMAR C,All India Anna Dravida Munnetra Kazhagam,66683,341,67024,36.06,Tamil Nadu-Thiruthuraipoondi
2,MARIMUTHU K,Communist Party of India,95785,1307,97092,52.23,Tamil Nadu-Thiruthuraipoondi
3,AARTHI A,Naam Tamilar Katchi,15300,62,15362,8.26,Tamil Nadu-Thiruthuraipoondi
4,PARIVENTHAN D,All India Samathuva Makhal Katchi,313,2,315,0.17,Tamil Nadu-Thiruthuraipoondi
5,RAJANIKANTH S,Amma Makkal Munnettra Kazagam,3536,19,3555,1.91,Tamil Nadu-Thiruthuraipoondi
6,SIVAPRAKASAM V,Independent,128,1,129,0.07,Tamil Nadu-Thiruthuraipoondi
7,SURESH A K,Independent,184,6,190,0.1,Tamil Nadu-Thiruthuraipoondi
8,SENGUTTUVAN M,Independent,133,3,136,0.07,Tamil Nadu-Thiruthuraipoondi
9,THIRUVARUL SELVI V,Independent,138,1,139,0.07,Tamil Nadu-Thiruthuraipoondi
10,THULASIRAMAN R,Independent,155,0,155,0.08,Tamil Nadu-Thiruthuraipoondi
11,PARAMASIVAM K,Independent,476,0,476,0.26,Tamil Nadu-Thiruthuraipoondi
12,NOTA,None of the Above,1310,3,1313,0.71,Tamil Nadu-Thiruthuraipoondi
1,ASWIN,Bahujan Samaj Party,530,0,530,0.25,Tamil Nadu-Thiruvaiyaru
2,DURAI.CHANDRASEKARAN,Dravida Munnetra Kazhagam,101959,1251,103210,48.82,Tamil Nadu-Thiruvaiyaru
3,"VENKATESAN, S.",Bharatiya Janata Party,49284,276,49560,23.44,Tamil Nadu-Thiruvaiyaru
4,"UTHIRAPATHI, G.",Puthiya Tamilagam,1197,18,1215,0.57,Tamil Nadu-Thiruvaiyaru
5,"KARTHIKEYAN, V.",Amma Makkal Munnettra Kazagam,37310,159,37469,17.72,Tamil Nadu-Thiruvaiyaru
6,"SIVARAMAN, T.","Makkal Sananayaga Kudiyarasu Katchi,",236,0,236,0.11,Tamil Nadu-Thiruvaiyaru
7,"SENTHILNATHAN, D.",Naam Tamilar Katchi,15727,93,15820,7.48,Tamil Nadu-Thiruvaiyaru
8,"BACKIYARAJ, V.",Anaithu Makkal Arasiyal Katchi,252,0,252,0.12,Tamil Nadu-Thiruvaiyaru
9,"VIJAYAKUMAR, S.",Anna Puratchi Thalaivar Amma Dravida Munnetra Kazhagam,255,2,257,0.12,Tamil Nadu-Thiruvaiyaru
10,"SINGARAVADIVEL, S.",Independent,238,2,240,0.11,Tamil Nadu-Thiruvaiyaru
11,"THIRUMARAN, P.S.",Independent,1089,4,1093,0.52,Tamil Nadu-Thiruvaiyaru
12,"RAJKUMAR, R.",Independent,367,1,368,0.17,Tamil Nadu-Thiruvaiyaru
13,NOTA,None of the Above,1173,7,1180,0.56,Tamil Nadu-Thiruvaiyaru
1,"RAAJENDRAN, V.G.",Dravida Munnetra Kazhagam,106316,1393,107709,50.27,Tamil Nadu-Thiruvallur
2,"DOSS, D.",Bahujan Samaj Party,2314,15,2329,1.09,Tamil Nadu-Thiruvallur
3,"RAMANAH, BE VEE",All India Anna Dravida Munnetra Kazhagam,84508,500,85008,39.68,Tamil Nadu-Thiruvallur
4,"GURU, N.",Amma Makkal Munnettra Kazagam,1072,5,1077,0.5,Tamil Nadu-Thiruvallur
5,"PASUPATHY, P.",Naam Tamilar Katchi,14943,85,15028,7.01,Tamil Nadu-Thiruvallur
6,"KUMAR, E.",Independent,132,1,133,0.06,Tamil Nadu-Thiruvallur
7,"SASIKUMAR, J.",Independent,87,0,87,0.04,Tamil Nadu-Thiruvallur
8,"BALA KRISHNAN, N.",Independent,232,0,232,0.11,Tamil Nadu-Thiruvallur
9,"RAMANAN, R.",Independent,97,0,97,0.05,Tamil Nadu-Thiruvallur
10,"RAJENDIRAN, G.",Independent,385,3,388,0.18,Tamil Nadu-Thiruvallur
11,"REVATHI, R.",Independent,281,2,283,0.13,Tamil Nadu-Thiruvallur
12,NOTA,None of the Above,1857,15,1872,0.87,Tamil Nadu-Thiruvallur
1,KALAIVANAN  POONDI  K.,Dravida Munnetra Kazhagam,107540,1366,108906,52.29,Tamil Nadu-Thiruvarur
2,GOMATHI A.,Bahujan Samaj Party,716,4,720,0.35,Tamil Nadu-Thiruvarur
3,PANNERSELVAM A.N.R.,All India Anna Dravida Munnetra Kazhagam,57439,293,57732,27.72,Tamil Nadu-Thiruvarur
4,KABILARASAN  P.,Makkal Needhi Maiam,4034,34,4068,1.95,Tamil Nadu-Thiruvarur
5,THIYAGASUNDARAM N.,Tamil Nadu Ilangyar Katchi,1000,8,1008,0.48,Tamil Nadu-Thiruvarur
6,THIYAGARAJAN  M.,Puthiya Tamilagam,285,8,293,0.14,Tamil Nadu-Thiruvarur
7,NASEEMA BANU M.A.,SOCIAL DEMOCRATIC PARTY OF INDIA,6348,16,6364,3.06,Tamil Nadu-Thiruvarur
8,VINOTHINI R.,Naam Tamilar Katchi,26211,89,26300,12.63,Tamil Nadu-Thiruvarur
9,AMANULLAH R.S.A.,Independent,163,0,163,0.08,Tamil Nadu-Thiruvarur
10,ANBAZHAGAN T.,Independent,101,2,103,0.05,Tamil Nadu-Thiruvarur
11,PANNEERSELVAM J.,Independent,530,1,531,0.25,Tamil Nadu-Thiruvarur
12,MOHAMED HALITH A.,Independent,247,0,247,0.12,Tamil Nadu-Thiruvarur
13,MUTHARASAN S.,Independent,200,2,202,0.1,Tamil Nadu-Thiruvarur
14,NOTA,None of the Above,1646,7,1653,0.79,Tamil Nadu-Thiruvarur
1,ANBIL MAHESH POYYAMOZHI,Dravida Munnetra Kazhagam,103673,1751,105424,53.51,Tamil Nadu-Thiruverumbur
2,P KUMAR,All India Anna Dravida Munnetra Kazhagam,55309,418,55727,28.29,Tamil Nadu-Thiruverumbur
3,S.  SENTHILKUMAR,Desiya Murpokku Dravida Kazhagam,2260,33,2293,1.16,Tamil Nadu-Thiruverumbur
4,MALATHI RAVICHANDRAN,Bahujan Samaj Party,225,1,226,0.11,Tamil Nadu-Thiruverumbur
5,K.M. KARTHIK,Tamil Nadu Ilangyar Katchi,408,5,413,0.21,Tamil Nadu-Thiruverumbur
6,S.SAKTHIVEL,New Generation Peopleâ€™s Party,414,2,416,0.21,Tamil Nadu-Thiruverumbur
7,V CHOLASOORAN,Naam Tamilar Katchi,15628,91,15719,7.98,Tamil Nadu-Thiruverumbur
8,K. PALANISAMY,Veerath Thiyagi Viswanathadoss Thozhilalarkal Katchi,122,1,123,0.06,Tamil Nadu-Thiruverumbur
9,MURUGANANDAM M,Makkal Needhi Maiam,14547,131,14678,7.45,Tamil Nadu-Thiruverumbur
10,S CHARLES,Independent,68,3,71,0.04,Tamil Nadu-Thiruverumbur
11,R. PRIYA,Independent,72,0,72,0.04,Tamil Nadu-Thiruverumbur
12,N. MUNIYANDI,Independent,52,2,54,0.03,Tamil Nadu-Thiruverumbur
13,A. RAJA MOHAMED,Independent,67,0,67,0.03,Tamil Nadu-Thiruverumbur
14,N. RAJU,Independent,88,0,88,0.04,Tamil Nadu-Thiruverumbur
15,JESTIN RAJA,Independent,222,2,224,0.11,Tamil Nadu-Thiruverumbur
16,NOTA,None of the Above,1403,15,1418,0.72,Tamil Nadu-Thiruverumbur
1,"CHEZHIAAN,  GOVI.",Dravida Munnetra Kazhagam,94602,1161,95763,48.26,Tamil Nadu-Thiruvidaimarudur
2,"PURATCHI MANI, M.",Bahujan Samaj Party,1825,14,1839,0.93,Tamil Nadu-Thiruvidaimarudur
3,"UNION VEERAMANI, S.",All India Anna Dravida Munnetra Kazhagam,84703,380,85083,42.87,Tamil Nadu-Thiruvidaimarudur
4,"KANNAIYAN, T.",Communist Party of India  (Marxist-Leninist)  (Liberation),574,2,576,0.29,Tamil Nadu-Thiruvidaimarudur
5,"KUDANTHAI ARASAN, J.",Amma Makkal Munnettra Kazagam,1736,10,1746,0.88,Tamil Nadu-Thiruvidaimarudur
6,"SURESH, R.",Anaithu Makkal Puratchi Katchi,78,0,78,0.04,Tamil Nadu-Thiruvidaimarudur
7,"DIVYA BHARATHI, M.",Naam Tamilar Katchi,11147,29,11176,5.63,Tamil Nadu-Thiruvidaimarudur
8,"MADHANKUMAR, R.",Indiya Jananayaka Katchi,222,4,226,0.11,Tamil Nadu-Thiruvidaimarudur
9,"KANNAIYAN, N.",Independent,62,6,68,0.03,Tamil Nadu-Thiruvidaimarudur
10,"DHANASEKAR, V.",Independent,38,0,38,0.02,Tamil Nadu-Thiruvidaimarudur
11,"NEDUMARAN, S.",Independent,66,2,68,0.03,Tamil Nadu-Thiruvidaimarudur
12,"MATHI, M.",Independent,102,0,102,0.05,Tamil Nadu-Thiruvidaimarudur
13,"MARIMUTHU, G.",Independent,245,0,245,0.12,Tamil Nadu-Thiruvidaimarudur
14,"MARIYAPPAN, N.",Independent,198,0,198,0.1,Tamil Nadu-Thiruvidaimarudur
15,NOTA,None of the Above,1233,7,1240,0.62,Tamil Nadu-Thiruvidaimarudur
1,K.KUPPAN,All India Anna Dravida Munnetra Kazhagam,50435,89,50524,25.26,Tamil Nadu-Thiruvottiyur
2,M.KOTTESWARAN,Bahujan Samaj Party,367,0,367,0.18,Tamil Nadu-Thiruvottiyur
3,K.P.SHANKAR,Dravida Munnetra Kazhagam,87703,482,88185,44.09,Tamil Nadu-Thiruvottiyur
4,R.EGAVALLI,Naadaalum Makkal Katchi,253,0,253,0.13,Tamil Nadu-Thiruvottiyur
5,D.SASIRAJ,Samata Party,291,0,291,0.15,Tamil Nadu-Thiruvottiyur
6,SEEMAN,Naam Tamilar Katchi,48497,100,48597,24.3,Tamil Nadu-Thiruvottiyur
7,M.SOUNDARA PANDIAN,Amma Makkal Munnettra Kazagam,1413,4,1417,0.71,Tamil Nadu-Thiruvottiyur
8,D.MOHAN,Makkal Needhi Maiam,7025,28,7053,3.53,Tamil Nadu-Thiruvottiyur
9,K.GOPINATH,Independent,96,0,96,0.05,Tamil Nadu-Thiruvottiyur
10,V.SURESHBALAJI,Independent,29,0,29,0.01,Tamil Nadu-Thiruvottiyur
11,M.CHELLAM,Independent,184,0,184,0.09,Tamil Nadu-Thiruvottiyur
12,D.THAMIZHIZHAN,Independent,103,0,103,0.05,Tamil Nadu-Thiruvottiyur
13,B.DHANASEKARAN,Independent,88,0,88,0.04,Tamil Nadu-Thiruvottiyur
14,C.DHANRAJ,Independent,115,0,115,0.06,Tamil Nadu-Thiruvottiyur
15,PRAVINA,Independent,52,0,52,0.03,Tamil Nadu-Thiruvottiyur
16,M.A.MICHAEL RAJ,Independent,601,2,603,0.3,Tamil Nadu-Thiruvottiyur
17,N.RAMESH KUMAR,Independent,584,1,585,0.29,Tamil Nadu-Thiruvottiyur
18,N.RAJESH KUMAR,Independent,48,0,48,0.02,Tamil Nadu-Thiruvottiyur
19,U.VENKATESH,Independent,224,0,224,0.11,Tamil Nadu-Thiruvottiyur
20,B.ZAKIR HUSSAIN,Independent,71,0,71,0.04,Tamil Nadu-Thiruvottiyur
21,NOTA,None of the Above,1106,5,1111,0.56,Tamil Nadu-Thiruvottiyur
1,KARUNANITHI J,Dravida Munnetra Kazhagam,55465,570,56035,40.57,Tamil Nadu-Thiyagarayanagar
2,SATHIYANAARAYANAN B,All India Anna Dravida Munnetra Kazhagam,55006,892,55898,40.47,Tamil Nadu-Thiyagarayanagar
3,JOHNSON R,Bahujan Samaj Party,259,10,269,0.19,Tamil Nadu-Thiyagarayanagar
4,ELLAPPAN A.K.D,Mahathma Makkal Munnetra Kazhakam,50,2,52,0.04,Tamil Nadu-Thiyagarayanagar
5,KARUPPIAH PALA,Makkal Needhi Maiam,14473,94,14567,10.55,Tamil Nadu-Thiyagarayanagar
6,SIVASANKARI S,Naam Tamilar Katchi,8259,25,8284,6,Tamil Nadu-Thiyagarayanagar
7,DHANASEKARAN R,Desiya Makkal Sakthi Katchi,72,2,74,0.05,Tamil Nadu-Thiyagarayanagar
8,DHANUSH M,United States of India Party,109,0,109,0.08,Tamil Nadu-Thiyagarayanagar
9,THIRUNAVUKKARASU V,Makkalatchi Katchi,33,2,35,0.03,Tamil Nadu-Thiyagarayanagar
10,BHARANEESWARAN R,Amma Makkal Munnettra Kazagam,774,8,782,0.57,Tamil Nadu-Thiyagarayanagar
11,VETRI SELVI,Anaithu Makkal Arasiyal Katchi,79,9,88,0.06,Tamil Nadu-Thiyagarayanagar
12,KANNAN S,Independent,86,2,88,0.06,Tamil Nadu-Thiyagarayanagar
13,PALAYAN R,Independent,124,0,124,0.09,Tamil Nadu-Thiyagarayanagar
14,RAJASEKARAN D,Independent,92,0,92,0.07,Tamil Nadu-Thiyagarayanagar
15,NOTA,None of the Above,1597,20,1617,1.17,Tamil Nadu-Thiyagarayanagar
1,KARTHIKEYA,Dravida Munnetra Kazhagam,81829,766,82595,35.83,Tamil Nadu-Thondamuthur
2,S.P. VELUMANI,All India Anna Dravida Munnetra Kazhagam,123538,687,124225,53.89,Tamil Nadu-Thondamuthur
3,S. KALAIARASI,Naam Tamilar Katchi,8014,28,8042,3.49,Tamil Nadu-Thondamuthur
4,R.SATHISHKUMAR,Amma Makkal Munnettra Kazagam,1229,6,1235,0.54,Tamil Nadu-Thondamuthur
5,M. BADRAN,Ganasangam Party of India,136,0,136,0.06,Tamil Nadu-Thondamuthur
6,S. SHAJAHAN,Makkal Needhi Maiam,11572,34,11606,5.03,Tamil Nadu-Thondamuthur
7,A. ABDUL GAFOOR,Independent,141,1,142,0.06,Tamil Nadu-Thondamuthur
8,CC SELVAMOHAN,Independent,173,2,175,0.08,Tamil Nadu-Thondamuthur
9,A. MANSOOR ALI KHAN,Independent,426,2,428,0.19,Tamil Nadu-Thondamuthur
10,J.JOHN EDWARD VISUVASAM,Independent,311,1,312,0.14,Tamil Nadu-Thondamuthur
11,NOTA,None of the Above,1622,13,1635,0.71,Tamil Nadu-Thondamuthur
1,A.Ashok Kumar,Bahujan Samaj Party,432,4,436,0.23,Tamil Nadu-Thoothukkudi
2,P.Geetha Jeevan,Dravida Munnetra Kazhagam,90206,2108,92314,49,Tamil Nadu-Thoothukkudi
3,U.Chandran,Desiya Murpokku Dravida Kazhagam,4011,29,4040,2.14,Tamil Nadu-Thoothukkudi
4,SDR Vijayaseelan,All India Anna Dravida Munnetra Kazhagam,41621,383,42004,22.29,Tamil Nadu-Thoothukkudi
5,N.Sundar,Makkal Needhi Maiam,10475,59,10534,5.59,Tamil Nadu-Thoothukkudi
6,S.Subash,Republican Party of India (Athawale),159,2,161,0.09,Tamil Nadu-Thoothukkudi
7,K.Subramani,Shiv Sena,124,0,124,0.07,Tamil Nadu-Thoothukkudi
8,G.Selvavinayagam,Veerath Thiyagi Viswanathadoss Thozhilalarkal Katchi,268,1,269,0.14,Tamil Nadu-Thoothukkudi
9,N.Balasubramanian,Anna Puratchi Thalaivar Amma Dravida Munnetra Kazhagam,126,1,127,0.07,Tamil Nadu-Thoothukkudi
10,Mannar Maharajan,Bahujan Dravida Party,93,0,93,0.05,Tamil Nadu-Thoothukkudi
11,S.V.Rajasekar,United States of India Party,914,1,915,0.49,Tamil Nadu-Thoothukkudi
12,V.Velraj,Naam Tamilar Katchi,30747,190,30937,16.42,Tamil Nadu-Thoothukkudi
13,J.Arun Nehruraj,Independent,142,0,142,0.08,Tamil Nadu-Thoothukkudi
14,J.Alldrin Airmarshal Thayaram,Independent,166,1,167,0.09,Tamil Nadu-Thoothukkudi
15,C.Ganesh Ayyadurai,Independent,115,1,116,0.06,Tamil Nadu-Thoothukkudi
16,S.Krishnan,Independent,182,0,182,0.1,Tamil Nadu-Thoothukkudi
17,J.samuvel,Independent,138,0,138,0.07,Tamil Nadu-Thoothukkudi
18,J.Sivaneswaran,Independent,2849,17,2866,1.52,Tamil Nadu-Thoothukkudi
19,G.Selvam,Independent,75,0,75,0.04,Tamil Nadu-Thoothukkudi
20,S.Balasundram,Independent,87,0,87,0.05,Tamil Nadu-Thoothukkudi
21,L.Maria Deva Sahaya Johny,Independent,442,4,446,0.24,Tamil Nadu-Thoothukkudi
22,A.Mohamed Imran Arabi,Independent,60,2,62,0.03,Tamil Nadu-Thoothukkudi
23,Ramagunaseelan,Independent,88,0,88,0.05,Tamil Nadu-Thoothukkudi
24,A.Rajavel,Independent,278,4,282,0.15,Tamil Nadu-Thoothukkudi
25,M.Lingaraja,Independent,70,0,70,0.04,Tamil Nadu-Thoothukkudi
26,A.Jeyalalitha,Independent,162,1,163,0.09,Tamil Nadu-Thoothukkudi
27,NOTA,None of the Above,1539,30,1569,0.83,Tamil Nadu-Thoothukkudi
1,EZHILAN N,Dravida Munnetra Kazhagam,71437,430,71867,52.87,Tamil Nadu-Thousand Lights
2,KUSHBOO SUNDAR,Bharatiya Janata Party,39237,168,39405,28.99,Tamil Nadu-Thousand Lights
3,WILLIAMS D,Bahujan Samaj Party,245,1,246,0.18,Tamil Nadu-Thousand Lights
4,K M SHARIFF,Makkal Needhi Maiam,11769,22,11791,8.67,Tamil Nadu-Thousand Lights
5,DOMNIC A,Nam India Naam Indiyar Katchi,72,0,72,0.05,Tamil Nadu-Thousand Lights
6,RIAZ(A) SYED ZAKEERULLA,Anaithu Makkal Arasiyal Katchi,52,0,52,0.04,Tamil Nadu-Thousand Lights
7,VAIDHYANATHAN N,Amma Makkal Munnettra Kazagam,1145,10,1155,0.85,Tamil Nadu-Thousand Lights
8,SHERINE AJ,Naam Tamilar Katchi,8860,24,8884,6.54,Tamil Nadu-Thousand Lights
9,SANJEEVI S,Independent,66,0,66,0.05,Tamil Nadu-Thousand Lights
10,SUDAKAR R,Independent,63,3,66,0.05,Tamil Nadu-Thousand Lights
11,SEKAR K,Independent,30,1,31,0.02,Tamil Nadu-Thousand Lights
12,DEEBAN M,Independent,37,0,37,0.03,Tamil Nadu-Thousand Lights
13,NIRMAL KUMAR S,Independent,53,0,53,0.04,Tamil Nadu-Thousand Lights
14,P PARIMALA,Independent,47,0,47,0.03,Tamil Nadu-Thousand Lights
15,BABU A,Independent,65,0,65,0.05,Tamil Nadu-Thousand Lights
16,PARTHIBAN V,Independent,154,0,154,0.11,Tamil Nadu-Thousand Lights
17,MANIVANNAN N,Independent,229,0,229,0.17,Tamil Nadu-Thousand Lights
18,RADHA KRISHNAN S,Independent,230,1,231,0.17,Tamil Nadu-Thousand Lights
19,VELRAJ S,Independent,41,1,42,0.03,Tamil Nadu-Thousand Lights
20,A GEORGE BENNY,Independent,62,0,62,0.05,Tamil Nadu-Thousand Lights
21,NOTA,None of the Above,1381,4,1385,1.02,Tamil Nadu-Thousand Lights
1,T.INDRAGANDHI,All India Anna Dravida Munnetra Kazhagam,65257,458,65715,37.36,Tamil Nadu-Thuraiyur
2,S.ESWARAMOORTHY,Bahujan Samaj Party,865,2,867,0.49,Tamil Nadu-Thuraiyur
3,S.STALINKUMAR,Dravida Munnetra Kazhagam,85802,1984,87786,49.91,Tamil Nadu-Thuraiyur
4,K.GUNASEKARAN,Puthiya Tamilagam,539,2,541,0.31,Tamil Nadu-Thuraiyur
5,K.SUBRAMANIAN,Amma Makkal Munnettra Kazagam,2404,31,2435,1.38,Tamil Nadu-Thuraiyur
6,R.TAMILZHSELVI,Naam Tamilar Katchi,13074,84,13158,7.48,Tamil Nadu-Thuraiyur
7,M.MALARMANNAN,Samaniya Makkal Nala Katchi,100,0,100,0.06,Tamil Nadu-Thuraiyur
8,T.N. YUVARAJAN,Makkal Needhi Maiam,2489,39,2528,1.44,Tamil Nadu-Thuraiyur
9,K.JAYAKKANNAN,Tamizhaga Murpokku Makkal Katchi,164,2,166,0.09,Tamil Nadu-Thuraiyur
10,S.KARUPPIAH,Independent,314,6,320,0.18,Tamil Nadu-Thuraiyur
11,A.SEERANGAN,Independent,119,0,119,0.07,Tamil Nadu-Thuraiyur
12,SRINIVASAN J,Independent,316,1,317,0.18,Tamil Nadu-Thuraiyur
13,K.SUNDARRAJ,Independent,230,0,230,0.13,Tamil Nadu-Thuraiyur
14,NOTA,None of the Above,1580,14,1594,0.91,Tamil Nadu-Thuraiyur
1,ARJUNAN P,All India Anna Dravida Munnetra Kazhagam,86155,997,87152,47.74,Tamil Nadu-Tindivanam
2,GOVINDASAMY A,Bahujan Samaj Party,599,4,603,0.33,Tamil Nadu-Tindivanam
3,CHANDRALEKHA K,Desiya Murpokku Dravida Kazhagam,2678,23,2701,1.48,Tamil Nadu-Tindivanam
4,SEETHAPATHY P,Dravida Munnetra Kazhagam,76038,1361,77399,42.4,Tamil Nadu-Tindivanam
5,ILAVARASAN K,Anna Dravidar Kazhagam,424,0,424,0.23,Tamil Nadu-Tindivanam
6,SETTU M,Desiya Sirupanmayinar Makkal Iyakkam,247,0,247,0.14,Tamil Nadu-Tindivanam
7,PACHIMUTHU P,Naam Tamilar Katchi,9162,41,9203,5.04,Tamil Nadu-Tindivanam
8,POYATHU @ ANBIN POYYAMOZHI S,Makkal Needhi Maiam,2068,11,2079,1.14,Tamil Nadu-Tindivanam
9,MOHAN A,MAKKAL SAKTHI KATCHI,108,4,112,0.06,Tamil Nadu-Tindivanam
10,VISWANATHAN S A,All  India  Pattali  Munnetra Katchi,148,0,148,0.08,Tamil Nadu-Tindivanam
11,ARULMARAN J,Independent,120,2,122,0.07,Tamil Nadu-Tindivanam
12,GOKULAKRISHNAN M,Independent,132,9,141,0.08,Tamil Nadu-Tindivanam
13,THAMBIRAJ A,Independent,378,1,379,0.21,Tamil Nadu-Tindivanam
14,VINOTH S,Independent,110,0,110,0.06,Tamil Nadu-Tindivanam
15,VETRIVENDHAN S,Independent,195,0,195,0.11,Tamil Nadu-Tindivanam
16,NOTA,None of the Above,1514,9,1523,0.83,Tamil Nadu-Tindivanam
1,Anitha R. Radhakrishnan,Dravida Munnetra Kazhagam,86162,2112,88274,50.58,Tamil Nadu-Tiruchendur
2,Radhakrishnan M,All India Anna Dravida Munnetra Kazhagam,62420,591,63011,36.1,Tamil Nadu-Tiruchendur
3,Gloriyan S,Naam Tamilar Katchi,14963,100,15063,8.63,Tamil Nadu-Tiruchendur
4,Kennady Babu K,Veerath Thiyagi Viswanathadoss Thozhilalarkal Katchi,128,1,129,0.07,Tamil Nadu-Tiruchendur
5,Rooswelt X,Naam Indiar Party,238,1,239,0.14,Tamil Nadu-Tiruchendur
6,Vadamalaipandian S,Amma Makkal Munnettra Kazagam,3730,36,3766,2.16,Tamil Nadu-Tiruchendur
7,Jayanthi M,Makkal Needhi Maiam,1949,16,1965,1.13,Tamil Nadu-Tiruchendur
8,Arumugam S,Independent,107,1,108,0.06,Tamil Nadu-Tiruchendur
9,Essakki Muthu,Independent,58,2,60,0.03,Tamil Nadu-Tiruchendur
10,Kalyanasundaram R,Independent,90,2,92,0.05,Tamil Nadu-Tiruchendur
11,Senthilkumar S,Independent,177,0,177,0.1,Tamil Nadu-Tiruchendur
12,Shaik Abdul Kader P.S.J,Independent,136,0,136,0.08,Tamil Nadu-Tiruchendur
13,Baskar C,Independent,195,1,196,0.11,Tamil Nadu-Tiruchendur
14,Perumal K,Independent,73,0,73,0.04,Tamil Nadu-Tiruchendur
15,Pon Rathna Selvan S,Independent,195,1,196,0.11,Tamil Nadu-Tiruchendur
16,NOTA,None of the Above,1040,11,1051,0.6,Tamil Nadu-Tiruchendur
1,ESWARAN E R,Dravida Munnetra Kazhagam,79934,1754,81688,44.23,Tamil Nadu-Tiruchengodu
2,SARASWATHI PON,All India Anna Dravida Munnetra Kazhagam,78010,816,78826,42.69,Tamil Nadu-Tiruchengodu
3,KALAIVANAN A,My India Party,510,5,515,0.28,Tamil Nadu-Tiruchengodu
4,SIVAKUMAR K,Tamilaga Makkal Thannurimai Katchi,203,1,204,0.11,Tamil Nadu-Tiruchengodu
5,CHINNATHAMBI K,Republican Party of India (Athawale),75,0,75,0.04,Tamil Nadu-Tiruchengodu
6,SENGOTTUVELLU N,Ahimsa Socialist Party,353,5,358,0.19,Tamil Nadu-Tiruchengodu
7,NATARAJAN P,Naam Tamilar Katchi,13857,110,13967,7.56,Tamil Nadu-Tiruchengodu
8,YUVARAJKUMAR K,Namathu Kongu Munnetra Kalagam,100,0,100,0.05,Tamil Nadu-Tiruchengodu
9,JANAGARAJ R,Makkal Needhi Maiam,3695,29,3724,2.02,Tamil Nadu-Tiruchengodu
10,HEMALATHA R,Amma Makkal Munnettra Kazagam,446,3,449,0.24,Tamil Nadu-Tiruchengodu
11,ESWARAN A,Independent,52,0,52,0.03,Tamil Nadu-Tiruchengodu
12,ESWARAN K,Independent,57,4,61,0.03,Tamil Nadu-Tiruchengodu
13,ESWARAN G,Independent,48,1,49,0.03,Tamil Nadu-Tiruchengodu
14,ESWARAN M,Independent,325,1,326,0.18,Tamil Nadu-Tiruchengodu
15,KARTHIKEYAN S,Independent,373,2,375,0.2,Tamil Nadu-Tiruchengodu
16,SHANMUGASUNDARAM T,Independent,665,1,666,0.36,Tamil Nadu-Tiruchengodu
17,SATHIESHKUMAR C,Independent,391,0,391,0.21,Tamil Nadu-Tiruchengodu
18,CHANDRA R,Independent,210,0,210,0.11,Tamil Nadu-Tiruchengodu
19,SARAVANAN K,Independent,43,0,43,0.02,Tamil Nadu-Tiruchengodu
20,SARASWATHI M,Independent,71,5,76,0.04,Tamil Nadu-Tiruchengodu
21,SENTHILKUMAR C,Independent,24,1,25,0.01,Tamil Nadu-Tiruchengodu
22,SELVARAMLINGAM,Independent,196,4,200,0.11,Tamil Nadu-Tiruchengodu
23,SELVARAJ K R,Independent,62,0,62,0.03,Tamil Nadu-Tiruchengodu
24,BALAMURUGAN C,Independent,378,1,379,0.21,Tamil Nadu-Tiruchengodu
25,BALAMURUGAN S,Independent,52,1,53,0.03,Tamil Nadu-Tiruchengodu
26,BALAJICHEZHIAN P,Independent,54,0,54,0.03,Tamil Nadu-Tiruchengodu
27,RANJIT R,Independent,93,3,96,0.05,Tamil Nadu-Tiruchengodu
28,VELU K,Independent,126,1,127,0.07,Tamil Nadu-Tiruchengodu
29,NOTA,None of the Above,1506,12,1518,0.82,Tamil Nadu-Tiruchengodu
1,"INIGO IRUDAYARAJ,S.",Dravida Munnetra Kazhagam,92645,1657,94302,54.56,Tamil Nadu-Tiruchirappalli (East)
2,"VELLAMANDI NATARAJAN,N.",All India Anna Dravida Munnetra Kazhagam,40109,396,40505,23.43,Tamil Nadu-Tiruchirappalli (East)
3,"PRABU,R.",Naam Tamilar Katchi,14211,101,14312,8.28,Tamil Nadu-Tiruchirappalli (East)
4,MANOHARAN.R.,Amma Makkal Munnettra Kazagam,9010,79,9089,5.26,Tamil Nadu-Tiruchirappalli (East)
5,VIJAIA MOHANAAJI,Vidial Valarchi Perani,105,0,105,0.06,Tamil Nadu-Tiruchirappalli (East)
6,"VEERASAKTHI,D.",Makkal Needhi Maiam,11309,87,11396,6.59,Tamil Nadu-Tiruchirappalli (East)
7,"ARAVINDAN,P.",Independent,85,0,85,0.05,Tamil Nadu-Tiruchirappalli (East)
8,"AROCKIA SATHEESH,A.",Independent,69,1,70,0.04,Tamil Nadu-Tiruchirappalli (East)
9,"IRUDAYARAJ,S.",Independent,55,3,58,0.03,Tamil Nadu-Tiruchirappalli (East)
10,"GASPAR REGAN,S.",Independent,49,1,50,0.03,Tamil Nadu-Tiruchirappalli (East)
11,"CHARLES SAGAYARAJ,P.",Independent,69,4,73,0.04,Tamil Nadu-Tiruchirappalli (East)
12,"DEVAKUMAR,T.",Independent,72,1,73,0.04,Tamil Nadu-Tiruchirappalli (East)
13,"BALAMURUGAN,A.",Independent,211,0,211,0.12,Tamil Nadu-Tiruchirappalli (East)
14,"MARUTHAMUTHU,N.",Independent,45,1,46,0.03,Tamil Nadu-Tiruchirappalli (East)
15,"MANOHARAN,M.",Independent,157,0,157,0.09,Tamil Nadu-Tiruchirappalli (East)
16,"RAJA,S.",Independent,381,1,382,0.22,Tamil Nadu-Tiruchirappalli (East)
17,"JAHIR HUSSAIN,M.",Independent,207,1,208,0.12,Tamil Nadu-Tiruchirappalli (East)
18,"SHEIK ABDULLAH,R.",Independent,199,0,199,0.12,Tamil Nadu-Tiruchirappalli (East)
19,NOTA,None of the Above,1504,31,1535,0.89,Tamil Nadu-Tiruchirappalli (East)
1,"Nehru, K.N.",Dravida Munnetra Kazhagam,116018,2115,118133,64.52,Tamil Nadu-Tiruchirappalli (West)
2,"Padmanathan, V.",All India Anna Dravida Munnetra Kazhagam,32632,392,33024,18.04,Tamil Nadu-Tiruchirappalli (West)
3,"Abubacker Siddiq,  M.",Makkal Needhi Maiam,10466,80,10546,5.76,Tamil Nadu-Tiruchirappalli (West)
4,"Abdullah Hassan Faizy, R.",SOCIAL DEMOCRATIC PARTY OF INDIA,2525,20,2545,1.39,Tamil Nadu-Tiruchirappalli (West)
5,"Vinodh, V.",Naam Tamilar Katchi,15637,88,15725,8.59,Tamil Nadu-Tiruchirappalli (West)
6,"Kalpana, T.",Independent,193,3,196,0.11,Tamil Nadu-Tiruchirappalli (West)
7,"Sahabudheen, A.J.",Independent,41,2,43,0.02,Tamil Nadu-Tiruchirappalli (West)
8,"Sudha, R.",Independent,216,6,222,0.12,Tamil Nadu-Tiruchirappalli (West)
9,"Sundar Rajulu, G.",Independent,40,2,42,0.02,Tamil Nadu-Tiruchirappalli (West)
10,"Selvaraj, D.",Independent,48,0,48,0.03,Tamil Nadu-Tiruchirappalli (West)
11,"Dheepan, M.",Independent,65,1,66,0.04,Tamil Nadu-Tiruchirappalli (West)
12,"Vasudevan, A.",Independent,211,0,211,0.12,Tamil Nadu-Tiruchirappalli (West)
13,"Shajahan, R.",Independent,181,0,181,0.1,Tamil Nadu-Tiruchirappalli (West)
14,NOTA,None of the Above,2079,38,2117,1.16,Tamil Nadu-Tiruchirappalli (West)
1,THANGAM THENARASU,Dravida Munnetra Kazhagam,101016,1209,102225,59.15,Tamil Nadu-Tiruchuli
2,RAJASEKAR S,All India Anna Dravida Munnetra Kazhagam,41087,146,41233,23.86,Tamil Nadu-Tiruchuli
3,ANANDHAJOTHI A,Naam Tamilar Katchi,13654,133,13787,7.98,Tamil Nadu-Tiruchuli
4,SIVASAMY K K,Amma Makkal Munnettra Kazagam,6399,42,6441,3.73,Tamil Nadu-Tiruchuli
5,THIRUMURUGAN PALANISAMY K,Puthiya Tamilagam,586,7,593,0.34,Tamil Nadu-Tiruchuli
6,MANIVASAGAM S,Bahujan Dravida Party,70,0,70,0.04,Tamil Nadu-Tiruchuli
7,MURUGAN S,Makkal Needhi Maiam,1338,18,1356,0.78,Tamil Nadu-Tiruchuli
8,ADAIKALAM R,Independent,896,2,898,0.52,Tamil Nadu-Tiruchuli
9,ARUNKUMAR V,Independent,2491,1,2492,1.44,Tamil Nadu-Tiruchuli
10,INDIRA B,Independent,123,1,124,0.07,Tamil Nadu-Tiruchuli
11,KALIMUTHU S,Independent,46,0,46,0.03,Tamil Nadu-Tiruchuli
12,CHENNAKESAVAN P,Independent,52,0,52,0.03,Tamil Nadu-Tiruchuli
13,SETHURAMALINGAM S,Independent,65,0,65,0.04,Tamil Nadu-Tiruchuli
14,ADVOCATE. THANGAPANDIAN M,Independent,357,8,365,0.21,Tamil Nadu-Tiruchuli
15,THIRUMURUGAN G,Independent,480,0,480,0.28,Tamil Nadu-Tiruchuli
16,MALAIALAGU M,Independent,566,0,566,0.33,Tamil Nadu-Tiruchuli
17,RAMATHILAGAM A,Independent,683,1,684,0.4,Tamil Nadu-Tiruchuli
18,RAJANGAM C,Independent,349,0,349,0.2,Tamil Nadu-Tiruchuli
19,RAJENDRAN R,Independent,137,0,137,0.08,Tamil Nadu-Tiruchuli
20,HARIKRISHNAN K,Independent,108,0,108,0.06,Tamil Nadu-Tiruchuli
21,NOTA,None of the Above,734,6,740,0.43,Tamil Nadu-Tiruchuli
1,VAT.KALIVARADHAN,Bharatiya Janata Party,50887,413,51300,26.14,Tamil Nadu-Tirukkoyilur
2,SIVA.PANJAVARNAM,Bahujan Samaj Party,691,5,696,0.35,Tamil Nadu-Tirukkoyilur
3,K.PONMUDY,Dravida Munnetra Kazhagam,109226,1754,110980,56.56,Tamil Nadu-Tirukkoyilur
4,L.VENKATESAN,Desiya Murpokku Dravida Kazhagam,13928,69,13997,7.13,Tamil Nadu-Tirukkoyilur
5,SANKAR S,Veerath Thiyagi Viswanathadoss Thozhilalarkal Katchi,565,1,566,0.29,Tamil Nadu-Tirukkoyilur
6,SENTHILKUMAR M,Indiya Jananayaka Katchi,1056,10,1066,0.54,Tamil Nadu-Tirukkoyilur
7,MURUGAN S,Naam Tamilar Katchi,11567,53,11620,5.92,Tamil Nadu-Tirukkoyilur
8,RAJINI VR,Naadaalum Makkal Katchi,231,0,231,0.12,Tamil Nadu-Tirukkoyilur
9,KATHIRAVAN K,Independent,183,6,189,0.1,Tamil Nadu-Tirukkoyilur
10,PRAKASH A,Independent,881,2,883,0.45,Tamil Nadu-Tirukkoyilur
11,MAGESH M,Independent,271,5,276,0.14,Tamil Nadu-Tirukkoyilur
12,MATHIVANAN S,Independent,412,0,412,0.21,Tamil Nadu-Tirukkoyilur
13,VIGNESH M,Independent,1482,0,1482,0.76,Tamil Nadu-Tirukkoyilur
14,JAYAVINDAN G,Independent,480,0,480,0.24,Tamil Nadu-Tirukkoyilur
15,NOTA,None of the Above,2030,9,2039,1.04,Tamil Nadu-Tirukkoyilur
1,Kalanithy,Bahujan Samaj Party,646,8,654,0.33,Tamil Nadu-Tirunelveli
2,Nainar Nagenthran,Bharatiya Janata Party,91504,778,92282,46.7,Tamil Nadu-Tirunelveli
3,"Lakshmanan,A.L.S.",Dravida Munnetra Kazhagam,68102,1073,69175,35.01,Tamil Nadu-Tirunelveli
4,"Sathya,B.",Naam Tamilar Katchi,18986,176,19162,9.7,Tamil Nadu-Tirunelveli
5,"Sundarraj,M.",Communist Party of India  (Marxist-Leninist)  (Liberation),412,3,415,0.21,Tamil Nadu-Tirunelveli
6,"Mahesh Kannan,A.P.",Amma Makkal Munnettra Kazagam,8807,104,8911,4.51,Tamil Nadu-Tirunelveli
7,"Esakkimuthu,P.",Independent,435,2,437,0.22,Tamil Nadu-Tirunelveli
8,"Sankarasubramanian,M.",Independent,582,0,582,0.29,Tamil Nadu-Tirunelveli
9,Sankar @ Sankaranarayanan,Independent,264,0,264,0.13,Tamil Nadu-Tirunelveli
10,"Sivakumar,M.",Independent,1375,37,1412,0.71,Tamil Nadu-Tirunelveli
11,"Murugan,R.",Independent,197,2,199,0.1,Tamil Nadu-Tirunelveli
12,"Murugan,V.",Independent,339,3,342,0.17,Tamil Nadu-Tirunelveli
13,"Raghavan,C.M.",Independent,318,1,319,0.16,Tamil Nadu-Tirunelveli
14,Srithar Rajan,Independent,1336,6,1342,0.68,Tamil Nadu-Tirunelveli
15,NOTA,None of the Above,2074,17,2091,1.06,Tamil Nadu-Tirunelveli
1,A. NALLATHAMBI,Dravida Munnetra Kazhagam,95067,1455,96522,51.91,Tamil Nadu-Tirupattur
2,S. KALASHTHRI,All India Uzhavargal Uzhaippalargal Katchi,713,11,724,0.39,Tamil Nadu-Tirupattur
3,S. SATHIYAMOORTHY,Makkal Nala Kazhagam,516,3,519,0.28,Tamil Nadu-Tirupattur
4,M. SUMATHI,Naam Tamilar Katchi,12016,111,12127,6.52,Tamil Nadu-Tirupattur
5,A. GNANASEKAR,Amma Makkal Munnettra Kazagam,2679,23,2702,1.45,Tamil Nadu-Tirupattur
6,T.K. RAJA,Pattali Makkal Katchi,67905,377,68282,36.72,Tamil Nadu-Tirupattur
7,I. ROSELIN JEEVA,Samaniya Makkal Nala Katchi,263,1,264,0.14,Tamil Nadu-Tirupattur
8,A. JEYAMMA,Anaithu Makkal Puratchi Katchi,127,1,128,0.07,Tamil Nadu-Tirupattur
9,R. AROCKIA JOE PRABU,Independent,437,1,438,0.24,Tamil Nadu-Tirupattur
10,I. GOVINDARAJI,Independent,296,1,297,0.16,Tamil Nadu-Tirupattur
11,M. NALLASIVAM,Independent,322,1,323,0.17,Tamil Nadu-Tirupattur
12,R. PALANI,Independent,361,1,362,0.19,Tamil Nadu-Tirupattur
13,MANITHAN,Independent,308,1,309,0.17,Tamil Nadu-Tirupattur
14,G. RAJA,Independent,204,1,205,0.11,Tamil Nadu-Tirupattur
15,B. VIJAYAKUMAR,Independent,1091,5,1096,0.59,Tamil Nadu-Tirupattur
16,NOTA,None of the Above,1625,7,1632,0.88,Tamil Nadu-Tirupattur
1,MARUDHU ALAGURAJ,All India Anna Dravida Munnetra Kazhagam,65915,393,66308,31.46,Tamil Nadu-Tiruppattur
2,KR.PERIYAKARUPPAN,Dravida Munnetra Kazhagam,102261,1421,103682,49.19,Tamil Nadu-Tiruppattur
3,A.AMALAN SAVARIMUTHU,Indiya Jananayaka Katchi,856,6,862,0.41,Tamil Nadu-Tiruppattur
4,K.K.UMADHEVAN,Amma Makkal Munnettra Kazagam,7396,52,7448,3.53,Tamil Nadu-Tiruppattur
5,KOTTAIKUMAR,Naam Tamilar Katchi,14518,53,14571,6.91,Tamil Nadu-Tiruppattur
6,M.SARASWATHI,Puthiya Tamilagam,240,1,241,0.11,Tamil Nadu-Tiruppattur
7,S.MURUGAN,Anaithu Makkal Puratchi Katchi,95,1,96,0.05,Tamil Nadu-Tiruppattur
8,K.VEERAPANDIAN,My India Party,143,1,144,0.07,Tamil Nadu-Tiruppattur
9,G.ABDUL KISHORE BABU,Independent,84,1,85,0.04,Tamil Nadu-Tiruppattur
10,ANANDHAN K,Independent,62,0,62,0.03,Tamil Nadu-Tiruppattur
11,C.KANNAN,Independent,67,1,68,0.03,Tamil Nadu-Tiruppattur
12,A.KARTHIKA,Independent,80,0,80,0.04,Tamil Nadu-Tiruppattur
13,P.SELVARAJ,Independent,221,0,221,0.1,Tamil Nadu-Tiruppattur
14,C.PARAMASIVAM,Independent,13186,16,13202,6.26,Tamil Nadu-Tiruppattur
15,PALANIAPPAN,Independent,333,0,333,0.16,Tamil Nadu-Tiruppattur
16,A.PARTHASARATHY,Independent,465,0,465,0.22,Tamil Nadu-Tiruppattur
17,PERIYASAMY,Independent,604,1,605,0.29,Tamil Nadu-Tiruppattur
18,A.MALLIKA,Independent,444,0,444,0.21,Tamil Nadu-Tiruppattur
19,M.MOHAMED RABEEK,Independent,122,0,122,0.06,Tamil Nadu-Tiruppattur
20,MUTHULAKSHMI,Independent,65,0,65,0.03,Tamil Nadu-Tiruppattur
21,RM.MURUGESAN,Independent,69,0,69,0.03,Tamil Nadu-Tiruppattur
22,K.S.K.RAJESH,Independent,352,0,352,0.17,Tamil Nadu-Tiruppattur
23,P.RAJESWARI,Independent,152,0,152,0.07,Tamil Nadu-Tiruppattur
24,RENUKA,Independent,56,0,56,0.03,Tamil Nadu-Tiruppattur
25,J.VEERAYI,Independent,65,0,65,0.03,Tamil Nadu-Tiruppattur
26,P.JEYACHANDRAN,Independent,115,0,115,0.05,Tamil Nadu-Tiruppattur
27,NOTA,None of the Above,845,8,853,0.4,Tamil Nadu-Tiruppattur
1,CHANDRASEKARAN.R,Bahujan Samaj Party,474,3,477,0.2,Tamil Nadu-Tiruppur (North)
2,RAVI (Alias) SUBRAMANIAN . M,Communist Party of India,72679,603,73282,30.78,Tamil Nadu-Tiruppur (North)
3,SELVAKUMAR.M,Desiya Murpokku Dravida Kazhagam,3420,7,3427,1.44,Tamil Nadu-Tiruppur (North)
4,VIJEYAKUMAR.K.N,All India Anna Dravida Munnetra Kazhagam,113119,265,113384,47.62,Tamil Nadu-Tiruppur (North)
5,ALAGHUSUNDARAM.P,Anna Dravidar Kazhagam,591,1,592,0.25,Tamil Nadu-Tiruppur (North)
6,EASWARAN.S,Naam Tamilar Katchi,23061,49,23110,9.71,Tamil Nadu-Tiruppur (North)
7,SIVABALAN.S,Makkal Needhi Maiam,19565,37,19602,8.23,Tamil Nadu-Tiruppur (North)
8,SENTHILKUMAR.V,Anna Puratchi Thalaivar Amma Dravida Munnetra Kazhagam,426,2,428,0.18,Tamil Nadu-Tiruppur (North)
9,DEIVASIGAMANI.K,Ezhuchi Tamilargal Munnetra Kazhagam,139,0,139,0.06,Tamil Nadu-Tiruppur (North)
10,UDHAYAKUMAR.S,Independent,337,5,342,0.14,Tamil Nadu-Tiruppur (North)
11,SENTHILKUMAR.T.N,Independent,96,0,96,0.04,Tamil Nadu-Tiruppur (North)
12,SENTHILKUMAR.R,Independent,131,2,133,0.06,Tamil Nadu-Tiruppur (North)
13,SENTHILVEL.A,Independent,301,1,302,0.13,Tamil Nadu-Tiruppur (North)
14,MURUGA PANDI.S,Independent,249,1,250,0.11,Tamil Nadu-Tiruppur (North)
15,RANGASAMY.M,Independent,365,1,366,0.15,Tamil Nadu-Tiruppur (North)
16,NOTA,None of the Above,2154,8,2162,0.91,Tamil Nadu-Tiruppur (North)
1,GUNASEKARAN. S.,All India Anna Dravida Munnetra Kazhagam,70551,275,70826,40.61,Tamil Nadu-Tiruppur (South)
2,CHELLAPANDY. P.,Bahujan Samaj Party,311,1,312,0.18,Tamil Nadu-Tiruppur (South)
3,SELVARAJ. K.,Dravida Munnetra Kazhagam,74944,591,75535,43.31,Tamil Nadu-Tiruppur (South)
4,ARUNKUMAR. G.,Tamil Nadu Ilangyar Katchi,554,0,554,0.32,Tamil Nadu-Tiruppur (South)
5,ANUSHA RAVI.,Makkal Needhi Maiam,9914,20,9934,5.7,Tamil Nadu-Tiruppur (South)
6,SHANMUGASUNDARAM. K.,Naam Tamilar Katchi,12870,28,12898,7.39,Tamil Nadu-Tiruppur (South)
7,DEIVEEGAN. K.,Anna Puratchi Thalaivar Amma Dravida Munnetra Kazhagam,101,0,101,0.06,Tamil Nadu-Tiruppur (South)
8,VISHALAKCHI. A.,Amma Makkal Munnettra Kazagam,1751,6,1757,1.01,Tamil Nadu-Tiruppur (South)
9,ASLAM. J.,Independent,163,1,164,0.09,Tamil Nadu-Tiruppur (South)
10,GANESH. E.,Independent,66,0,66,0.04,Tamil Nadu-Tiruppur (South)
11,KADER BASHA. A.,Independent,75,1,76,0.04,Tamil Nadu-Tiruppur (South)
12,GUNASEKARAN. I.,Independent,38,0,38,0.02,Tamil Nadu-Tiruppur (South)
13,GUNASEKARAN. M.,Independent,80,0,80,0.05,Tamil Nadu-Tiruppur (South)
14,SARVALOGA DAYABARAN. M.A.,Independent,147,0,147,0.08,Tamil Nadu-Tiruppur (South)
15,SELVARAJ. A.,Independent,68,0,68,0.04,Tamil Nadu-Tiruppur (South)
16,SELVAN. K.,Independent,224,0,224,0.13,Tamil Nadu-Tiruppur (South)
17,PRAKASH. R.,Independent,264,1,265,0.15,Tamil Nadu-Tiruppur (South)
18,MALARVIZHI. G.,Independent,83,0,83,0.05,Tamil Nadu-Tiruppur (South)
19,MUTHUSAMY. K.,Independent,121,0,121,0.07,Tamil Nadu-Tiruppur (South)
20,VIJAYAKUMAR. A.,Independent,27,0,27,0.02,Tamil Nadu-Tiruppur (South)
21,NOTA,None of the Above,1133,9,1142,0.65,Tamil Nadu-Tiruppur (South)
1,G.Hari,All India Anna Dravida Munnetra Kazhagam,89704,1357,91061,39.15,Tamil Nadu-Tiruttani
2,D.Krishnamoorthi,Desiya Murpokku Dravida Kazhagam,3903,25,3928,1.69,Tamil Nadu-Tiruttani
3,S.Chandran,Dravida Munnetra Kazhagam,118005,2309,120314,51.72,Tamil Nadu-Tiruttani
4,N.MAGENDIRAN,Bahujan Samaj Party,711,6,717,0.31,Tamil Nadu-Tiruttani
5,L.AKILA,Naam Tamilar Katchi,11900,107,12007,5.16,Tamil Nadu-Tiruttani
6,M.D.Thanigai Malai,Indiya Jananayaka Katchi,352,1,353,0.15,Tamil Nadu-Tiruttani
7,Manikkam,All India Jananayaka Makkal Kazhagam,121,0,121,0.05,Tamil Nadu-Tiruttani
8,M.Hari,Independent,365,1,366,0.16,Tamil Nadu-Tiruttani
9,Chandran,Independent,59,1,60,0.03,Tamil Nadu-Tiruttani
10,Chandran,Independent,46,0,46,0.02,Tamil Nadu-Tiruttani
11,A.J.Suresh,Independent,174,8,182,0.08,Tamil Nadu-Tiruttani
12,Shettu,Independent,147,0,147,0.06,Tamil Nadu-Tiruttani
13,D.PAULRAJ,Independent,886,3,889,0.38,Tamil Nadu-Tiruttani
14,V.P.Vijayan,Independent,760,8,768,0.33,Tamil Nadu-Tiruttani
15,NOTA,None of the Above,1653,12,1665,0.72,Tamil Nadu-Tiruttani
1,ANBUBAGURUDEEN N,Nationalist Congress Party,621,8,629,0.31,Tamil Nadu-Tiruvadanai
2,K C ANIMUTHU,All India Anna Dravida Munnetra Kazhagam,65049,463,65512,32.46,Tamil Nadu-Tiruvadanai
3,KARUMANICKAM,Indian National Congress,78415,949,79364,39.33,Tamil Nadu-Tiruvadanai
4,RAMALINGAM,Bahujan Samaj Party,605,5,610,0.3,Tamil Nadu-Tiruvadanai
5,ANANDH N,Amma Makkal Munnettra Kazagam,33038,388,33426,16.56,Tamil Nadu-Tiruvadanai
6,ANANTHARAJ S,My India Party,399,0,399,0.2,Tamil Nadu-Tiruvadanai
7,SATHYARAJ,Makkal Needhi Maiam,2189,19,2208,1.09,Tamil Nadu-Tiruvadanai
8,JAWAHAR,Naam Tamilar Katchi,16403,98,16501,8.18,Tamil Nadu-Tiruvadanai
9,SIKKANDAR,Independent,262,0,262,0.13,Tamil Nadu-Tiruvadanai
10,SURIYA PRAKASH,Independent,385,0,385,0.19,Tamil Nadu-Tiruvadanai
11,PRADEEP,Independent,163,0,163,0.08,Tamil Nadu-Tiruvadanai
12,PRAVEEN,Independent,273,1,274,0.14,Tamil Nadu-Tiruvadanai
13,PERUMAL,Independent,517,5,522,0.26,Tamil Nadu-Tiruvadanai
14,MANI,Independent,382,0,382,0.19,Tamil Nadu-Tiruvadanai
15,MANIKANDAN,Independent,410,0,410,0.2,Tamil Nadu-Tiruvadanai
16,NOTA,None of the Above,765,3,768,0.38,Tamil Nadu-Tiruvadanai
1,KOTHANDAPANI,Bahujan Samaj Party,460,6,466,0.22,Tamil Nadu-Tiruvannamalai
2,S THANIGAIVEL,Bharatiya Janata Party,42836,367,43203,20.69,Tamil Nadu-Tiruvannamalai
3,E V VELU,Dravida Munnetra Kazhagam,134987,2889,137876,66.02,Tamil Nadu-Tiruvannamalai
4,J AGNI SELVARASU,Naadaalum Makkal Katchi,545,3,548,0.26,Tamil Nadu-Tiruvannamalai
5,ARUL R,Makkal Needhi Maiam,6169,77,6246,2.99,Tamil Nadu-Tiruvannamalai
6,J KAMALAKKANNAN,Naam Tamilar Katchi,13894,101,13995,6.7,Tamil Nadu-Tiruvannamalai
7,R CHANDRAKANTH PILLAI,New Generation Peopleâ€™s Party,98,3,101,0.05,Tamil Nadu-Tiruvannamalai
8,S K SELVAM,Veerath Thiyagi Viswanathadoss Thozhilalarkal Katchi,130,1,131,0.06,Tamil Nadu-Tiruvannamalai
9,A G PANCHATCHARAM,Amma Makkal Munnettra Kazagam,2088,20,2108,1.01,Tamil Nadu-Tiruvannamalai
10,A NAKKEERAN,Independent,142,4,146,0.07,Tamil Nadu-Tiruvannamalai
11,N PALANI,Independent,145,19,164,0.08,Tamil Nadu-Tiruvannamalai
12,D MANIMARAN,Independent,152,5,157,0.08,Tamil Nadu-Tiruvannamalai
13,R G VASUDEVAN,Independent,291,0,291,0.14,Tamil Nadu-Tiruvannamalai
14,K VINAYAGAM,Independent,430,0,430,0.21,Tamil Nadu-Tiruvannamalai
15,J JAMEEL BASHA,Independent,774,6,780,0.37,Tamil Nadu-Tiruvannamalai
16,NOTA,None of the Above,2170,24,2194,1.05,Tamil Nadu-Tiruvannamalai
1,"UMANATH,  R.",Desiya Murpokku Dravida Kazhagam,4121,21,4142,2.46,Tamil Nadu-Tittakudi
2,"GANESAN,  C.V.",Dravida Munnetra Kazhagam,82780,946,83726,49.78,Tamil Nadu-Tittakudi
3,"PERIYASAMY,  D.",Bharatiya Janata Party,61851,312,62163,36.96,Tamil Nadu-Tittakudi
4,"RAVICHANDRAN,  P.",Bahujan Samaj Party,558,1,559,0.33,Tamil Nadu-Tittakudi
5,"ARULDOSS,  E.",Desiya Makkal Sakthi Katchi,219,2,221,0.13,Tamil Nadu-Tittakudi
6,"KAMATCHI,  N.",Naam Tamilar Katchi,10555,36,10591,6.3,Tamil Nadu-Tittakudi
7,"PRABAKARAN,  R.",Makkal Needhi Maiam,1730,15,1745,1.04,Tamil Nadu-Tittakudi
8,"AYYASAMY,  S.",Independent,720,4,724,0.43,Tamil Nadu-Tittakudi
9,"KARUPPAN,  M.",Independent,927,17,944,0.56,Tamil Nadu-Tittakudi
10,"KAMARAJ,  K.",Independent,141,0,141,0.08,Tamil Nadu-Tittakudi
11,"KOLANJINATHAN,  V.",Independent,129,1,130,0.08,Tamil Nadu-Tittakudi
12,"SEENUVASAN,  C.",Independent,197,0,197,0.12,Tamil Nadu-Tittakudi
13,"SUMATHI,  S.",Independent,237,1,238,0.14,Tamil Nadu-Tittakudi
14,"NATARAJAN,  M.",Independent,1063,0,1063,0.63,Tamil Nadu-Tittakudi
15,"PALANIAMMAL,  P.",Independent,601,0,601,0.36,Tamil Nadu-Tittakudi
16,NOTA,None of the Above,995,4,999,0.59,Tamil Nadu-Tittakudi
1,"GANESH, R.",Indian National Congress,64148,1382,65530,46.44,Tamil Nadu-Udhagamandalam
2,"BHOJARAJAN, M.",Bharatiya Janata Party,59553,629,60182,42.65,Tamil Nadu-Udhagamandalam
3,"Dr.SURESH BABU, S.",Makkal Needhi Maiam,4859,76,4935,3.5,Tamil Nadu-Udhagamandalam
4,"LAKSHMANAN, T.",Amma Makkal Munnettra Kazagam,1250,23,1273,0.9,Tamil Nadu-Udhagamandalam
5,"JAYAKUMAR, A.",Naam Tamilar Katchi,6316,65,6381,4.52,Tamil Nadu-Udhagamandalam
6,"AROKIYANATHAN, B.",Independent,514,0,514,0.36,Tamil Nadu-Udhagamandalam
7,"KRISHNAMURTHI, B.",Independent,249,6,255,0.18,Tamil Nadu-Udhagamandalam
8,"A. SARDAR BABU, B.COM.",Independent,223,2,225,0.16,Tamil Nadu-Udhagamandalam
9,"VINOTHKUMAR, M.A.",Independent,425,6,431,0.31,Tamil Nadu-Udhagamandalam
10,NOTA,None of the Above,1357,19,1376,0.98,Tamil Nadu-Udhagamandalam
1,"Kumar,K.",Bahujan Samaj Party,456,3,459,0.24,Tamil Nadu-Udumalaipettai
2,"Thennarasu,K.",Indian National Congress,73788,1210,74998,38.59,Tamil Nadu-Udumalaipettai
3,"Radhakrishnan,K.",All India Anna Dravida Munnetra Kazhagam,95953,940,96893,49.85,Tamil Nadu-Udumalaipettai
4,"Krishnan,T.",Anna Puratchi Thalaivar Amma Dravida Munnetra Kazhagam,680,3,683,0.35,Tamil Nadu-Udumalaipettai
5,"Nachammal,K.",Anaithu Makkal Arasiyal Katchi,175,2,177,0.09,Tamil Nadu-Udumalaipettai
6,"Palanisamy,R.",Amma Makkal Munnettra Kazagam,1038,5,1043,0.54,Tamil Nadu-Udumalaipettai
7,"Babu Ranjendra Prasad,A.",Naam Tamilar Katchi,8540,52,8592,4.42,Tamil Nadu-Udumalaipettai
8,"Srinithi,V.",Makkal Needhi Maiam,8107,56,8163,4.2,Tamil Nadu-Udumalaipettai
9,"Ashokkumar,S.",Independent,70,0,70,0.04,Tamil Nadu-Udumalaipettai
10,"Arumugam,P.",Independent,182,2,184,0.09,Tamil Nadu-Udumalaipettai
11,"Umar Ali,D.",Independent,217,7,224,0.12,Tamil Nadu-Udumalaipettai
12,"Elsy,C.",Independent,124,2,126,0.06,Tamil Nadu-Udumalaipettai
13,"Karthikeyan,S.",Independent,180,1,181,0.09,Tamil Nadu-Udumalaipettai
14,"Dhivya,D.",Independent,785,2,787,0.4,Tamil Nadu-Udumalaipettai
15,"Rajini,K.",Independent,300,0,300,0.15,Tamil Nadu-Udumalaipettai
16,NOTA,None of the Above,1469,9,1478,0.76,Tamil Nadu-Udumalaipettai
1,KUMARAGURU R,All India Anna Dravida Munnetra Kazhagam,108960,1235,110195,45,Tamil Nadu-Ulundurpettai
2,SATHIYAMOORTHY,Bahujan Samaj Party,823,2,825,0.34,Tamil Nadu-Ulundurpettai
3,MANIKANNAN A J,Dravida Munnetra Kazhagam,114344,1107,115451,47.15,Tamil Nadu-Ulundurpettai
4,K.G.P.Rajamani,Amma Makkal Munnettra Kazagam,2843,5,2848,1.16,Tamil Nadu-Ulundurpettai
5,KUMAR A,Indhia Kudiarasu Katchi,110,0,110,0.04,Tamil Nadu-Ulundurpettai
6,CHINNAIYAN S,Makkal Needhi Maiam,673,4,677,0.28,Tamil Nadu-Ulundurpettai
7,DHANAPAL P,Lok Jan Shakti Party,81,0,81,0.03,Tamil Nadu-Ulundurpettai
8,Pushbamary L,Naam Tamilar Katchi,8954,46,9000,3.68,Tamil Nadu-Ulundurpettai
9,VENkATESAN M,Communist Party of India  (Marxist-Leninist)  (Liberation),140,3,143,0.06,Tamil Nadu-Ulundurpettai
10,RAJAMANI  K,Independent,116,1,117,0.05,Tamil Nadu-Ulundurpettai
11,KATHIRVEL M,Independent,102,3,105,0.04,Tamil Nadu-Ulundurpettai
12,DEEPA,My India Party,263,0,263,0.11,Tamil Nadu-Ulundurpettai
13,MANI R,Veerath Thiyagi Viswanathadoss Thozhilalarkal Katchi,298,1,299,0.12,Tamil Nadu-Ulundurpettai
14,MANIKANNAN M,Independent,2106,1,2107,0.86,Tamil Nadu-Ulundurpettai
15,RAJASTALIN K,Independent,351,1,352,0.14,Tamil Nadu-Ulundurpettai
16,NOTA,None of the Above,2277,3,2280,0.93,Tamil Nadu-Ulundurpettai
1,AYYAPPAN P,All India Anna Dravida Munnetra Kazhagam,70780,475,71255,33.53,Tamil Nadu-Usilampatti
2,KATHIRAVAN P V,Dravida Munnetra Kazhagam,62877,901,63778,30.01,Tamil Nadu-Usilampatti
3,ARASUMAYAN M,All India Jananayaka Makkal Kazhagam,961,6,967,0.46,Tamil Nadu-Usilampatti
4,IYNDHUKOVILAN G,Naam Tamilar Katchi,15089,268,15357,7.23,Tamil Nadu-Usilampatti
5,THIRUSELVAM C,Puthiya Tamilagam,1149,12,1161,0.55,Tamil Nadu-Usilampatti
6,BHARATH V,My India Party,372,6,378,0.18,Tamil Nadu-Usilampatti
7,MAHENDRAN I,Amma Makkal Munnettra Kazagam,54758,733,55491,26.11,Tamil Nadu-Usilampatti
8,ARUNKUMAR M,Independent,359,3,362,0.17,Tamil Nadu-Usilampatti
9,ALAGUMURUGESAN K,Independent,155,3,158,0.07,Tamil Nadu-Usilampatti
10,ARUMUGAM K,Independent,1238,9,1247,0.59,Tamil Nadu-Usilampatti
11,ANANTHA KUMAR N,Independent,69,5,74,0.03,Tamil Nadu-Usilampatti
12,KATHIRAVAN A,Independent,523,5,528,0.25,Tamil Nadu-Usilampatti
13,Dhanasekaran T,Independent,477,1,478,0.22,Tamil Nadu-Usilampatti
14,MAHENDRAN A,Independent,247,0,247,0.12,Tamil Nadu-Usilampatti
15,NOTA,None of the Above,1015,17,1032,0.49,Tamil Nadu-Usilampatti
1,S.Arumugam,Indian National Congress,70084,1204,71288,37.87,Tamil Nadu-Uthangarai
2,T.M.TAMILSELVAM,All India Anna Dravida Munnetra Kazhagam,98973,702,99675,52.96,Tamil Nadu-Uthangarai
3,NAGARAJ,Bahujan Samaj Party,718,4,722,0.38,Tamil Nadu-Uthangarai
4,R.Bakyaraj,Desiya Murpokku Dravida Kazhagam,2278,13,2291,1.22,Tamil Nadu-Uthangarai
5,Elangovan,Naam Tamilar Katchi,10352,72,10424,5.54,Tamil Nadu-Uthangarai
6,S.Perumal,Anna Puratchi Thalaivar Amma Dravida Munnetra Kazhagam,205,1,206,0.11,Tamil Nadu-Uthangarai
7,K.Murugesan,Makkal Needhi Maiam,1239,15,1254,0.67,Tamil Nadu-Uthangarai
8,T.Tamilarasan,Independent,180,1,181,0.1,Tamil Nadu-Uthangarai
9,M.Thenmozhi,Independent,103,1,104,0.06,Tamil Nadu-Uthangarai
10,R.Manjunathan,Independent,112,2,114,0.06,Tamil Nadu-Uthangarai
11,R.Vivekanandhan,Independent,280,3,283,0.15,Tamil Nadu-Uthangarai
12,C.Jayaraman,Independent,322,0,322,0.17,Tamil Nadu-Uthangarai
13,NOTA,None of the Above,1354,5,1359,0.72,Tamil Nadu-Uthangarai
1,SUNDAR K,Dravida Munnetra Kazhagam,92161,1266,93427,44.38,Tamil Nadu-Uthiramerur
2,SURESH D,Bahujan Samaj Party,600,2,602,0.29,Tamil Nadu-Uthiramerur
3,SOMASUNDARAM V,All India Anna Dravida Munnetra Kazhagam,91127,678,91805,43.61,Tamil Nadu-Uthiramerur
4,KAMACTHI.S,Naam Tamilar Katchi,11320,85,11405,5.42,Tamil Nadu-Uthiramerur
5,SIVAKUMAR.A,Desiya Makkal Sakthi Katchi,134,2,136,0.06,Tamil Nadu-Uthiramerur
6,SUSAIAPPAR.A,Makkal Needhi Maiam,2077,23,2100,1,Tamil Nadu-Uthiramerur
7,RANJITHKUMAR.R.V,Amma Makkal Munnettra Kazagam,7181,30,7211,3.43,Tamil Nadu-Uthiramerur
8,JAISUDHA.V,Republican Party of India (Athawale),82,3,85,0.04,Tamil Nadu-Uthiramerur
9,AROKIASAMY.J,Independent,91,13,104,0.05,Tamil Nadu-Uthiramerur
10,GUNASEKAR.V,Independent,104,0,104,0.05,Tamil Nadu-Uthiramerur
11,SARAVANAN.A,Independent,298,6,304,0.14,Tamil Nadu-Uthiramerur
12,SIVALINGAM.M,Independent,64,0,64,0.03,Tamil Nadu-Uthiramerur
13,CHINNASWAMY.T,Independent,100,1,101,0.05,Tamil Nadu-Uthiramerur
14,THANGARAJ.K,Independent,332,1,333,0.16,Tamil Nadu-Uthiramerur
15,DEVARAJAN.C,Independent,140,1,141,0.07,Tamil Nadu-Uthiramerur
16,PONNAMBALAM.R,Independent,752,1,753,0.36,Tamil Nadu-Uthiramerur
17,MADHAVARAJ.K.V,Independent,448,0,448,0.21,Tamil Nadu-Uthiramerur
18,JEEVANANTHAM.D,Independent,66,0,66,0.03,Tamil Nadu-Uthiramerur
19,JAYABALAN.E,Independent,305,1,306,0.15,Tamil Nadu-Uthiramerur
20,JAYARAMAN.C.A,Independent,81,1,82,0.04,Tamil Nadu-Uthiramerur
21,NOTA,None of the Above,946,6,952,0.45,Tamil Nadu-Uthiramerur
1,AMULKANDASAMI T K,All India Anna Dravida Munnetra Kazhagam,71128,544,71672,49.37,Tamil Nadu-Valparai
2,ARUMUGAM M,Communist Party of India,58821,628,59449,40.95,Tamil Nadu-Valparai
3,MURUGARAJ M S,Desiya Murpokku Dravida Kazhagam,1327,8,1335,0.92,Tamil Nadu-Valparai
4,KOHILA C,Naam Tamilar Katchi,7588,44,7632,5.26,Tamil Nadu-Valparai
5,SENTHILRAJ D,Makkal Needhi Maiam,3291,23,3314,2.28,Tamil Nadu-Valparai
6,RANGASAMY T M,Independent,353,2,355,0.24,Tamil Nadu-Valparai
7,NOTA,None of the Above,1409,6,1415,0.97,Tamil Nadu-Valparai
1,Ambethkumar S,Dravida Munnetra Kazhagam,100951,1113,102064,54.88,Tamil Nadu-Vandavasi
2,Arjunan M,Bahujan Samaj Party,597,10,607,0.33,Tamil Nadu-Vandavasi
3,Suresh S,Makkal Needhi Maiam,1678,14,1692,0.91,Tamil Nadu-Vandavasi
4,Durai B,Ganasangam Party of India,360,3,363,0.2,Tamil Nadu-Vandavasi
5,Prabavathi G,Naam Tamilar Katchi,9249,35,9284,4.99,Tamil Nadu-Vandavasi
6,Murali S,Pattali Makkal Katchi,65617,494,66111,35.55,Tamil Nadu-Vandavasi
7,Venkatesan P,Amma Makkal Munnettra Kazagam,1714,14,1728,0.93,Tamil Nadu-Vandavasi
8,Manikandan K,Independent,1262,2,1264,0.68,Tamil Nadu-Vandavasi
9,Muthuperumal K,Independent,136,3,139,0.07,Tamil Nadu-Vandavasi
10,Murali C,Independent,406,1,407,0.22,Tamil Nadu-Vandavasi
11,Vignesh S,Independent,540,6,546,0.29,Tamil Nadu-Vandavasi
12,NOTA,None of the Above,1759,10,1769,0.95,Tamil Nadu-Vandavasi
1,G.SENDHIL KUMAR,All India Anna Dravida Munnetra Kazhagam,87340,678,88018,46.33,Tamil Nadu-Vaniyambadi
2,D.Ramu,Bahujan Samaj Party,715,6,721,0.38,Tamil Nadu-Vaniyambadi
3,R.Sekar,All India Youth Development Party,176,3,179,0.09,Tamil Nadu-Vaniyambadi
4,M.GNANA DOSS,Makkal Needhi Maiam,1843,25,1868,0.98,Tamil Nadu-Vaniyambadi
5,A.J.DEVENDHIRAN,Naam Tamilar Katchi,11151,75,11226,5.91,Tamil Nadu-Vaniyambadi
6,N.MOHAMMED NAYEEM,Indian Union Muslim League,82317,797,83114,43.74,Tamil Nadu-Vaniyambadi
7,T.S.VAKEEL AHMED,All India Majlis-E-Ittehadul Muslimeen,1895,2,1897,1,Tamil Nadu-Vaniyambadi
8,B.JAGAN,Akhil Bharat Hindu Mahasabha,351,5,356,0.19,Tamil Nadu-Vaniyambadi
9,P.ABDUL WAHID,Independent,258,1,259,0.14,Tamil Nadu-Vaniyambadi
10,M.SURESH,Independent,362,0,362,0.19,Tamil Nadu-Vaniyambadi
11,SYED MOHAMMED SALEEM,Independent,131,2,133,0.07,Tamil Nadu-Vaniyambadi
12,DELHI RAJI.S,Independent,184,2,186,0.1,Tamil Nadu-Vaniyambadi
13,C.M.MOHAMMED HUSSAIN,Independent,186,0,186,0.1,Tamil Nadu-Vaniyambadi
14,NOTA,None of the Above,1487,5,1492,0.79,Tamil Nadu-Vaniyambadi
1,GANAPATHI P M,Desiya Murpokku Dravida Kazhagam,5430,30,5460,3,Tamil Nadu-Vanur
2,CHAKRAPANI M,All India Anna Dravida Munnetra Kazhagam,91501,718,92219,50.61,Tamil Nadu-Vanur
3,VINAYAGAMURTHY M,Bahujan Samaj Party,765,9,774,0.42,Tamil Nadu-Vanur
4,SANDOSHKUMAR M,Makkal Needhi Maiam,2492,8,2500,1.37,Tamil Nadu-Vanur
5,LATCHOUMY M,Naam Tamilar Katchi,8537,50,8587,4.71,Tamil Nadu-Vanur
6,VANNI ARASU,Viduthalai Chiruthaigal Katchi,69843,649,70492,38.69,Tamil Nadu-Vanur
7,SAKTHIVEL S,Independent,811,2,813,0.45,Tamil Nadu-Vanur
8,NOTA,None of the Above,1356,7,1363,0.75,Tamil Nadu-Vanur
1,"SADHAN THIRUMALAIKUMAR, DOCTOR.T",Dravida Munnetra Kazhagam,67053,1677,68730,39.08,Tamil Nadu-Vasudevanallur
2,MANOHARAN A,All India Anna Dravida Munnetra Kazhagam,65952,411,66363,37.73,Tamil Nadu-Vasudevanallur
3,ESWARAN M,New Generation Peopleâ€™s Party,789,6,795,0.45,Tamil Nadu-Vasudevanallur
4,KARUPPASAMY K,My India Party,340,2,342,0.19,Tamil Nadu-Vasudevanallur
5,CHINNASAMY M,Makkal Needhi Maiam,2105,34,2139,1.22,Tamil Nadu-Vasudevanallur
6,THANGARAJ S,Amma Makkal Munnettra Kazagam,13194,182,13376,7.61,Tamil Nadu-Vasudevanallur
7,PETCHIAMMAL V,Puthiya Tamilagam,3600,51,3651,2.08,Tamil Nadu-Vasudevanallur
8,MATHIVANAN S S,Naam Tamilar Katchi,16545,186,16731,9.51,Tamil Nadu-Vasudevanallur
9,JAYAKUMAR P L A,Tamil Nadu Ilangyar Katchi,525,19,544,0.31,Tamil Nadu-Vasudevanallur
10,MUTHUPANDI G,Independent,322,1,323,0.18,Tamil Nadu-Vasudevanallur
11,RAMAMOORTHY P,Independent,715,1,716,0.41,Tamil Nadu-Vasudevanallur
12,NOTA,None of the Above,2147,24,2171,1.23,Tamil Nadu-Vasudevanallur
1,R.PANNEERSELVAM,Bahujan Samaj Party,460,0,460,0.29,Tamil Nadu-Vedaranyam
2,O.S.MANIAN,All India Anna Dravida Munnetra Kazhagam,77625,1094,78719,49.8,Tamil Nadu-Vedaranyam
3,S.K.VETHARATHINAM,Dravida Munnetra Kazhagam,64823,1567,66390,42,Tamil Nadu-Vedaranyam
4,P.S.ARUMUGAM,Amma Makkal Munnettra Kazagam,1276,8,1284,0.81,Tamil Nadu-Vedaranyam
5,K.RAJENDRAN,Naam Tamilar Katchi,9030,76,9106,5.76,Tamil Nadu-Vedaranyam
6,Dr.T.SUNDARAVADIVELAN,Shiv Sena,91,0,91,0.06,Tamil Nadu-Vedaranyam
7,MOHAMED ALI,Makkal Needhi Maiam,433,4,437,0.28,Tamil Nadu-Vedaranyam
8,R.RAMAMURTHY,Independent,65,0,65,0.04,Tamil Nadu-Vedaranyam
9,T.RAMAJAYAM,Independent,63,13,76,0.05,Tamil Nadu-Vedaranyam
10,R.KATHIRVEL,Independent,139,4,143,0.09,Tamil Nadu-Vedaranyam
11,P.V.THEENATHAYALAN,Independent,315,4,319,0.2,Tamil Nadu-Vedaranyam
12,V.VEERAKUMAR,Independent,297,0,297,0.19,Tamil Nadu-Vedaranyam
13,NOTA,None of the Above,670,3,673,0.43,Tamil Nadu-Vedaranyam
1,GANDHIRAJAN S,Dravida Munnetra Kazhagam,105157,1324,106481,49.97,Tamil Nadu-Vedasandur
2,PARAMASIVAM V P B,All India Anna Dravida Munnetra Kazhagam,88330,598,88928,41.73,Tamil Nadu-Vedasandur
3,KARTHIKEYAN A,My India Party,669,0,669,0.31,Tamil Nadu-Vedasandur
4,KALIMUTHU V,Samaniya Makkal Nala Katchi,101,0,101,0.05,Tamil Nadu-Vedasandur
5,POTHUMANI R,Naam Tamilar Katchi,8441,54,8495,3.99,Tamil Nadu-Vedasandur
6,MANEESHANKAR M G,Rashtriya Samaj Paksha,105,3,108,0.05,Tamil Nadu-Vedasandur
7,MURUGESAN K,Ganasangam Party of India,123,0,123,0.06,Tamil Nadu-Vedasandur
8,RAMASAMY P,Amma Makkal Munnettra Kazagam,2030,11,2041,0.96,Tamil Nadu-Vedasandur
9,VETRIVEL S,Makkal Needhi Maiam,1202,13,1215,0.57,Tamil Nadu-Vedasandur
10,SARAVANA KUMAR K R,Independent,71,1,72,0.03,Tamil Nadu-Vedasandur
11,SUKUMAR V,Independent,233,0,233,0.11,Tamil Nadu-Vedasandur
12,SELVARAJ V,Independent,71,0,71,0.03,Tamil Nadu-Vedasandur
13,DHARMALINGAM Dr MARUR N,Independent,78,3,81,0.04,Tamil Nadu-Vedasandur
14,NANDAKUMAR P,Independent,124,0,124,0.06,Tamil Nadu-Vedasandur
15,PALANICHAMY B,Independent,1292,1,1293,0.61,Tamil Nadu-Vedasandur
16,PRASATH R,Independent,886,1,887,0.42,Tamil Nadu-Vedasandur
17,MUTHUSAMY V,Independent,739,1,740,0.35,Tamil Nadu-Vedasandur
18,MURUGAN P,Independent,489,0,489,0.23,Tamil Nadu-Vedasandur
19,MOORTHY S,Independent,77,0,77,0.04,Tamil Nadu-Vedasandur
20,RAMASAMY K,Independent,48,1,49,0.02,Tamil Nadu-Vedasandur
21,NOTA,None of the Above,798,5,803,0.38,Tamil Nadu-Vedasandur
1,"CHINNANANN, M.",Bahujan Samaj Party,358,3,361,0.16,Tamil Nadu-Veerapandi
2,"THARUN, A.K.",Dravida Munnetra Kazhagam,90732,1055,91787,41.03,Tamil Nadu-Veerapandi
3,"RAJAMUTHU, M.",All India Anna Dravida Munnetra Kazhagam,111081,601,111682,49.92,Tamil Nadu-Veerapandi
4,"AMUTHA, R.",Indiya Jananayaka Katchi,1293,9,1302,0.58,Tamil Nadu-Veerapandi
5,SATHIYAVANI,Dhesiya Makkal Kazhagam,117,1,118,0.05,Tamil Nadu-Veerapandi
6,"SELVAM, S.K.",Amma Makkal Munnettra Kazagam,4957,29,4986,2.23,Tamil Nadu-Veerapandi
7,"PRABAKARAN, P.",Veerath Thiyagi Viswanathadoss Thozhilalarkal Katchi,67,2,69,0.03,Tamil Nadu-Veerapandi
8,"MANI, M.",My India Party,133,0,133,0.06,Tamil Nadu-Veerapandi
9,"MANIKANDAN, S.",All India Jananayaka Makkal Kazhagam,59,0,59,0.03,Tamil Nadu-Veerapandi
10,"MOHAN, P.",SOCIALIST UNITY CENTRE OF INDIA (COMMUNIST),126,3,129,0.06,Tamil Nadu-Veerapandi
11,"RAJESHKUMAR, S.",Naam Tamilar Katchi,9734,72,9806,4.38,Tamil Nadu-Veerapandi
12,INDRAJITH GUPTHA,Independent,229,1,230,0.1,Tamil Nadu-Veerapandi
13,"SENTHILKUMAR, J.",Independent,94,0,94,0.04,Tamil Nadu-Veerapandi
14,"SENTHILMURUGAN, E.",Independent,265,0,265,0.12,Tamil Nadu-Veerapandi
15,"SEKAR, M.",Independent,208,0,208,0.09,Tamil Nadu-Veerapandi
16,"MOHAN, V.",Independent,384,2,386,0.17,Tamil Nadu-Veerapandi
17,"RAMESH, C.",Independent,55,0,55,0.02,Tamil Nadu-Veerapandi
18,"RAJARATHINAM, K.",Independent,236,1,237,0.11,Tamil Nadu-Veerapandi
19,"VENKAT, A.",Independent,324,0,324,0.14,Tamil Nadu-Veerapandi
20,"VAITHI, M.",Independent,62,0,62,0.03,Tamil Nadu-Veerapandi
21,NOTA,None of the Above,1391,18,1409,0.63,Tamil Nadu-Veerapandi
1,JMH.AASSAN MAULAANA,Indian National Congress,67998,495,68493,38.76,Tamil Nadu-Velachery
2,M.K.ASHOK,All India Anna Dravida Munnetra Kazhagam,63830,311,64141,36.3,Tamil Nadu-Velachery
3,C.VELU,Bahujan Samaj Party,473,4,477,0.27,Tamil Nadu-Velachery
4,R.KANCHANA,Tamizhaga Murpokku Makkal Katchi,86,1,87,0.05,Tamil Nadu-Velachery
5,GEETHA,New Generation Peopleâ€™s Party,277,1,278,0.16,Tamil Nadu-Velachery
6,M.KEERTHANA,Naam Tamilar Katchi,14142,29,14171,8.02,Tamil Nadu-Velachery
7,M.CHANDRABOSE,Amma Makkal Munnettra Kazagam,1972,5,1977,1.12,Tamil Nadu-Velachery
8,A.CHANDRAN,MGR Makkal Katchi,85,0,85,0.05,Tamil Nadu-Velachery
9,Dr. SANTHOSH BABU IAS (Retd),Makkal Needhi Maiam,22992,80,23072,13.06,Tamil Nadu-Velachery
10,V.L.REVATHI JAYAKUMARI,Tamil Nadu Ilangyar Katchi,746,4,750,0.42,Tamil Nadu-Velachery
11,J.VICTOR PAUL,Republican Party of India (Athawale),69,0,69,0.04,Tamil Nadu-Velachery
12,D.VENKATESHAN,Anaithu Makkal Arasiyal Katchi,63,0,63,0.04,Tamil Nadu-Velachery
13,G.YESUDASAN,Independent,48,0,48,0.03,Tamil Nadu-Velachery
14,K.KANNAN,Independent,57,0,57,0.03,Tamil Nadu-Velachery
15,S.GOKUL,Independent,89,0,89,0.05,Tamil Nadu-Velachery
16,V.SIVARAMAN,Independent,282,0,282,0.16,Tamil Nadu-Velachery
17,A.TAMIL AZHAGAN,Independent,229,0,229,0.13,Tamil Nadu-Velachery
18,N.MAHALAKSHMI,Independent,143,0,143,0.08,Tamil Nadu-Velachery
19,MURALI BALAJI,Independent,116,0,116,0.07,Tamil Nadu-Velachery
20,M.VIGNESH,Independent,34,0,34,0.02,Tamil Nadu-Velachery
21,A.VETRISELVAN,Independent,24,0,24,0.01,Tamil Nadu-Velachery
22,S.JOTHI KANNAN,Independent,116,1,117,0.07,Tamil Nadu-Velachery
23,V.HARIHARAN,Independent,170,0,170,0.1,Tamil Nadu-Velachery
24,NOTA,None of the Above,1725,17,1742,0.99,Tamil Nadu-Velachery
1,Appu S.R.K,All India Anna Dravida Munnetra Kazhagam,74457,661,75118,41.76,Tamil Nadu-Vellore
2,Karthikeyan .P,Dravida Munnetra Kazhagam,82907,1392,84299,46.86,Tamil Nadu-Vellore
3,Senthilkumar .P,Veerath Thiyagi Viswanathadoss Thozhilalarkal Katchi,200,2,202,0.11,Tamil Nadu-Vellore
4,Syed Jalaluddin .M,Tipu Sultan Party,186,1,187,0.1,Tamil Nadu-Vellore
5,Dharmalingam .V.D,Amma Makkal Munnettra Kazagam,860,5,865,0.48,Tamil Nadu-Vellore
6,Naresh Kumar .R,Tamil Nadu Ilangyar Katchi,921,7,928,0.52,Tamil Nadu-Vellore
7,Poonkundran .N,Naam Tamilar Katchi,8454,76,8530,4.74,Tamil Nadu-Vellore
8,Manogaran S,Kamarajar Deseeya Congress,67,0,67,0.04,Tamil Nadu-Vellore
9,Vikram Chakravarthy .G,Makkal Needhi Maiam,7179,64,7243,4.03,Tamil Nadu-Vellore
10,Karthick .E,Independent,35,1,36,0.02,Tamil Nadu-Vellore
11,Karthikeyan .R,Independent,40,2,42,0.02,Tamil Nadu-Vellore
12,Sathishkumar .S,Independent,54,0,54,0.03,Tamil Nadu-Vellore
13,Srinivasan .N,Independent,67,0,67,0.04,Tamil Nadu-Vellore
14,Naseer K,Independent,90,1,91,0.05,Tamil Nadu-Vellore
15,Panneer Sevlan .N,Independent,135,3,138,0.08,Tamil Nadu-Vellore
16,Vijayaraj .K,Independent,224,0,224,0.12,Tamil Nadu-Vellore
17,Vishnumohan .E,Independent,364,3,367,0.2,Tamil Nadu-Vellore
18,NOTA,None of the Above,1417,24,1441,0.8,Tamil Nadu-Vellore
1,P.Murugan,Dravida Munnetra Kazhagam,90593,457,91050,44.38,Tamil Nadu-Veppanahalli
2,S.M.Murugesan,Desiya Murpokku Dravida Kazhagam,3592,9,3601,1.76,Tamil Nadu-Veppanahalli
3,K.P.Munusamy,All India Anna Dravida Munnetra Kazhagam,93855,249,94104,45.87,Tamil Nadu-Veppanahalli
4,M.Sakthivel,Naam Tamilar Katchi,8287,23,8310,4.05,Tamil Nadu-Veppanahalli
5,S.Thangapandiyan,Tamil Nadu Ilangyar Katchi,416,3,419,0.2,Tamil Nadu-Veppanahalli
6,M.Mariyappan,Puthiya Tamilagam,225,1,226,0.11,Tamil Nadu-Veppanahalli
7,Valli,Anna Puratchi Thalaivar Amma Dravida Munnetra Kazhagam,124,7,131,0.06,Tamil Nadu-Veppanahalli
8,P.Jayapal,Makkal Needhi Maiam,667,5,672,0.33,Tamil Nadu-Veppanahalli
9,Abdul Azeez Amanullah,Independent,3015,7,3022,1.47,Tamil Nadu-Veppanahalli
10,Usha,Independent,146,8,154,0.08,Tamil Nadu-Veppanahalli
11,Krishnamoorthy,Independent,154,1,155,0.08,Tamil Nadu-Veppanahalli
12,C.Chakkarlappa,Independent,403,2,405,0.2,Tamil Nadu-Veppanahalli
13,K.P.U.UVARAJ,Independent,285,0,285,0.14,Tamil Nadu-Veppanahalli
14,Ramaswamy,Independent,565,2,567,0.28,Tamil Nadu-Veppanahalli
15,Lakshmanan Shanmugam,Independent,376,2,378,0.18,Tamil Nadu-Veppanahalli
16,NOTA,None of the Above,1661,1,1662,0.81,Tamil Nadu-Veppanahalli
1,ARUMUGAM C,Bahujan Samaj Party,517,3,520,0.27,Tamil Nadu-Vikravandi
2,PUGAZHENTHI N,Dravida Munnetra Kazhagam,92621,1109,93730,48.41,Tamil Nadu-Vikravandi
3,MUTHAMILSELVAN R,All India Anna Dravida Munnetra Kazhagam,83258,899,84157,43.47,Tamil Nadu-Vikravandi
4,ELANGOVAN S,Akhil Bharat Hindu Mahasabha,652,3,655,0.34,Tamil Nadu-Vikravandi
5,IYYANAR R,Amma Makkal Munnettra Kazagam,3039,14,3053,1.58,Tamil Nadu-Vikravandi
6,SENTHIL R,Indiya Jananayaka Katchi,204,3,207,0.11,Tamil Nadu-Vikravandi
7,RAJIVGANDHI P,Naadaalum Makkal Katchi,95,1,96,0.05,Tamil Nadu-Vikravandi
8,SHEEBA ASHMI R,Naam Tamilar Katchi,8141,75,8216,4.24,Tamil Nadu-Vikravandi
9,IYYAPPAN K,Independent,54,0,54,0.03,Tamil Nadu-Vikravandi
10,AYYANAR A,Independent,75,3,78,0.04,Tamil Nadu-Vikravandi
11,KANNADHASAN A,Independent,73,8,81,0.04,Tamil Nadu-Vikravandi
12,GAYATHRI J,Independent,303,2,305,0.16,Tamil Nadu-Vikravandi
13,SATHISH R,Independent,436,0,436,0.23,Tamil Nadu-Vikravandi
14,RAGHUPATHY P,Independent,906,1,907,0.47,Tamil Nadu-Vikravandi
15,NOTA,None of the Above,1108,14,1122,0.58,Tamil Nadu-Vikravandi
1,CHINNAPPAN P,All India Anna Dravida Munnetra Kazhagam,51237,562,51799,30.99,Tamil Nadu-Vilathikulam
2,MANIKKARAJ A,Bahujan Samaj Party,480,7,487,0.29,Tamil Nadu-Vilathikulam
3,MARKANDAYAN V,Dravida Munnetra Kazhagam,89130,1218,90348,54.05,Tamil Nadu-Vilathikulam
4,KARUPPASAMY K,Naam Indiar Party,610,3,613,0.37,Tamil Nadu-Vilathikulam
5,GANDHI M,Bahujan Dravida Party,119,2,121,0.07,Tamil Nadu-Vilathikulam
6,SEENI SELVI K,Amma Makkal Munnettra Kazagam,6591,66,6657,3.98,Tamil Nadu-Vilathikulam
7,BALAJI R,Naam Tamilar Katchi,11697,131,11828,7.08,Tamil Nadu-Vilathikulam
8,MARIMUTHU S,South India Forward Bloc,398,6,404,0.24,Tamil Nadu-Vilathikulam
9,MUTHUKUMAR C,Puthiya Tamilagam,1029,26,1055,0.63,Tamil Nadu-Vilathikulam
10,WILSON X,Makkal Needhi Maiam,1511,9,1520,0.91,Tamil Nadu-Vilathikulam
11,ARUMUGAPERUMAL K,Independent,263,5,268,0.16,Tamil Nadu-Vilathikulam
12,ARUMUGAM S,Independent,272,0,272,0.16,Tamil Nadu-Vilathikulam
13,CHELLADURAI S,Independent,310,2,312,0.19,Tamil Nadu-Vilathikulam
14,MURUGANANTHAM M,Independent,347,1,348,0.21,Tamil Nadu-Vilathikulam
15,RAJAMANI P,Independent,101,0,101,0.06,Tamil Nadu-Vilathikulam
16,NOTA,None of the Above,1017,19,1036,0.62,Tamil Nadu-Vilathikulam
1,IDEN SONI L,Desiya Murpokku Dravida Kazhagam,2415,32,2447,1.46,Tamil Nadu-Vilavancode
2,VIJAYADHARANI S,Indian National Congress,86227,1246,87473,52.12,Tamil Nadu-Vilavancode
3,JAYASEELAN R,Bharatiya Janata Party,58156,648,58804,35.04,Tamil Nadu-Vilavancode
4,MARY ADLIN,Naam Tamilar Katchi,12120,172,12292,7.32,Tamil Nadu-Vilavancode
5,RAJAKUMAR R,Makkal Needhi Maiam,626,11,637,0.38,Tamil Nadu-Vilavancode
6,RAJESH KUMAR S,National Democratic Party of South India,77,2,79,0.05,Tamil Nadu-Vilavancode
7,VASANTHEESWARAN E,Ulaga Makkal Katchi,234,1,235,0.14,Tamil Nadu-Vilavancode
8,WILSON G,Shiv Sena,161,0,161,0.1,Tamil Nadu-Vilavancode
9,AMOSE S,Independent,431,5,436,0.26,Tamil Nadu-Vilavancode
10,SATHEESH S,Independent,183,2,185,0.11,Tamil Nadu-Vilavancode
11,SAMUEL GEORGE KALAI ARASAR,Independent,3492,49,3541,2.11,Tamil Nadu-Vilavancode
12,MARIASELVAN Y,Independent,122,0,122,0.07,Tamil Nadu-Vilavancode
13,MOHAN KUMAR M,Independent,198,0,198,0.12,Tamil Nadu-Vilavancode
14,RAJA MURRUGAN K H,Independent,150,0,150,0.09,Tamil Nadu-Vilavancode
15,VIJAYAKUMAR P,Independent,293,1,294,0.18,Tamil Nadu-Vilavancode
16,NOTA,None of the Above,774,8,782,0.47,Tamil Nadu-Vilavancode
1,D.Subamangalam,Desiya Murpokku Dravida Kazhagam,1081,13,1094,0.76,Tamil Nadu-Villivakkam
2,A.Palanivel,Bahujan Samaj Party,221,1,222,0.15,Tamil Nadu-Villivakkam
3,J.C.D.Prabhakar,All India Anna Dravida Munnetra Kazhagam,38601,289,38890,26.99,Tamil Nadu-Villivakkam
4,A . Vetriazhagan,Dravida Munnetra Kazhagam,75347,780,76127,52.83,Tamil Nadu-Villivakkam
5,L.Govindaraj,Nam India Naam Indiyar Katchi,188,1,189,0.13,Tamil Nadu-Villivakkam
6,S. Raju Bharathi,Desiya Makkal Sakthi Katchi,88,0,88,0.06,Tamil Nadu-Villivakkam
7,Jagadesh Jayakumar,Valamaana  Tamizhagam   Katchi,261,0,261,0.18,Tamil Nadu-Villivakkam
8,R.Sridar,Naam Tamilar Katchi,10846,68,10914,7.57,Tamil Nadu-Villivakkam
9,Sriharan,Makkal Needhi Maiam,13282,82,13364,9.27,Tamil Nadu-Villivakkam
10,C.A.Ashok Kumar,Independent,39,1,40,0.03,Tamil Nadu-Villivakkam
11,A . Ajith Kumar,Independent,80,0,80,0.06,Tamil Nadu-Villivakkam
12,G.Iyanar,Independent,34,2,36,0.02,Tamil Nadu-Villivakkam
13,S.Kandasamy,Independent,68,6,74,0.05,Tamil Nadu-Villivakkam
14,M.Gunasekaran,Independent,206,0,206,0.14,Tamil Nadu-Villivakkam
15,A.S.Kumar,Independent,42,0,42,0.03,Tamil Nadu-Villivakkam
16,S.Chandrika,Independent,193,1,194,0.13,Tamil Nadu-Villivakkam
17,Syed Rayhan,Independent,409,0,409,0.28,Tamil Nadu-Villivakkam
18,G. Devapriyan,Independent,27,0,27,0.02,Tamil Nadu-Villivakkam
19,S.Baskar,Independent,171,0,171,0.12,Tamil Nadu-Villivakkam
20,M.Murali Vinodh,Independent,98,0,98,0.07,Tamil Nadu-Villivakkam
21,C.Mohan,Independent,54,0,54,0.04,Tamil Nadu-Villivakkam
22,C.Raghul,Independent,24,1,25,0.02,Tamil Nadu-Villivakkam
23,M .Jalal,Independent,43,0,43,0.03,Tamil Nadu-Villivakkam
24,NOTA,None of the Above,1430,14,1444,1,Tamil Nadu-Villivakkam
1,LAKSHMANAN R,Dravida Munnetra Kazhagam,100423,1848,102271,49.92,Tamil Nadu-Villupuram
2,SHANMUGAM C Ve,All India Anna Dravida Munnetra Kazhagam,86368,1035,87403,42.66,Tamil Nadu-Villupuram
3,SIVABALAN N,Bahujan Samaj Party,412,3,415,0.2,Tamil Nadu-Villupuram
4,SELVAM J,Naam Tamilar Katchi,6314,61,6375,3.11,Tamil Nadu-Villupuram
5,DASS K,Makkal Needhi Maiam,3207,35,3242,1.58,Tamil Nadu-Villupuram
6,DURAISAMY D,Makkal Munnetra Peravai,318,4,322,0.16,Tamil Nadu-Villupuram
7,DEVANATHAN N,Veerath Thiyagi Viswanathadoss Thozhilalarkal Katchi,118,0,118,0.06,Tamil Nadu-Villupuram
8,BALASUNDARAM R,Amma Makkal Munnettra Kazagam,1684,11,1695,0.83,Tamil Nadu-Villupuram
9,MOHAMED IBRAIM A,Anna Dravidar Kazhagam,32,0,32,0.02,Tamil Nadu-Villupuram
10,VICTOR A S,Desiya Sirupanmayinar Makkal Iyakkam,78,0,78,0.04,Tamil Nadu-Villupuram
11,INIYADAYALAN G,Independent,19,0,19,0.01,Tamil Nadu-Villupuram
12,IYYANAR G,Independent,34,0,34,0.02,Tamil Nadu-Villupuram
13,KUPPAN V,Independent,67,0,67,0.03,Tamil Nadu-Villupuram
14,KUMAR R,Independent,66,0,66,0.03,Tamil Nadu-Villupuram
15,KESAVAN P,Independent,321,0,321,0.16,Tamil Nadu-Villupuram
16,SHANMUGAM A,Independent,491,0,491,0.24,Tamil Nadu-Villupuram
17,SHANMUGAM G,Independent,371,0,371,0.18,Tamil Nadu-Villupuram
18,SHANMUGAM V,Independent,233,0,233,0.11,Tamil Nadu-Villupuram
19,SUBRAMANIAN R,Independent,25,2,27,0.01,Tamil Nadu-Villupuram
20,DAKSHINAMOORTHY SU VA,Independent,47,1,48,0.02,Tamil Nadu-Villupuram
21,NARENDIRAN D,Independent,23,0,23,0.01,Tamil Nadu-Villupuram
22,BALU K,Independent,42,0,42,0.02,Tamil Nadu-Villupuram
23,PRABAKARAN M,Independent,35,0,35,0.02,Tamil Nadu-Villupuram
24,RAMAN K,Independent,78,0,78,0.04,Tamil Nadu-Villupuram
25,JAIAADHE R,Independent,84,0,84,0.04,Tamil Nadu-Villupuram
26,NOTA,None of the Above,960,10,970,0.47,Tamil Nadu-Villupuram
1,ALAGURAJA.V,Bahujan Samaj Party,263,0,263,0.14,Tamil Nadu-Viralimalai
2,PALANIAPPAN,Dravida Munnetra Kazhagam,78028,553,78581,40.63,Tamil Nadu-Viralimalai
3,VIJAYA BASKER C,All India Anna Dravida Munnetra Kazhagam,101676,503,102179,52.83,Tamil Nadu-Viralimalai
4,AZHAGU MEENA P,Naam Tamilar Katchi,7013,22,7035,3.64,Tamil Nadu-Viralimalai
5,ARUMUGAM P,Puthiya Tamilagam,213,2,215,0.11,Tamil Nadu-Viralimalai
6,KARTHI PRABHAKARAN O,Amma Makkal Munnettra Kazagam,1220,8,1228,0.63,Tamil Nadu-Viralimalai
7,SARAVANAN R,Makkal Needhi Maiam,559,0,559,0.29,Tamil Nadu-Viralimalai
8,SENTHILKUMAR P,My India Party,35,0,35,0.02,Tamil Nadu-Viralimalai
9,VIJAY A,Anna Dravidar Kazhagam,26,0,26,0.01,Tamil Nadu-Viralimalai
10,ABDUL NAZAR K,Independent,33,0,33,0.02,Tamil Nadu-Viralimalai
11,ELAYARAJA R,Independent,37,0,37,0.02,Tamil Nadu-Viralimalai
12,SYEED MOHAMED J,Independent,50,0,50,0.03,Tamil Nadu-Viralimalai
13,DHANALAKSHMI.M,Independent,618,2,620,0.32,Tamil Nadu-Viralimalai
14,THIRUVENTHIRAN V,Independent,508,1,509,0.26,Tamil Nadu-Viralimalai
15,PALANISAMY A,Independent,239,2,241,0.12,Tamil Nadu-Viralimalai
16,BALASUBRAMANIAN M,Independent,156,0,156,0.08,Tamil Nadu-Viralimalai
17,MANIKANDAN K,Independent,73,0,73,0.04,Tamil Nadu-Viralimalai
18,MANIKANDAN. C,Independent,291,0,291,0.15,Tamil Nadu-Viralimalai
19,RAMESH M,Independent,504,0,504,0.26,Tamil Nadu-Viralimalai
20,RAMESHKUMAR.P,Independent,93,0,93,0.05,Tamil Nadu-Viralimalai
21,RAJAVARMAN R,Independent,119,0,119,0.06,Tamil Nadu-Viralimalai
22,JOTHIVEL A,Independent,191,0,191,0.1,Tamil Nadu-Viralimalai
23,NOTA,None of the Above,385,0,385,0.2,Tamil Nadu-Viralimalai
1,SEENIVASAN A.R.R,Dravida Munnetra Kazhagam,71909,1388,73297,45.32,Tamil Nadu-Virudhunagar
2,PANDURANGAN G,Bharatiya Janata Party,51502,456,51958,32.13,Tamil Nadu-Virudhunagar
3,SUYAMBULINGAM L,Naam Indiar Party,587,3,590,0.36,Tamil Nadu-Virudhunagar
4,SELVAKUMAR V.R,Naam Tamilar Katchi,14162,149,14311,8.85,Tamil Nadu-Virudhunagar
5,THANGARAJ M,Amma Makkal Munnettra Kazagam,10642,141,10783,6.67,Tamil Nadu-Virudhunagar
6,MANIMARAN N,All India Samathuva Makhal Katchi,4996,58,5054,3.13,Tamil Nadu-Virudhunagar
7,VIKRAMAN N,Desa Makkal Munnetrak Kazhgam,200,0,200,0.12,Tamil Nadu-Virudhunagar
8,KARUPPIAH P,Independent,84,1,85,0.05,Tamil Nadu-Virudhunagar
9,GUNASEKARAN G,Independent,1377,29,1406,0.87,Tamil Nadu-Virudhunagar
10,GURUNATHAN G,Independent,64,0,64,0.04,Tamil Nadu-Virudhunagar
11,SHIBI B,Independent,261,3,264,0.16,Tamil Nadu-Virudhunagar
12,THANGAPANDI N,Independent,85,4,89,0.06,Tamil Nadu-Virudhunagar
13,THANGARAJ R,Independent,93,0,93,0.06,Tamil Nadu-Virudhunagar
14,DHAMOTHARAN R,Independent,119,0,119,0.07,Tamil Nadu-Virudhunagar
15,PANDURENGAN T,Independent,279,3,282,0.17,Tamil Nadu-Virudhunagar
16,PUNGAN K,Independent,758,1,759,0.47,Tamil Nadu-Virudhunagar
17,RAMARAJ C,Independent,463,2,465,0.29,Tamil Nadu-Virudhunagar
18,VELUCHAMY S,Independent,328,0,328,0.2,Tamil Nadu-Virudhunagar
19,NOTA,None of the Above,1556,14,1570,0.97,Tamil Nadu-Virudhunagar
1,B.PARTHASARATHY,Desiya Murpokku Dravida Kazhagam,1584,1,1585,0.94,Tamil Nadu-Virugampakkam
2,AMV.PRABHAKARA RAJA,Dravida Munnetra Kazhagam,73814,537,74351,43.97,Tamil Nadu-Virugampakkam
3,VIRUGAI V.N.RAVI,All India Anna Dravida Munnetra Kazhagam,55526,458,55984,33.11,Tamil Nadu-Virugampakkam
4,M.S.ISMAIL KHAN,All India Jananayaka Makkal Kazhagam,206,3,209,0.12,Tamil Nadu-Virugampakkam
5,SENEGAN,Makkal Needhi Maiam,16871,68,16939,10.02,Tamil Nadu-Virugampakkam
6,G.THANIGACHALAM,Veerath Thiyagi Viswanathadoss Thozhilalarkal Katchi,90,0,90,0.05,Tamil Nadu-Virugampakkam
7,S.R.DINESH KUMAR,Anna MGR Dravida Makkal Kalgam,40,1,41,0.02,Tamil Nadu-Virugampakkam
8,R.PRABAHARAN,Tamizhaga Murpokku Makkal Katchi,63,2,65,0.04,Tamil Nadu-Virugampakkam
9,MANJU,Anaithu Makkal Arasiyal Katchi,89,1,90,0.05,Tamil Nadu-Virugampakkam
10,G.RAVI,Rashtriya Janata Dal,69,4,73,0.04,Tamil Nadu-Virugampakkam
11,T.S.RAJENDRAN,Naam Tamilar Katchi,10153,32,10185,6.02,Tamil Nadu-Virugampakkam
12,M.ELLANGOVAN,Independent,68,4,72,0.04,Tamil Nadu-Virugampakkam
13,V.K.KATHIR,Independent,48,0,48,0.03,Tamil Nadu-Virugampakkam
14,S.GUNASEKAR,Independent,86,2,88,0.05,Tamil Nadu-Virugampakkam
15,M.GUNASEKARAN (A) STAR M.GUNASEKARAN,Independent,5165,21,5186,3.07,Tamil Nadu-Virugampakkam
16,V.GUNASEKARAN,Independent,131,0,131,0.08,Tamil Nadu-Virugampakkam
17,E.SANKAR,Independent,68,0,68,0.04,Tamil Nadu-Virugampakkam
18,SATHASIVAM,Independent,344,0,344,0.2,Tamil Nadu-Virugampakkam
19,M.SIVAKUMAR,Independent,119,0,119,0.07,Tamil Nadu-Virugampakkam
20,M.SRINIVASAN,Independent,49,0,49,0.03,Tamil Nadu-Virugampakkam
21,D.SUNDAR SINGH,Independent,56,0,56,0.03,Tamil Nadu-Virugampakkam
22,V.K.SENTHIL KUMAR,Independent,24,0,24,0.01,Tamil Nadu-Virugampakkam
23,V.THALAPATHI,Independent,49,0,49,0.03,Tamil Nadu-Virugampakkam
24,D.PRABAKARAN,Independent,55,1,56,0.03,Tamil Nadu-Virugampakkam
25,K.BOOPATHY,Independent,34,0,34,0.02,Tamil Nadu-Virugampakkam
26,M.MANNU,Independent,146,2,148,0.09,Tamil Nadu-Virugampakkam
27,R.MAYILSAMY,Independent,1436,4,1440,0.85,Tamil Nadu-Virugampakkam
28,NOTA,None of the Above,1551,12,1563,0.92,Tamil Nadu-Virugampakkam
1,A. Ayyasamy,Bahujan Samaj Party,461,7,468,0.24,Tamil Nadu-Vriddhachalam
2,Premalatha Vijayakant,Desiya Murpokku Dravida Kazhagam,25790,118,25908,13.17,Tamil Nadu-Vriddhachalam
3,Radhakrishnan,Indian National Congress,75892,1172,77064,39.17,Tamil Nadu-Vriddhachalam
4,N. Amutha,Naam Tamilar Katchi,8603,39,8642,4.39,Tamil Nadu-Vriddhachalam
5,B. Arasi,Rashtriya Janata Dal,404,1,405,0.21,Tamil Nadu-Vriddhachalam
6,Karthikeyan. J,Pattali Makkal Katchi,75585,617,76202,38.73,Tamil Nadu-Vriddhachalam
7,R. Kesavaperumal,Tamil Nadu Ilangyar Katchi,887,4,891,0.45,Tamil Nadu-Vriddhachalam
8,Sathiyanathan,Anaithu Makkal Puratchi Katchi,272,1,273,0.14,Tamil Nadu-Vriddhachalam
9,Sivasankar,New Generation Peopleâ€™s Party,178,1,179,0.09,Tamil Nadu-Vriddhachalam
10,R. Parthasarathi,Indiya Jananayaka Katchi,822,19,841,0.43,Tamil Nadu-Vriddhachalam
11,G. Pichamuthu,Desiya Sirupanmayinar Makkal Iyakkam,323,0,323,0.16,Tamil Nadu-Vriddhachalam
12,S. Aruljothi,Independent,86,0,86,0.04,Tamil Nadu-Vriddhachalam
13,M. Anwar Basha,Independent,298,2,300,0.15,Tamil Nadu-Vriddhachalam
14,S. Sadhasivam,Independent,245,1,246,0.13,Tamil Nadu-Vriddhachalam
15,M. Sathiyaseelan,Independent,261,0,261,0.13,Tamil Nadu-Vriddhachalam
16,R. Saravanan,Independent,398,0,398,0.2,Tamil Nadu-Vriddhachalam
17,K.P.Senthilmurugan,Independent,270,0,270,0.14,Tamil Nadu-Vriddhachalam
18,C. Dhanasekar,Independent,268,0,268,0.14,Tamil Nadu-Vriddhachalam
19,Perumal,Independent,485,0,485,0.25,Tamil Nadu-Vriddhachalam
20,S. Mahaveer Chand,Independent,175,0,175,0.09,Tamil Nadu-Vriddhachalam
21,A. Manikandan,Independent,108,1,109,0.06,Tamil Nadu-Vriddhachalam
22,S. Muruganantham,Independent,526,1,527,0.27,Tamil Nadu-Vriddhachalam
23,S. Radhakrishnan,Independent,101,2,103,0.05,Tamil Nadu-Vriddhachalam
24,N. Radhika,Independent,193,1,194,0.1,Tamil Nadu-Vriddhachalam
25,P. Ramasamy,Independent,74,0,74,0.04,Tamil Nadu-Vriddhachalam
26,Ramadoss  S,Independent,114,1,115,0.06,Tamil Nadu-Vriddhachalam
27,K. Ravichandiran,Independent,156,0,156,0.08,Tamil Nadu-Vriddhachalam
28,T. Veeramani,Independent,148,0,148,0.08,Tamil Nadu-Vriddhachalam
29,Stalin,Independent,859,3,862,0.44,Tamil Nadu-Vriddhachalam
30,NOTA,None of the Above,757,4,761,0.39,Tamil Nadu-Vriddhachalam
1,C. KUMAR,Desiya Murpokku Dravida Kazhagam,2962,24,2986,1.25,Tamil Nadu-Yercaud
2,G. Chitra,All India Anna Dravida Munnetra Kazhagam,120542,1019,121561,50.88,Tamil Nadu-Yercaud
3,C. TAMILSELVAN,Dravida Munnetra Kazhagam,93927,1679,95606,40.02,Tamil Nadu-Yercaud
4,P. Ramasamy,Bahujan Samaj Party,579,0,579,0.24,Tamil Nadu-Yercaud
5,T. Duraisamy,Indiya Jananayaka Katchi,870,6,876,0.37,Tamil Nadu-Yercaud
6,Jothi,Naam Tamilar Katchi,13214,94,13308,5.57,Tamil Nadu-Yercaud
7,S.T. Rajendhiran,Independent,158,7,165,0.07,Tamil Nadu-Yercaud
8,K. UNNAMALAI,Independent,109,1,110,0.05,Tamil Nadu-Yercaud
9,P. SATHISHKUMAR,Independent,148,0,148,0.06,Tamil Nadu-Yercaud
10,Santhosam,Independent,165,2,167,0.07,Tamil Nadu-Yercaud
11,T. Priya,Independent,284,5,289,0.12,Tamil Nadu-Yercaud
12,K. Manikandan,Independent,485,5,490,0.21,Tamil Nadu-Yercaud
13,D. MADESH,Independent,659,1,660,0.28,Tamil Nadu-Yercaud
14,NOTA,None of the Above,1955,24,1979,0.83,Tamil Nadu-Yercaud
1,DEBA PRASAD ROY,Indian National Congress,15203,448,15651,7.03,West Bengal-Alipurduars
2,SUMAN KANJILAL,Bharatiya Janata Party,105517,1816,107333,48.19,West Bengal-Alipurduars
3,SOURAV CHAKRABORTY (GHUTIS),All India Trinamool Congress,90183,1143,91326,41,West Bengal-Alipurduars
4,PIJUSH KANTI SARMA,SOCIALIST UNITY CENTRE OF INDIA (COMMUNIST),1090,21,1111,0.5,West Bengal-Alipurduars
5,ABINASH DAS,Independent,267,3,270,0.12,West Bengal-Alipurduars
6,ASHIM ROY,Independent,677,19,696,0.31,West Bengal-Alipurduars
7,KUSHAL KUMAR ROY,Independent,613,7,620,0.28,West Bengal-Alipurduars
8,NIKHIL CHANDRA RAIBIR,Independent,2333,18,2351,1.06,West Bengal-Alipurduars
9,RINKU GHOSH,Independent,1384,9,1393,0.63,West Bengal-Alipurduars
10,NOTA,None of the Above,1950,31,1981,0.89,West Bengal-Alipurduars
1,JOYDEV MANNA,Bharatiya Janata Party,63238,217,63455,29.97,West Bengal-Amdanga
2,RAFIQUR RAHAMAN,All India Trinamool Congress,88689,246,88935,42,West Bengal-Amdanga
3,SHAFIQUE ALI,Bahujan Samaj Party,1036,2,1038,0.49,West Bengal-Amdanga
4,GOUTAM BISWAS,SOCIALIST UNITY CENTRE OF INDIA (COMMUNIST),567,4,571,0.27,West Bengal-Amdanga
5,JAMAL UDDIN,Rashtriya Secular Majlis Party,50797,108,50905,24.04,West Bengal-Amdanga
6,SAHAJAN ALI,United Socialist Party,968,0,968,0.46,West Bengal-Amdanga
7,HARI PADA BISWAS,Lok Jan Shakti Party,518,0,518,0.24,West Bengal-Amdanga
8,MAFID MONDAL,Independent,1289,1,1290,0.61,West Bengal-Amdanga
9,RANJIT SANTRA,Independent,1738,0,1738,0.82,West Bengal-Amdanga
10,NOTA,None of the Above,2314,10,2324,1.1,West Bengal-Amdanga
1,ASIT MITRA,Indian National Congress,25081,28,25109,12.02,West Bengal-Amta
2,DEBTANU BHATTACHARYA,Bharatiya Janata Party,76180,60,76240,36.51,West Bengal-Amta
3,SUKANTA KUMAR PAUL,All India Trinamool Congress,102344,101,102445,49.06,West Bengal-Amta
4,SANJEEB SANTRA,SOCIALIST UNITY CENTRE OF INDIA (COMMUNIST),1136,3,1139,0.55,West Bengal-Amta
5,DILIP KUMAR HAIT,Independent,526,0,526,0.25,West Bengal-Amta
6,BISWANATH DAS,Independent,1265,1,1266,0.61,West Bengal-Amta
7,RATAN CHANDRA MALICK,Independent,783,0,783,0.37,West Bengal-Amta
8,NOTA,None of the Above,1302,0,1302,0.62,West Bengal-Amta
1,BANKIM CHANDRA SANTRA,Bahujan Samaj Party,2761,19,2780,1.26,West Bengal-Arambag
2,MADHUSUDAN BAG,Bharatiya Janata Party,102518,590,103108,46.88,West Bengal-Arambag
3,SAKTI MOHON MALIK,Communist Party of India  (Marxist),14841,124,14965,6.8,West Bengal-Arambag
4,SUJATA MONDAL,All India Trinamool Congress,95332,604,95936,43.62,West Bengal-Arambag
5,NOTA,None of the Above,3163,8,3171,1.44,West Bengal-Arambag
1,Krishnendu Mukherjee,Bharatiya Janata Party,79143,678,79821,41.38,West Bengal-Asansol Uttar
2,Ghatak Moloy,All India Trinamool Congress,99691,1240,100931,52.32,West Bengal-Asansol Uttar
3,Danish Aziz,All India Majlis-E-Ittehadul Muslimeen,1494,20,1514,0.78,West Bengal-Asansol Uttar
4,Mohammad Mustaqim,Rashtriya Secular Majlis Party,4335,136,4471,2.32,West Bengal-Asansol Uttar
5,Sanjoy Chatterjee,SOCIALIST UNITY CENTRE OF INDIA (COMMUNIST),497,13,510,0.26,West Bengal-Asansol Uttar
6,Nani Gopal Dawn,Independent,634,5,639,0.33,West Bengal-Asansol Uttar
7,Sunil Thakur,Independent,1667,6,1673,0.87,West Bengal-Asansol Uttar
8,NOTA,None of the Above,3321,27,3348,1.74,West Bengal-Asansol Uttar
1,JAGADISH RAY,Bahujan Samaj Party,1051,2,1053,0.49,West Bengal-Ashoknagar
2,TANUJA CHAKRABORTY,Bharatiya Janata Party,69505,550,70055,32.32,West Bengal-Ashoknagar
3,NARAYAN GOSWAMI,All India Trinamool Congress,92573,1014,93587,43.18,West Bengal-Ashoknagar
4,ANGSHUMALI BARAI,Guru Chand Mukti Morcha,1269,9,1278,0.59,West Bengal-Ashoknagar
5,TAPAS BANERJEE,Rashtriya Secular Majlis Party,45386,409,45795,21.13,West Bengal-Ashoknagar
6,TARAK RAJAK DAS,SOCIALIST UNITY CENTRE OF INDIA (COMMUNIST),737,2,739,0.34,West Bengal-Ashoknagar
7,TANUJA CHAKRABORTY,Independent,1551,5,1556,0.72,West Bengal-Ashoknagar
8,DR. SUMAY HIRA,Independent,1045,5,1050,0.48,West Bengal-Ashoknagar
9,NOTA,None of the Above,1604,7,1611,0.74,West Bengal-Ashoknagar
1,AGNIMITRA PAUL,Bharatiya Janata Party,87156,725,87881,45.13,West Bengal-Asnsol Dakshin
2,PRASANTA GHOSH,Communist Party of India  (Marxist),15720,252,15972,8.2,West Bengal-Asnsol Dakshin
3,SAYANI GHOSH,All India Trinamool Congress,82464,930,83394,42.82,West Bengal-Asnsol Dakshin
4,SINGHASAN PASWAN,Bahujan Samaj Party,2854,13,2867,1.47,West Bengal-Asnsol Dakshin
5,SHIULI RUIDAS,Bahujan Mukti Party,1149,8,1157,0.59,West Bengal-Asnsol Dakshin
6,NOTA,None of the Above,3442,24,3466,1.78,West Bengal-Asnsol Dakshin
1,ABHEDANANDA THANDER,All India Trinamool Congress,99837,555,100392,46.25,West Bengal-Ausgram
2,KALITA MAJI,Bharatiya Janata Party,88262,315,88577,40.8,West Bengal-Ausgram
3,CHANCHAL KUMAR MAJHI,Communist Party of India  (Marxist),20309,90,20399,9.4,West Bengal-Ausgram
4,SRIDAM GOLDAR,Bahujan Samaj Party,1700,1,1701,0.78,West Bengal-Ausgram
5,MANASA METE,SOCIALIST UNITY CENTRE OF INDIA (COMMUNIST),1972,0,1972,0.91,West Bengal-Ausgram
6,NOTA,None of the Above,4037,2,4039,1.86,West Bengal-Ausgram
1,ABDUR RAHIM QUAZI,All India Trinamool Congress,109200,501,109701,51.53,West Bengal-Baduria
2,ABDUS SATTAR,Indian National Congress,45095,136,45231,21.25,West Bengal-Baduria
3,GOPAL DAS,Bahujan Samaj Party,1268,10,1278,0.6,West Bengal-Baduria
4,SUKALYAN BAIDYA,Bharatiya Janata Party,52930,327,53257,25.02,West Bengal-Baduria
5,NITAI KRISHNA PAL,SOCIALIST UNITY CENTRE OF INDIA (COMMUNIST),616,3,619,0.29,West Bengal-Baduria
6,SAFIKUL ISLAM DAFADAR,Independent,844,0,844,0.4,West Bengal-Baduria
7,NOTA,None of the Above,1952,1,1953,0.92,West Bengal-Baduria
1,Kirttaniya Prabir (Bapi),Indian National Congress,8099,151,8250,3.77,West Bengal-Bagda
2,Paritosh Kumar Saha,All India Trinamool Congress,97335,984,98319,44.94,West Bengal-Bagda
3,Biswajit Das,Bharatiya Janata Party,107242,869,108111,49.41,West Bengal-Bagda
4,Santosh  Biswas,Bahujan Samaj Party,2229,11,2240,1.02,West Bengal-Bagda
5,Pradip Kumar Biswas,Independent,848,3,851,0.39,West Bengal-Bagda
6,NOTA,None of the Above,1012,8,1020,0.47,West Bengal-Bagda
1,Debranjan Mahato,All India Forward Bloc,11733,109,11842,5.74,West Bengal-Baghmundi
2,Nepal Chandra Mahato,Indian National Congress,50615,431,51046,24.74,West Bengal-Baghmundi
3,Sushanta Mahato,All India Trinamool Congress,75245,660,75905,36.79,West Bengal-Baghmundi
4,Ashutosh Mahato,AJSU Party,61510,426,61936,30.02,West Bengal-Baghmundi
5,Pashupati Mahato,Amra Bangalee,1992,8,2000,0.97,West Bengal-Baghmundi
6,Mrityunjoy Singh Babu,SOCIALIST UNITY CENTRE OF INDIA (COMMUNIST),1182,6,1188,0.58,West Bengal-Baghmundi
7,NOTA,None of the Above,2375,11,2386,1.16,West Bengal-Baghmundi
1,Anupam Mallik,Bharatiya Janata Party,75781,141,75922,37.97,West Bengal-Bagnan
2,Arunava Sen (Raja),All India Trinamool Congress,105867,175,106042,53.04,West Bengal-Bagnan
3,Sk Bosir Ahmed,Communist Party of India  (Marxist),14512,43,14555,7.28,West Bengal-Bagnan
4,Pampa Sarkar Bera,SOCIALIST UNITY CENTRE OF INDIA (COMMUNIST),462,2,464,0.23,West Bengal-Bagnan
5,Ramesh Khanra,Independent,213,1,214,0.11,West Bengal-Bagnan
6,Subhasish Adhikary,Independent,284,0,284,0.14,West Bengal-Bagnan
7,Sanjit Patra,Independent,906,0,906,0.45,West Bengal-Bagnan
8,NOTA,None of the Above,1546,2,1548,0.77,West Bengal-Bagnan
1,Naru Gopal Mukherjee,All India Trinamool Congress,61835,653,62488,31.62,West Bengal-Baharampur
2,Manoj Chakraborty,Indian National Congress,39377,790,40167,20.33,West Bengal-Baharampur
3,Sajal Sen,Bahujan Samaj Party,1081,7,1088,0.55,West Bengal-Baharampur
4,Subrata Maitra (Kanchan),Bharatiya Janata Party,87759,1581,89340,45.21,West Bengal-Baharampur
5,Goutam Ghosh (Dwarak Ghosh),SOCIALIST UNITY CENTRE OF INDIA (COMMUNIST),1029,9,1038,0.53,West Bengal-Baharampur
6,Rekha Roy,Bahujan Mukti Party,413,1,414,0.21,West Bengal-Baharampur
7,Sujit Kumar Das,Independent,547,0,547,0.28,West Bengal-Baharampur
8,NOTA,None of the Above,2504,21,2525,1.28,West Bengal-Baharampur
1,AZIZUL HOQUE,Indian National Congress,37201,242,37443,17.95,West Bengal-Baisnabnagar
2,CHANDANA SARKAR,All India Trinamool Congress,82593,468,83061,39.81,West Bengal-Baisnabnagar
3,NIKHIL CHANDRA MANDAL,Bahujan Samaj Party,2280,2,2282,1.09,West Bengal-Baisnabnagar
4,SWADHIN KUMAR SARKAR,Bharatiya Janata Party,80094,496,80590,38.62,West Bengal-Baisnabnagar
5,KURBAN ANSARI,Independent,1247,0,1247,0.6,West Bengal-Baisnabnagar
6,SAMIR GHOSH,Independent,978,0,978,0.47,West Bengal-Baisnabnagar
7,HARENDRANATH SARKAR,Independent,1344,2,1346,0.65,West Bengal-Baisnabnagar
8,NOTA,None of the Above,1704,1,1705,0.82,West Bengal-Baisnabnagar
1,MANORANJAN BAPARI,All India Trinamool Congress,99524,840,100364,45.63,West Bengal-Balagarh
2,MAHAMAYA MONDAL,Communist Party of India  (Marxist),19592,174,19766,8.99,West Bengal-Balagarh
3,SUBHAS CHANDRA HALDAR,Bharatiya Janata Party,93993,587,94580,43,West Bengal-Balagarh
4,SUKDEB BISWAS,SOCIALIST UNITY CENTRE OF INDIA (COMMUNIST),2133,9,2142,0.97,West Bengal-Balagarh
5,NOTA,None of the Above,3098,7,3105,1.41,West Bengal-Balagarh
1,ANANDI TUDU,Bahujan Samaj Party,1410,6,1416,0.72,West Bengal-Balarampur
2,UTTAM KUMAR BANDYOPADHYAY,Indian National Congress,8842,53,8895,4.49,West Bengal-Balarampur
3,BANESWAR MAHATO,Bharatiya Janata Party,88803,718,89521,45.22,West Bengal-Balarampur
4,SHANTIRAM MAHATO,All India Trinamool Congress,88530,568,89098,45.01,West Bengal-Balarampur
5,DIPAK KUMAR,SOCIALIST UNITY CENTRE OF INDIA (COMMUNIST),1791,2,1793,0.91,West Bengal-Balarampur
6,SITARAM HANSDA,Ambedkarite Party of India,2150,3,2153,1.09,West Bengal-Balarampur
7,SUBHASH MAHATO,Bharateeya Manavadhikar party,1167,3,1170,0.59,West Bengal-Balarampur
8,ASWINI SINGH SARDAR,Independent,1467,11,1478,0.75,West Bengal-Balarampur
9,NOTA,None of the Above,2432,9,2441,1.23,West Bengal-Balarampur
1,DIPSITA DHAR,Communist Party of India  (Marxist),21924,116,22040,17.51,West Bengal-Bally
2,BAISHALI DALMIYA,Bharatiya Janata Party,46992,118,47110,37.43,West Bengal-Bally
3,RANA CHATTERJEE,All India Trinamool Congress,53223,124,53347,42.38,West Bengal-Bally
4,PUTUL CHOWDHURY,SOCIALIST UNITY CENTRE OF INDIA (COMMUNIST),442,0,442,0.35,West Bengal-Bally
5,INDRANATH DAS,Independent,98,0,98,0.08,West Bengal-Bally
6,UJJWALA BISWAS,Independent,82,0,82,0.07,West Bengal-Bally
7,GOUTAM DAS,Independent,93,0,93,0.07,West Bengal-Bally
8,JITENDRA PRASAD,Independent,292,0,292,0.23,West Bengal-Bally
9,MAYA SAMANTA,Independent,171,1,172,0.14,West Bengal-Bally
10,RAJKUMAR DHANUK,Independent,586,1,587,0.47,West Bengal-Bally
11,SURYA KANTA GHOSH,Independent,404,0,404,0.32,West Bengal-Bally
12,NOTA,None of the Above,1203,2,1205,0.96,West Bengal-Bally
1,Dr. Fuad Halim,Communist Party of India  (Marxist),8428,46,8474,5.61,West Bengal-Ballygunge
2,LOKENATH CHATTERJEE,Bharatiya Janata Party,31054,172,31226,20.68,West Bengal-Ballygunge
3,Rajendra Ram Das,Bahujan Samaj Party,808,4,812,0.54,West Bengal-Ballygunge
4,Subrata Mukherjee,All India Trinamool Congress,106223,362,106585,70.6,West Bengal-Ballygunge
5,ANIRBAN SAHA,Purvanchal Mahapanchayat,538,3,541,0.36,West Bengal-Ballygunge
6,CHHANDA SAHA,Bharatiya Nyay-Adhikar Raksha Party,576,4,580,0.38,West Bengal-Ballygunge
7,SEKH SADIK HUSSAIN,United Socialist Party,116,2,118,0.08,West Bengal-Ballygunge
8,AMITAVA DUTTA,Independent,194,1,195,0.13,West Bengal-Ballygunge
9,KAUSHIK GHOSHAL,Independent,642,1,643,0.43,West Bengal-Ballygunge
10,SANTANU SAHA,Independent,213,0,213,0.14,West Bengal-Ballygunge
11,ZUBIN RASHID,Independent,258,0,258,0.17,West Bengal-Ballygunge
12,NOTA,None of the Above,1314,3,1317,0.87,West Bengal-Ballygunge
1,Ashok Kumar Lahiri,Bharatiya Janata Party,70484,1645,72129,47.42,West Bengal-Balurghat
2,Jogesh Chandra Murmu,Bahujan Samaj Party,1138,3,1141,0.75,West Bengal-Balurghat
3,Sekhar Dasgupta,All India Trinamool Congress,57885,808,58693,38.59,West Bengal-Balurghat
4,Sucheta Biswas,Revolutionary Socialist Party,15706,447,16153,10.62,West Bengal-Balurghat
5,Anup Barman,Kamatapur Peopleâ€™s Party (United),353,0,353,0.23,West Bengal-Balurghat
6,Dulal Barman,Bahujan Mukti Party,377,2,379,0.25,West Bengal-Balurghat
7,Narottam Saha,Amra Bangalee,808,2,810,0.53,West Bengal-Balurghat
8,BIRENDRA NATH MAHANTA,SOCIALIST UNITY CENTRE OF INDIA (COMMUNIST),596,8,604,0.4,West Bengal-Balurghat
9,NOTA,None of the Above,1810,20,1830,1.2,West Bengal-Balurghat
1,TIKARAM HEMBRAM,Bahujan Samaj Party,2976,11,2987,1.24,West Bengal-Bandwan
2,PARCY MURMU,Bharatiya Janata Party,93298,1208,94506,39.21,West Bengal-Bandwan
3,BESRA SUSANTA KUMAR,Communist Party of India  (Marxist),21928,276,22204,9.21,West Bengal-Bandwan
4,RAJIB LOCHAN SAREN,All India Trinamool Congress,112183,1154,113337,47.02,West Bengal-Bandwan
5,SIB SANKAR SINGH,Independent,5008,59,5067,2.1,West Bengal-Bandwan
6,NOTA,None of the Above,2939,15,2954,1.23,West Bengal-Bandwan
1,ALO RANI SARKAR,All India Trinamool Congress,94889,935,95824,46.11,West Bengal-Bangaon Dakshin
2,TAPAS KUMAR BISWAS,Communist Party of India  (Marxist),9894,175,10069,4.84,West Bengal-Bangaon Dakshin
3,PRADIP KUMAR SARKAR,Bahujan Samaj Party,818,2,820,0.39,West Bengal-Bangaon Dakshin
4,SWAPAN MAJUMDER,Bharatiya Janata Party,96862,966,97828,47.07,West Bengal-Bangaon Dakshin
5,RABINDRA NATH BARAI,SOCIALIST UNITY CENTRE OF INDIA (COMMUNIST),947,6,953,0.46,West Bengal-Bangaon Dakshin
6,ALOKE BAIN,Independent,461,1,462,0.22,West Bengal-Bangaon Dakshin
7,SUSHANTA KUMAR SARKAR,Independent,332,4,336,0.16,West Bengal-Bangaon Dakshin
8,NOTA,None of the Above,1529,13,1542,0.74,West Bengal-Bangaon Dakshin
1,ASHOK KIRTANIA,Bharatiya Janata Party,96676,1085,97761,47.65,West Bengal-Bangaon Uttar
2,PIJUSH KANTI SAHA,Communist Party of India  (Marxist),13780,271,14051,6.85,West Bengal-Bangaon Uttar
3,SHYAMAL ROY,All India Trinamool Congress,86403,870,87273,42.54,West Bengal-Bangaon Uttar
4,SUNITI MALLICK,Bahujan Samaj Party,1078,4,1082,0.53,West Bengal-Bangaon Uttar
5,ARPITA MONDAL,Amra Bangalee,423,2,425,0.21,West Bengal-Bangaon Uttar
6,SHYAMSUNDAR HALDAR,SOCIALIST UNITY CENTRE OF INDIA (COMMUNIST),226,2,228,0.11,West Bengal-Bangaon Uttar
7,SUBRATA BISWAS,Bahujan Mukti Party,140,1,141,0.07,West Bengal-Bangaon Uttar
8,ARABINDA BISWAS,Independent,320,1,321,0.16,West Bengal-Bangaon Uttar
9,DINESH DAS,Independent,1478,2,1480,0.72,West Bengal-Bangaon Uttar
10,SUBHASIS BISWAS,Independent,578,2,580,0.28,West Bengal-Bangaon Uttar
11,NOTA,None of the Above,1818,15,1833,0.89,West Bengal-Bangaon Uttar
1,NILADRI SEKHAR DANA,Bharatiya Janata Party,94470,996,95466,43.79,West Bengal-Bankura
2,RADHARANI BANERJEE,Indian National Congress,13542,222,13764,6.31,West Bengal-Bankura
3,SADHAN CHATTARAJ,Bahujan Samaj Party,1305,9,1314,0.6,West Bengal-Bankura
4,SAYANTIKA BANERJEE,All India Trinamool Congress,93093,905,93998,43.12,West Bengal-Bankura
5,LINA GHOSH,SOCIALIST UNITY CENTRE OF INDIA (COMMUNIST),1699,21,1720,0.79,West Bengal-Bankura
6,HULU KSHETRAPAL,Bahujan Mukti Party,501,8,509,0.23,West Bengal-Bankura
7,BAIDYANATH KISKU,Independent,495,8,503,0.23,West Bengal-Bankura
8,SK. HASIMUDDIN,Independent,884,4,888,0.41,West Bengal-Bankura
9,SWADESH MANDAL,Independent,3280,23,3303,1.52,West Bengal-Bankura
10,SWAPAN KUMAR DAS,Independent,1031,12,1043,0.48,West Bengal-Bankura
11,HARIPADA MAHATO,Independent,970,1,971,0.45,West Bengal-Bankura
12,NOTA,None of the Above,4491,16,4507,2.07,West Bengal-Bankura
1,ARIJIT ROY,Bharatiya Janata Party,64477,496,64973,38.4,West Bengal-Barabani
2,BIDHAN UPADHYAY,All India Trinamool Congress,87251,1179,88430,52.26,West Bengal-Barabani
3,RANENDRA NATH BAGCHI,Indian National Congress,8764,198,8962,5.3,West Bengal-Barabani
4,DEBSHWAR BESRA,SOCIALIST UNITY CENTRE OF INDIA (COMMUNIST),973,12,985,0.58,West Bengal-Barabani
5,SANJAY MAJHI,Bahujan Mukti Party,661,1,662,0.39,West Bengal-Barabani
6,PABAN NUNIA,Independent,2152,4,2156,1.27,West Bengal-Barabani
7,NOTA,None of the Above,3024,15,3039,1.8,West Bengal-Barabani
1,AMAL KUMAR MUKHOPADHYAY,Indian National Congress,19883,252,20135,12.56,West Bengal-Baranagar
2,TAPAS ROY,All India Trinamool Congress,84756,859,85615,53.42,West Bengal-Baranagar
3,PARNO MITTRA,Bharatiya Janata Party,50155,313,50468,31.49,West Bengal-Baranagar
4,SURAJIT GHOSH,National Republic Party Of India,535,3,538,0.34,West Bengal-Baranagar
5,SHYAMAL CK,Independent,491,4,495,0.31,West Bengal-Baranagar
6,SUBRATA DE,Independent,628,2,630,0.39,West Bengal-Baranagar
7,NOTA,None of the Above,2365,13,2378,1.48,West Bengal-Baranagar
1,CHIRANJEET CHAKRABARTI,All India Trinamool Congress,103956,475,104431,46.27,West Bengal-Barasat
2,SANKAR CHATTERJEE,Bharatiya Janata Party,80189,459,80648,35.73,West Bengal-Barasat
3,SANJIB CHATTOPADHYAY,All India Forward Bloc,33933,238,34171,15.14,West Bengal-Barasat
4,SUNIL CHANDRA ROY,Bahujan Samaj Party,934,6,940,0.42,West Bengal-Barasat
5,KSHAMA DEBNATH (PANDA),SOCIALIST UNITY CENTRE OF INDIA (COMMUNIST),415,3,418,0.19,West Bengal-Barasat
6,MOHAN LAL ADHIKARI,Amra Bangalee,568,8,576,0.26,West Bengal-Barasat
7,SUDARSHAN DAS,Jan Sangh Party,490,6,496,0.22,West Bengal-Barasat
8,AMIT KUMAR CHAKRABORTY,Independent,565,7,572,0.25,West Bengal-Barasat
9,TARUN DHAR,Independent,765,2,767,0.34,West Bengal-Barasat
10,NOTA,None of the Above,2678,10,2688,1.19,West Bengal-Barasat
1,ALOK MUKHERJEE,All India Trinamool Congress,92672,618,93290,42.51,West Bengal-Barjora
2,SUJIT CHAKRABORTY,Communist Party of India  (Marxist),25015,220,25235,11.5,West Bengal-Barjora
3,SUPRITI CHATTERJEE,Bharatiya Janata Party,89460,561,90021,41.02,West Bengal-Barjora
4,BABLU GORAI,Bahujan Mukti Party,1365,6,1371,0.62,West Bengal-Barjora
5,SUDARSHAN ADHIKARI,SOCIALIST UNITY CENTRE OF INDIA (COMMUNIST),1157,3,1160,0.53,West Bengal-Barjora
6,TARANI ROY,Independent,2076,5,2081,0.95,West Bengal-Barjora
7,SATYAM BAURI,Independent,1390,1,1391,0.63,West Bengal-Barjora
8,NOTA,None of the Above,4894,9,4903,2.23,West Bengal-Barjora
1,CHANDRAMANI SHUKLA,Bharatiya Janata Party,59255,410,59665,40.25,West Bengal-Barrackpur
2,TAPASH SARKAR,Bahujan Samaj Party,955,15,970,0.65,West Bengal-Barrackpur
3,DEBASISH BHOWMICK,Communist Party of India  (Marxist),15932,213,16145,10.89,West Bengal-Barrackpur
4,RAJU CHAKRABORTY (RAJ),All India Trinamool Congress,68441,446,68887,46.47,West Bengal-Barrackpur
5,KUMAR BISHAL YADAB,Independent,650,2,652,0.44,West Bengal-Barrackpur
6,NOTA,None of the Above,1923,7,1930,1.3,West Bengal-Barrackpur
1,AJIT BAUL,Bahujan Samaj Party,910,2,912,0.43,West Bengal-Baruipur Paschim
2,DEBOPAM CHATTOPADHYAYA(BABU),Bharatiya Janata Party,58774,322,59096,27.97,West Bengal-Baruipur Paschim
3,BIMAN BANERJEE,All India Trinamool Congress,120184,822,121006,57.27,West Bengal-Baruipur Paschim
4,MD LAHEK ALI,Communist Party of India  (Marxist),25458,181,25639,12.13,West Bengal-Baruipur Paschim
5,ANANDA KUNDU,Independent,384,1,385,0.18,West Bengal-Baruipur Paschim
6,MUKUL MONDAL,Independent,398,1,399,0.19,West Bengal-Baruipur Paschim
7,RANESWAR DAS,Independent,1766,3,1769,0.84,West Bengal-Baruipur Paschim
8,SUKUMAR NASKAR,Independent,550,1,551,0.26,West Bengal-Baruipur Paschim
9,NOTA,None of the Above,1528,8,1536,0.73,West Bengal-Baruipur Paschim
1,CHANDAN MONDAL,Bharatiya Janata Party,73238,364,73602,32.7,West Bengal-Baruipur Purba
2,BIVAS SARDAR (VOBO),All India Trinamool Congress,122337,906,123243,54.75,West Bengal-Baruipur Purba
3,SANKAR DEB MONDAL,Bahujan Samaj Party,1389,4,1393,0.62,West Bengal-Baruipur Purba
4,SWAPAN NASKAR,Communist Party of India  (Marxist),21365,102,21467,9.54,West Bengal-Baruipur Purba
5,JOYDEV NASKAR,SOCIALIST UNITY CENTRE OF INDIA (COMMUNIST),1513,12,1525,0.68,West Bengal-Baruipur Purba
6,CHINMAY NASKAR,Independent,399,3,402,0.18,West Bengal-Baruipur Purba
7,SNEHASIS SAHA,Independent,1624,3,1627,0.72,West Bengal-Baruipur Purba
8,NOTA,None of the Above,1851,4,1855,0.82,West Bengal-Baruipur Purba
1,RAMESH MAJHI,Bharatiya Janata Party,60313,498,60811,28.43,West Bengal-Basanti
2,SHYAMAL MONDAL,All India Trinamool Congress,110508,945,111453,52.1,West Bengal-Basanti
3,SUBHAS NASKAR,Revolutionary Socialist Party,36489,199,36688,17.15,West Bengal-Basanti
4,NIMAI CHANDRA MONDAL,SOCIALIST UNITY CENTRE OF INDIA (COMMUNIST),685,3,688,0.32,West Bengal-Basanti
5,DEBABRATA MONDAL,Independent,722,6,728,0.34,West Bengal-Basanti
6,BISWAJIT MONDAL,Independent,1631,4,1635,0.76,West Bengal-Basanti
7,NOTA,None of the Above,1905,2,1907,0.89,West Bengal-Basanti
1,AMIT MAJUMDAR,Indian National Congress,22943,146,23089,9.79,West Bengal-Basirhat Dakshin
2,TARAK NATH GHOSH,Bharatiya Janata Party,90646,759,91405,38.77,West Bengal-Basirhat Dakshin
3,DEBASHIS SARKAR,Bahujan Samaj Party,1465,5,1470,0.62,West Bengal-Basirhat Dakshin
4,DR. SAPTARSHI BANERJEE,All India Trinamool Congress,115378,495,115873,49.15,West Bengal-Basirhat Dakshin
5,AJAY KUMAR BAIN,SOCIALIST UNITY CENTRE OF INDIA (COMMUNIST),1342,5,1347,0.57,West Bengal-Basirhat Dakshin
6,AKTAR RASUL BACHHU,"Justice and Development Party,",859,5,864,0.37,West Bengal-Basirhat Dakshin
7,NOTA,None of the Above,1680,9,1689,0.72,West Bengal-Basirhat Dakshin
1,NARAYAN CHANDRA MONDAL,Bharatiya Janata Party,47236,269,47505,19.92,West Bengal-Basirhat Uttar
2,RAFIKUL ISLAM MONDAL,All India Trinamool Congress,136617,599,137216,57.55,West Bengal-Basirhat Uttar
3,MD BAIJID AMIN,Rashtriya Secular Majlis Party,47739,126,47865,20.08,West Bengal-Basirhat Uttar
4,MD KASED ALI SARDAR,Independent,1870,4,1874,0.79,West Bengal-Basirhat Uttar
5,TASLIMA KHATUN,Independent,2009,5,2014,0.84,West Bengal-Basirhat Uttar
6,NOTA,None of the Above,1946,6,1952,0.82,West Bengal-Basirhat Uttar
1,AMAL DHALI,Bahujan Samaj Party,855,7,862,0.37,West Bengal-Behala Paschim
2,NIHAR BHAKTA,Communist Party of India  (Marxist),47156,353,47509,20.49,West Bengal-Behala Paschim
3,PARTHA CHATTERJEE,All India Trinamool Congress,113787,991,114778,49.51,West Bengal-Behala Paschim
4,SRABANTI CHATTERJEE,Bharatiya Janata Party,63500,394,63894,27.56,West Bengal-Behala Paschim
5,ARUNA RAY,Independent,527,5,532,0.23,West Bengal-Behala Paschim
6,MRIDUL OJHA,Independent,550,0,550,0.24,West Bengal-Behala Paschim
7,SANAT KUMAR BHAKAT,Independent,872,1,873,0.38,West Bengal-Behala Paschim
8,VIJAY KUMAR SINGH,Independent,384,1,385,0.17,West Bengal-Behala Paschim
9,NOTA,None of the Above,2415,18,2433,1.05,West Bengal-Behala Paschim
1,Payel Sarkar,Bharatiya Janata Party,73137,403,73540,33.15,West Bengal-Behala Purba
2,Ratna Chatterjee,All India Trinamool Congress,110294,674,110968,50.01,West Bengal-Behala Purba
3,Rina Roy,Bahujan Samaj Party,1158,17,1175,0.53,West Bengal-Behala Purba
4,Samita Har Chowdhury,Communist Party of India  (Marxist),29945,227,30172,13.6,West Bengal-Behala Purba
5,Ashis Kumar Danda,SOCIALIST UNITY CENTRE OF INDIA (COMMUNIST),658,5,663,0.3,West Bengal-Behala Purba
6,Dr. Arun Kumar Giri,Independent,269,2,271,0.12,West Bengal-Behala Purba
7,Bholanath Patra,Independent,262,3,265,0.12,West Bengal-Behala Purba
8,Dhiman Debnath,Independent,142,1,143,0.06,West Bengal-Behala Purba
9,Nikhilesh Ghosh,Independent,270,0,270,0.12,West Bengal-Behala Purba
10,Subrata Roy,Independent,398,5,403,0.18,West Bengal-Behala Purba
11,Tulsi Rani Pramanik,Independent,1163,4,1167,0.53,West Bengal-Behala Purba
12,NOTA,None of the Above,2729,106,2835,1.28,West Bengal-Behala Purba
1,SAFIUJJAMAN SEIKH,Indian National Congress,26742,207,26949,13.18,West Bengal-Beldanga
2,SUMIT GHOSH,Bharatiya Janata Party,58417,613,59030,28.86,West Bengal-Beldanga
3,HASANUZZAMAN SK,All India Trinamool Congress,112173,689,112862,55.19,West Bengal-Beldanga
4,MD: SAGIR HOSSAIN,Democratic Socialist Party of India,1173,3,1176,0.58,West Bengal-Beldanga
5,SARIFUL ISLAM,SOCIALIST UNITY CENTRE OF INDIA (COMMUNIST),472,6,478,0.23,West Bengal-Beldanga
6,KAJAL GHOSH BISWAS,Independent,1965,3,1968,0.96,West Bengal-Beldanga
7,MUKTI PADA KONAI,Independent,678,2,680,0.33,West Bengal-Beldanga
8,NOTA,None of the Above,1361,7,1368,0.67,West Bengal-Beldanga
1,ARJUN KUMAR DAS,Bahujan Samaj Party,751,6,757,0.48,West Bengal-Beleghata
2,KASHINATH BISWAS,Bharatiya Janata Party,35817,225,36042,22.74,West Bengal-Beleghata
3,PARESH PAUL,All India Trinamool Congress,102478,704,103182,65.1,West Bengal-Beleghata
4,RAJIB BISWAS,Communist Party of India  (Marxist),13908,137,14045,8.86,West Bengal-Beleghata
5,BAPI PAUL,Akhil Bharat Hindu Mahasabha,204,2,206,0.13,West Bengal-Beleghata
6,TARUN KUMAR DAS,SOCIALIST UNITY CENTRE OF INDIA (COMMUNIST),164,4,168,0.11,West Bengal-Beleghata
7,AVIJIT GHOSH,Independent,134,0,134,0.08,West Bengal-Beleghata
8,DIP SANKAR NAIYA,Independent,89,5,94,0.06,West Bengal-Beleghata
9,MANASH CHOWDHURY,Independent,84,2,86,0.05,West Bengal-Beleghata
10,RAKESH SHAW,Independent,166,11,177,0.11,West Bengal-Beleghata
11,SHAHAWAZ AFZAL,Independent,435,2,437,0.28,West Bengal-Beleghata
12,SURENDAR TEWARI,Independent,1168,0,1168,0.74,West Bengal-Beleghata
13,SUSOVAN DUTTA,Independent,445,1,446,0.28,West Bengal-Beleghata
14,NOTA,None of the Above,1559,5,1564,0.99,West Bengal-Beleghata
1,Anita Rajwar,Bahujan Samaj Party,555,9,564,0.44,West Bengal-Bhabanipur
2,Md. Shadab Khan,Indian National Congress,5159,52,5211,4.09,West Bengal-Bhabanipur
3,Rudranil Ghosh,Bharatiya Janata Party,44541,245,44786,35.16,West Bengal-Bhabanipur
4,Sobhandeb Chattopadhyay,All India Trinamool Congress,73048,457,73505,57.71,West Bengal-Bhabanipur
5,Ashraf Alam,Independent,487,1,488,0.38,West Bengal-Bhabanipur
6,Bikki Rajak,Independent,282,1,283,0.22,West Bengal-Bhabanipur
7,Chandan Mallick,Independent,520,3,523,0.41,West Bengal-Bhabanipur
8,Deepak Prasad Singh,Independent,230,4,234,0.18,West Bengal-Bhabanipur
9,Narayan Das,Independent,207,5,212,0.17,West Bengal-Bhabanipur
10,NOTA,None of the Above,1563,7,1570,1.23,West Bengal-Bhabanipur
1,IDRIS ALI,All India Trinamool Congress,153430,365,153795,68.05,West Bengal-Bhagabangola
2,Mehebub Alam,Bharatiya Janata Party,16652,55,16707,7.39,West Bengal-Bhagabangola
3,MD. KAMAL HOSSAIN,Communist Party of India  (Marxist),47512,275,47787,21.15,West Bengal-Bhagabangola
4,SEIKH RABIUL ALAM,Bahujan Samaj Party,783,1,784,0.35,West Bengal-Bhagabangola
5,ABDUL MABUD NAYAN,SOCIALIST UNITY CENTRE OF INDIA (COMMUNIST),447,2,449,0.2,West Bengal-Bhagabangola
6,ALI HOSSAIN,United Socialist Party,265,0,265,0.12,West Bengal-Bhagabangola
7,REJAUL KARIM SK,Indian Union Muslim League,614,3,617,0.27,West Bengal-Bhagabangola
8,MST. SIKHA KHATUN,Bahujan Maha Party,421,0,421,0.19,West Bengal-Bhagabangola
9,MD. NURUL ISLAM,Independent,289,1,290,0.13,West Bengal-Bhagabangola
10,MD. MOSARAF HOSSAIN,Independent,827,0,827,0.37,West Bengal-Bhagabangola
11,SYED IMRAN ALI MEERZA,Independent,652,0,652,0.29,West Bengal-Bhagabangola
12,NOTA,None of the Above,3392,4,3396,1.5,West Bengal-Bhagabangola
1,ARDHENDU MAITY,All India Trinamool Congress,93228,703,93931,42.19,West Bengal-Bhagabanpur
2,RABINDRANATH MAITY,Bharatiya Janata Party,120633,847,121480,54.56,West Bengal-Bhagabanpur
3,SHIU MAITI,Indian National Congress,5192,82,5274,2.37,West Bengal-Bhagabanpur
4,ASOKTARU PRADHAN,SOCIALIST UNITY CENTRE OF INDIA (COMMUNIST),938,8,946,0.42,West Bengal-Bhagabanpur
5,NOTA,None of the Above,1013,6,1019,0.46,West Bengal-Bhagabanpur
1,KARIM REZAUL,All India Trinamool Congress,82850,236,83086,34.31,West Bengal-Bhangar
2,SOUMI HATI,Bharatiya Janata Party,38636,90,38726,15.99,West Bengal-Bhangar
3,TAPAN GHOSH,SOCIALIST UNITY CENTRE OF INDIA (COMMUNIST),933,4,937,0.39,West Bengal-Bhangar
4,MD. NAWSAD SIDDIQUE,Rashtriya Secular Majlis Party,109063,174,109237,45.1,West Bengal-Bhangar
5,MIRJA HASAN,Communist Party of India (Marxist-Leninist) Red Star,4925,5,4930,2.04,West Bengal-Bhangar
6,ISMAIL  MOLLA,Independent,720,3,723,0.3,West Bengal-Bhangar
7,NOUSHAR ALI MOLLA,Independent,1301,2,1303,0.54,West Bengal-Bhangar
8,NOTA,None of the Above,3243,0,3243,1.34,West Bengal-Bhangar
1,IMAN KALYAN MUKHERJEE,Bharatiya Janata Party,52809,334,53143,28.11,West Bengal-Bharatpur
2,KAMALESH CHATTERJEE (GOPAL),Indian National Congress,30013,103,30116,15.93,West Bengal-Bharatpur
3,SHYAMAPADA GHOSH,Bahujan Samaj Party,1445,5,1450,0.77,West Bengal-Bharatpur
4,HUMAYUN KABIR,All India Trinamool Congress,95906,320,96226,50.9,West Bengal-Bharatpur
5,BADAN GHOSH,Amra Bangalee,2581,0,2581,1.37,West Bengal-Bharatpur
6,SAJJAD HOSSAIN,All India Majlis-E-Ittehadul Muslimeen,2067,9,2076,1.1,West Bengal-Bharatpur
7,BASUDEB SAHA,Independent,1010,1,1011,0.53,West Bengal-Bharatpur
8,NOTA,None of the Above,2441,3,2444,1.29,West Bengal-Bharatpur
1,ADHIKARI MANGOBINDA,All India Trinamool Congress,107294,734,108028,50.44,West Bengal-Bhatar
2,NAZRUL HAQUE,Communist Party of India  (Marxist),19478,129,19607,9.15,West Bengal-Bhatar
3,MAHENDRANATH KOWAR,Bharatiya Janata Party,75957,330,76287,35.62,West Bengal-Bhatar
4,SUKUL SAREN,Bahujan Samaj Party,1569,6,1575,0.74,West Bengal-Bhatar
5,MAINUDDIN SAH,Lok Jan Shakti Party,475,5,480,0.22,West Bengal-Bhatar
6,AYAN GHOSH,Independent,823,5,828,0.39,West Bengal-Bhatar
7,NAZRUL ISLAM,Independent,1866,2,1868,0.87,West Bengal-Bhatar
8,SOMNATH SAIN,Independent,1147,2,1149,0.54,West Bengal-Bhatar
9,NOTA,None of the Above,4342,4,4346,2.03,West Bengal-Bhatar
1,AJAY KUMAR RAM,Bahujan Samaj Party,677,5,682,0.64,West Bengal-Bhatpara
2,JITENDRA SHAW (JITU),All India Trinamool Congress,43385,172,43557,40.63,West Bengal-Bhatpara
3,DHARMENDRA SHAW,Indian National Congress,2144,25,2169,2.02,West Bengal-Bhatpara
4,PAWAN KUMAR SINGH,Bharatiya Janata Party,57050,194,57244,53.4,West Bengal-Bhatpara
5,PARTHA BHATTACHARYYA,SOCIALIST UNITY CENTRE OF INDIA (COMMUNIST),590,2,592,0.55,West Bengal-Bhatpara
6,UDAY VEER CHOUDHURY,Independent,190,1,191,0.18,West Bengal-Bhatpara
7,VINOD KISHOR VERMA,Independent,743,1,744,0.69,West Bengal-Bhatpara
8,MUNEEL KUMAR RAJAK,Independent,248,0,248,0.23,West Bengal-Bhatpara
9,SABARI CHOWDHURY,Independent,609,1,610,0.57,West Bengal-Bhatpara
10,NOTA,None of the Above,1146,14,1160,1.08,West Bengal-Bhatpara
1,ABHISEK BANERJEE,Indian National Congress,12664,157,12821,7.91,West Bengal-Bidhannagar
2,SABYA SACHI DUTTA S/O - LATE GOURI SANKAR DUTTA,Bharatiya Janata Party,67548,367,67915,41.91,West Bengal-Bidhannagar
3,SMRITI KANA HOWLADER,Bahujan Samaj Party,604,7,611,0.38,West Bengal-Bidhannagar
4,SUJIT BOSE S/O - LATE AJIT BOSE,All India Trinamool Congress,75306,606,75912,46.85,West Bengal-Bidhannagar
5,BIPLAB KUMAR  HALDER,Independent,453,1,454,0.28,West Bengal-Bidhannagar
6,SABYASACHI DUTTA S/O - LATE SHYAMAL DUTTA,Independent,540,5,545,0.34,West Bengal-Bidhannagar
7,SAMIR SARDAR,Independent,643,4,647,0.4,West Bengal-Bidhannagar
8,SUJIT BOSE S/O - LATE SAMIR BOSE,Independent,485,11,496,0.31,West Bengal-Bidhannagar
9,SUSOMA LOHO,Independent,417,4,421,0.26,West Bengal-Bidhannagar
10,NOTA,None of the Above,2198,15,2213,1.37,West Bengal-Bidhannagar
1,ARJUN KRISHNA BARAI,Bahujan Samaj Party,871,7,878,0.63,West Bengal-Bijpur
2,SUBHRANSHU ROY,Bharatiya Janata Party,52873,405,53278,38.3,West Bengal-Bijpur
3,SUKANTA RAKSHIT (BABIN),Communist Party of India  (Marxist),14267,223,14490,10.42,West Bengal-Bijpur
4,SUBODH ADHIKARY,All India Trinamool Congress,65954,671,66625,47.9,West Bengal-Bijpur
5,KALIPADA DEBNATH,SOCIALIST UNITY CENTRE OF INDIA (COMMUNIST),1534,8,1542,1.11,West Bengal-Bijpur
6,AVIJIT BISWAS,Independent,391,5,396,0.28,West Bengal-Bijpur
7,SUDHANSU SAHA,Independent,651,9,660,0.47,West Bengal-Bijpur
8,NOTA,None of the Above,1222,5,1227,0.88,West Bengal-Bijpur
1,DIBAKAR HANSDA,Communist Party of India  (Marxist),8268,85,8353,4.42,West Bengal-Binpur
2,DEBNATH HANSDA,All India Trinamool Congress,99786,491,100277,53.11,West Bengal-Binpur
3,PATAL CHANDRA MURMU,Bahujan Samaj Party,3526,4,3530,1.87,West Bengal-Binpur
4,PALAN SAREN,Bharatiya Janata Party,60213,570,60783,32.19,West Bengal-Binpur
5,RAJIB MUDI,SOCIALIST UNITY CENTRE OF INDIA (COMMUNIST),1729,3,1732,0.92,West Bengal-Binpur
6,NITYALAL SING,Independent,6308,10,6318,3.35,West Bengal-Binpur
7,BABLU MURMU,Independent,2679,6,2685,1.42,West Bengal-Binpur
8,MANGAL CHANDRA SARDAR,Independent,1813,2,1815,0.96,West Bengal-Binpur
9,NOTA,None of the Above,3296,9,3305,1.75,West Bengal-Binpur
1,AGNISWAR NASKAR,Bharatiya Janata Party,77379,298,77677,32.7,West Bengal-Bishnupur
2,JHUMA KAYAL,Communist Party of India  (Marxist),17866,129,17995,7.57,West Bengal-Bishnupur
3,DILIP MONDAL,All India Trinamool Congress,135620,889,136509,57.46,West Bengal-Bishnupur
4,RABINDRANATH RANJAN,Bahujan Samaj Party,2697,12,2709,1.14,West Bengal-Bishnupur
5,UTTAM NASKAR,Independent,815,2,817,0.34,West Bengal-Bishnupur
6,NOTA,None of the Above,1861,2,1863,0.78,West Bengal-Bishnupur
1,ARCHITA BID,All India Trinamool Congress,77610,659,78269,40.88,West Bengal-Bishnupur
2,TANMAY GHOSH (BUMBA),Bharatiya Janata Party,88743,946,89689,46.84,West Bengal-Bishnupur
3,DEBU CHATTERJEE,Indian National Congress,15649,165,15814,8.26,West Bengal-Bishnupur
4,BASUDEB SIKARI,Bahujan Mukti Party,980,5,985,0.51,West Bengal-Bishnupur
5,SHASHIBHUSAN BANERJEE,SOCIALIST UNITY CENTRE OF INDIA (COMMUNIST),1007,8,1015,0.53,West Bengal-Bishnupur
6,BAIDYANATH ROY,Independent,2270,8,2278,1.19,West Bengal-Bishnupur
7,NOTA,None of the Above,3395,24,3419,1.79,West Bengal-Bishnupur
1,ANIRBAN GANGULY,Bharatiya Janata Party,92871,1292,94163,40.89,West Bengal-Bolpur
2,JITEN RAY,Bahujan Samaj Party,1229,10,1239,0.54,West Bengal-Bolpur
3,TAPAN HORE,Revolutionary Socialist Party,9748,217,9965,4.33,West Bengal-Bolpur
4,SINHA CHANDRANATH,All India Trinamool Congress,114842,1601,116443,50.57,West Bengal-Bolpur
5,MIHIR KUMAR BANERJEE,Rashtravadi Janata Party,1168,1,1169,0.51,West Bengal-Bolpur
6,SAMARJIT BARMAN,SOCIALIST UNITY CENTRE OF INDIA (COMMUNIST),669,9,678,0.29,West Bengal-Bolpur
7,SIDDHARTHA BANERJEE,Paradise Party,1935,3,1938,0.84,West Bengal-Bolpur
8,SK SIRAJUL HOQUE,Mulnibasi Party of India,623,3,626,0.27,West Bengal-Bolpur
9,SONA MURMU,Bahujan Mukti Party,699,3,702,0.3,West Bengal-Bolpur
10,NOTA,None of the Above,3316,21,3337,1.45,West Bengal-Bolpur
1,ASHOK KUMAR DEB,All India Trinamool Congress,121401,956,122357,56.41,West Bengal-Budge Budge
2,DR. TARUN KUMAR ADAK,Bharatiya Janata Party,77224,419,77643,35.8,West Bengal-Budge Budge
3,BHARAT LAL DAS,Bahujan Samaj Party,922,10,932,0.43,West Bengal-Budge Budge
4,SK MUJIBAR RAHAMAN,Indian National Congress,10687,122,10809,4.98,West Bengal-Budge Budge
5,UTTAM PAL,SOCIALIST UNITY CENTRE OF INDIA (COMMUNIST),508,7,515,0.24,West Bengal-Budge Budge
6,KASHYAP UPADHYAY,Independent,367,4,371,0.17,West Bengal-Budge Budge
7,BISWAJIT DAS,Independent,385,2,387,0.18,West Bengal-Budge Budge
8,MUKUL CHANDRA JANA,Independent,1138,5,1143,0.53,West Bengal-Budge Budge
9,NOTA,None of the Above,2726,9,2735,1.26,West Bengal-Budge Budge
1,KHOKAN DAS,All India Trinamool Congress,90166,849,91015,44.32,West Bengal-Burdwan Dakshin
2,PUSPA HANSDA,Bahujan Samaj Party,1452,3,1455,0.71,West Bengal-Burdwan Dakshin
3,PRITHA TAH,Communist Party of India  (Marxist),23056,290,23346,11.37,West Bengal-Burdwan Dakshin
4,SANDIP NANDI,Bharatiya Janata Party,82328,582,82910,40.38,West Bengal-Burdwan Dakshin
5,ANIRUDDHA KUNDU,SOCIALIST UNITY CENTRE OF INDIA (COMMUNIST),791,6,797,0.39,West Bengal-Burdwan Dakshin
6,RAJIB PASWAN,National Republic Party Of India,983,0,983,0.48,West Bengal-Burdwan Dakshin
7,LUXMI NARAYAN KORA,Bahujan Mukti Party,549,2,551,0.27,West Bengal-Burdwan Dakshin
8,ARINDAM GHOSH,Independent,581,0,581,0.28,West Bengal-Burdwan Dakshin
9,NOTA,None of the Above,3697,10,3707,1.81,West Bengal-Burdwan Dakshin
1,CHANDI CHORAN LET,Communist Party of India  (Marxist),30817,211,31028,12.83,West Bengal-Burdwan Uttar
2,NISITH KUMAR MALIK,All India Trinamool Congress,110411,800,111211,45.97,West Bengal-Burdwan Uttar
3,RADHA KANTA ROY,Bharatiya Janata Party,93449,494,93943,38.83,West Bengal-Burdwan Uttar
4,RAMKRISHNA MALIK,Bahujan Samaj Party,3341,6,3347,1.38,West Bengal-Burdwan Uttar
5,NOTA,None of the Above,2388,8,2396,0.99,West Bengal-Burdwan Uttar
1,AMIYA KUMAR DAS,Bharatiya Janata Party,78680,461,79141,44.76,West Bengal-Burwan
2,JIBAN KRISHNA SAHA,All India Trinamool Congress,81320,570,81890,46.32,West Bengal-Burwan
3,SHILADITYA HALDAR,Indian National Congress,12166,94,12260,6.93,West Bengal-Burwan
4,NARESH KUMAR DAS,Independent,1501,3,1504,0.85,West Bengal-Burwan
5,NOTA,None of the Above,2002,6,2008,1.14,West Bengal-Burwan
1,ARNAB ROY,Bharatiya Janata Party,75414,402,75816,34.72,West Bengal-Canning Paschim
2,Paresh Ram Das,All India Trinamool Congress,110418,641,111059,50.86,West Bengal-Canning Paschim
3,PROTAP CHANDRA MONDAL,Indian National Congress,11862,46,11908,5.45,West Bengal-Canning Paschim
4,NARAYAN NASKAR,SOCIALIST UNITY CENTRE OF INDIA (COMMUNIST),1948,15,1963,0.9,West Bengal-Canning Paschim
5,GOPAL CHANDRA MANDAL,Independent,426,1,427,0.2,West Bengal-Canning Paschim
6,MAYA BAG,Independent,753,6,759,0.35,West Bengal-Canning Paschim
7,MEGHNATH HALDER,Independent,13378,12,13390,6.13,West Bengal-Canning Paschim
8,NOTA,None of the Above,3026,6,3032,1.39,West Bengal-Canning Paschim
1,KALIPADA NASKAR,Bharatiya Janata Party,34306,197,34503,14.82,West Bengal-Canning Purba
2,SAOKAT MOLLA,All India Trinamool Congress,121562,739,122301,52.54,West Bengal-Canning Purba
3,RAFIK AKUNJE,SOCIALIST UNITY CENTRE OF INDIA (COMMUNIST),2670,16,2686,1.15,West Bengal-Canning Purba
4,GAZI SHAHABUDDIN SIRAJI,Rashtriya Secular Majlis Party,69154,140,69294,29.77,West Bengal-Canning Purba
5,AJAY HALDAR,Independent,1708,7,1715,0.74,West Bengal-Canning Purba
6,NOTA,None of the Above,2258,9,2267,0.97,West Bengal-Canning Purba
1,Arun Majumdar,Bahujan Samaj Party,976,19,995,0.47,West Bengal-Chakdaha
2,Narayan Das Gupta,Communist Party of India  (Marxist),17401,411,17812,8.4,West Bengal-Chakdaha
3,Bankim Chandra Ghosh,Bharatiya Janata Party,97955,1413,99368,46.86,West Bengal-Chakdaha
4,Subhankar Singha (Jishu),All India Trinamool Congress,86105,1583,87688,41.35,West Bengal-Chakdaha
5,Bidhan Ghosh,Bharatiya Nyay-Adhikar Raksha Party,1670,13,1683,0.79,West Bengal-Chakdaha
6,Ashoke Kumar Das,Independent,1182,11,1193,0.56,West Bengal-Chakdaha
7,Tapan Biswas,Independent,1362,8,1370,0.65,West Bengal-Chakdaha
8,Bhowmick Koushik,Independent,465,3,468,0.22,West Bengal-Chakdaha
9,NOTA,None of the Above,1475,12,1487,0.7,West Bengal-Chakdaha
1,ALI IMRAN RAMZ,All India Forward Bloc,28521,183,28704,16.55,West Bengal-Chakulia
2,AZAD MINHAJUL ARFIN,All India Trinamool Congress,85922,389,86311,49.78,West Bengal-Chakulia
3,GOUTAM PAUL,Bahujan Samaj Party,2720,5,2725,1.57,West Bengal-Chakulia
4,SACHIN PRASAD,Bharatiya Janata Party,52170,304,52474,30.26,West Bengal-Chakulia
5,KAMKSHYA SARKAR,Janata Dal  (United),950,4,954,0.55,West Bengal-Chakulia
6,MAZHAR IMAM,Independent,1046,0,1046,0.6,West Bengal-Chakulia
7,NOTA,None of the Above,1183,3,1186,0.68,West Bengal-Chakulia
1,ARINDAM GUIN (BUBAI),All India Trinamool Congress,100512,460,100972,50.2,West Bengal-Champdani
2,ABDUL MANNAN,Indian National Congress,23053,219,23272,11.57,West Bengal-Champdani
3,DILIP SINGH,Bharatiya Janata Party,70617,277,70894,35.25,West Bengal-Champdani
4,MANGAL SARKAR,Bahujan Maha Party,781,9,790,0.39,West Bengal-Champdani
5,AJAY YADAV,Independent,411,5,416,0.21,West Bengal-Champdani
6,ARABIND KUMAR RABIDAS,Independent,807,1,808,0.4,West Bengal-Champdani
7,DILIP DAS,Independent,632,0,632,0.31,West Bengal-Champdani
8,NOTA,None of the Above,3338,9,3347,1.66,West Bengal-Champdani
1,Asif Mehbub,Indian National Congress,31107,239,31346,15.7,West Bengal-Chanchal
2,Younish Mia,Bahujan Samaj Party,1049,1,1050,0.53,West Bengal-Chanchal
3,Dipankar Ram (Bankat),Bharatiya Janata Party,48240,388,48628,24.35,West Bengal-Chanchal
4,Nihar Ranjan Ghosh,All India Trinamool Congress,115467,499,115966,58.08,West Bengal-Chanchal
5,Jhantu Kumar Rabidas,SOCIALIST UNITY CENTRE OF INDIA (COMMUNIST),1213,1,1214,0.61,West Bengal-Chanchal
6,Bhakta Prasad Saha,Independent,452,0,452,0.23,West Bengal-Chanchal
7,NOTA,None of the Above,1018,5,1023,0.51,West Bengal-Chanchal
1,INDRANIL SEN,All India Trinamool Congress,85604,1174,86778,47.63,West Bengal-Chandannagar
2,GAUTAM SARKAR,Communist Party of India  (Marxist),33071,631,33702,18.5,West Bengal-Chandannagar
3,DEEPANJAN KUMAR GUHA,Bharatiya Janata Party,55275,474,55749,30.6,West Bengal-Chandannagar
4,UDAY VEER CHOUDHURY,Independent,532,6,538,0.3,West Bengal-Chandannagar
5,TANDRA BHATTACHARJEE (TANDRADI),Independent,352,13,365,0.2,West Bengal-Chandannagar
6,PRALOY MUKHERJEE,Independent,304,3,307,0.17,West Bengal-Chandannagar
7,RATAN KUMAR CHATTERJEE (R.K.C),Independent,1179,5,1184,0.65,West Bengal-Chandannagar
8,SUBRATA DEY,Independent,531,1,532,0.29,West Bengal-Chandannagar
9,NOTA,None of the Above,3000,23,3023,1.66,West Bengal-Chandannagar
1,Ashis Kumar Guchhait,Communist Party of India  (Marxist),9708,129,9837,4.46,West Bengal-Chandipur
2,Pulak Kanti Guria,Bharatiya Janata Party,95695,603,96298,43.71,West Bengal-Chandipur
3,Biswanath Ghorai,Bahujan Samaj Party,1253,1,1254,0.57,West Bengal-Chandipur
4,Soham Chakraborty,All India Trinamool Congress,109193,577,109770,49.82,West Bengal-Chandipur
5,Bikash Chandra Das,West Bengal Socialist Party,1365,0,1365,0.62,West Bengal-Chandipur
6,Swapan Kumar Bhowmik,SOCIALIST UNITY CENTRE OF INDIA (COMMUNIST),470,5,475,0.22,West Bengal-Chandipur
7,Arup Kumar Sahoo,Independent,589,3,592,0.27,West Bengal-Chandipur
8,NOTA,None of the Above,726,10,736,0.33,West Bengal-Chandipur
1,DEBASHISH DASGUPTA(YASH D GUPTAA),Bharatiya Janata Party,61620,151,61771,29.83,West Bengal-Chanditala
2,MD. SALIM,Communist Party of India  (Marxist),37005,156,37161,17.94,West Bengal-Chanditala
3,SWATI KHANDOKER,All India Trinamool Congress,102719,399,103118,49.79,West Bengal-Chanditala
4,ABDUL RAHIM MOLLICK,Independent,1882,4,1886,0.91,West Bengal-Chanditala
5,ONKAR MAJUMDER,Independent,1011,3,1014,0.49,West Bengal-Chanditala
6,NOTA,None of the Above,2153,3,2156,1.04,West Bengal-Chanditala
1,ARUP DHARA,All India Trinamool Congress,121315,531,121846,48.87,West Bengal-Chandrakona
2,SIBARAM DAS,Bharatiya Janata Party,109831,734,110565,44.35,West Bengal-Chandrakona
3,AKSHAY KHAN,SOCIALIST UNITY CENTRE OF INDIA (COMMUNIST),1524,3,1527,0.61,West Bengal-Chandrakona
4,GOURANGA DAS,Rashtriya Secular Majlis Party,10712,89,10801,4.33,West Bengal-Chandrakona
5,SUDHIR ARI,Independent,1666,4,1670,0.67,West Bengal-Chandrakona
6,NOTA,None of the Above,2900,6,2906,1.17,West Bengal-Chandrakona
1,KALYAN KUMAR NANDI,Bharatiya Janata Party,57380,788,58168,27.29,West Bengal-Chapra
2,JAHANGIR BISWAS (RAJU),Communist Party of India  (Marxist),11542,180,11722,5.5,West Bengal-Chapra
3,ROKIBUL HOSSAIN MOLLA,Bahujan Samaj Party,1064,6,1070,0.5,West Bengal-Chapra
4,RUKBANUR RAHMAN,All India Trinamool Congress,73187,679,73866,34.65,West Bengal-Chapra
5,KANCHAN MAITRA,Rashtriya Secular Majlis Party,3848,17,3865,1.81,West Bengal-Chapra
6,MOZAMMEL HOSSAIN MONDAL,SOCIALIST UNITY CENTRE OF INDIA (COMMUNIST),713,0,713,0.33,West Bengal-Chapra
7,JEBER SEKH,Independent,61063,685,61748,28.97,West Bengal-Chapra
8,NOTA,None of the Above,2016,7,2023,0.95,West Bengal-Chapra
1,FALGUNI MUKHERJEE,Revolutionary Socialist Party,9615,85,9700,4.93,West Bengal-Chhatna
2,SUBASISH BATABYAL,All India Trinamool Congress,82483,586,83069,42.2,West Bengal-Chhatna
3,SATYANARAYAN MUKHOPADHYAY,Bharatiya Janata Party,89511,722,90233,45.84,West Bengal-Chhatna
4,BAURI DINABANDHU,Bahujan Mukti Party,1832,6,1838,0.93,West Bengal-Chhatna
5,SADANANDA MANDAL,SOCIALIST UNITY CENTRE OF INDIA (COMMUNIST),967,11,978,0.5,West Bengal-Chhatna
6,ANATH BAURI,Independent,804,5,809,0.41,West Bengal-Chhatna
7,ABIR CHANDRA MANDAL,Independent,1218,9,1227,0.62,West Bengal-Chhatna
8,DINANATH CHATTERJEE,Independent,2593,9,2602,1.32,West Bengal-Chhatna
9,RABINDRANATH BOURI,Independent,2857,9,2866,1.46,West Bengal-Chhatna
10,NOTA,None of the Above,3510,4,3514,1.79,West Bengal-Chhatna
1,ANWARUL HAQUE,Communist Party of India  (Marxist),12188,91,12279,6.02,West Bengal-Chopra
2,MD. SHAHIN AKHTER,Bharatiya Janata Party,59604,414,60018,29.4,West Bengal-Chopra
3,HAMIDUL RAHAMAN,All India Trinamool Congress,123944,979,124923,61.2,West Bengal-Chopra
4,AJOY KUMAR SINHA,Amra Bangalee,3158,8,3166,1.55,West Bengal-Chopra
5,SUROJIT KISKU,Independent,2190,3,2193,1.07,West Bengal-Chopra
6,NOTA,None of the Above,1527,4,1531,0.75,West Bengal-Chopra
1,BANDYOPADHYAY NAYNA,All India Trinamool Congress,69702,399,70101,62.87,West Bengal-Chowrangee
2,DEVDUTTA MAJI,Bharatiya Janata Party,24644,113,24757,22.2,West Bengal-Chowrangee
3,SANTOSH KUMAR PATHAK,Indian National Congress,14184,82,14266,12.8,West Bengal-Chowrangee
4,SWAMINATH KORI,Bahujan Samaj Party,263,1,264,0.24,West Bengal-Chowrangee
5,AJAY KUMAR GUPTA,Bharatiya Momin Front,74,1,75,0.07,West Bengal-Chowrangee
6,ANIL KUMAR SINGH,Janata Dal  (United),79,2,81,0.07,West Bengal-Chowrangee
7,MANIKA PAUL,SOCIALIST UNITY CENTRE OF INDIA (COMMUNIST),201,3,204,0.18,West Bengal-Chowrangee
8,ASHISH AGARWAL,Independent,88,4,92,0.08,West Bengal-Chowrangee
9,ISHRAT KHAN,Independent,109,0,109,0.1,West Bengal-Chowrangee
10,SAYANTAN PATRA,Independent,162,1,163,0.15,West Bengal-Chowrangee
11,SUMANTA BHOWMICK,Independent,169,0,169,0.15,West Bengal-Chowrangee
12,NOTA,None of the Above,1207,5,1212,1.09,West Bengal-Chowrangee
1,Asit Mazumder (Tapan),All India Trinamool Congress,115802,1302,117104,45.97,West Bengal-Chunchura
2,Goutam Mondal,Bahujan Samaj Party,1306,22,1328,0.52,West Bengal-Chunchura
3,PRANAB KUMAR GHOSH,All India Forward Bloc,28397,380,28777,11.3,West Bengal-Chunchura
4,Locket Chatterjee,Bharatiya Janata Party,98011,676,98687,38.74,West Bengal-Chunchura
5,Ajanta Sarkar,Socialist Party (India),1034,8,1042,0.41,West Bengal-Chunchura
6,AJIT KUMAR MURMU,Ambedkarite Party of India,827,12,839,0.33,West Bengal-Chunchura
7,Kashinath Murmu,Independent,1297,14,1311,0.51,West Bengal-Chunchura
8,Gopal Jee Pandey,Independent,639,7,646,0.25,West Bengal-Chunchura
9,Debkanta Sikdar,Independent,658,7,665,0.26,West Bengal-Chunchura
10,NOTA,None of the Above,4319,19,4338,1.7,West Bengal-Chunchura
1,Akshay Thakur,All India Forward Bloc,9928,318,10246,5.24,West Bengal-Cooch Behar Dakshin
2,Avijit De Bhowmik,All India Trinamool Congress,85620,1009,86629,44.31,West Bengal-Cooch Behar Dakshin
3,Khokan Majumdar,Bahujan Samaj Party,1415,4,1419,0.73,West Bengal-Cooch Behar Dakshin
4,Nikhil Ranjan Dey,Bharatiya Janata Party,89966,1594,91560,46.83,West Bengal-Cooch Behar Dakshin
5,Nazma Khandakar,SOCIALIST UNITY CENTRE OF INDIA (COMMUNIST),1124,14,1138,0.58,West Bengal-Cooch Behar Dakshin
6,Babla Deb,Amra Bangalee,326,3,329,0.17,West Bengal-Cooch Behar Dakshin
7,Anamika Paul,Independent,728,11,739,0.38,West Bengal-Cooch Behar Dakshin
8,Bidhan Barma,Independent,493,3,496,0.25,West Bengal-Cooch Behar Dakshin
9,Rati Ranjan Paul,Independent,1480,5,1485,0.76,West Bengal-Cooch Behar Dakshin
10,NOTA,None of the Above,1436,28,1464,0.75,West Bengal-Cooch Behar Dakshin
1,NAGENDRA NATH ROY,All India Forward Bloc,11232,243,11475,4.7,West Bengal-COOCHBEHAR UTTAR
2,BINAY KRISHNA BARMAN,All India Trinamool Congress,104823,1045,105868,43.4,West Bengal-COOCHBEHAR UTTAR
3,SUKUMAR ROY,Bharatiya Janata Party,118656,1827,120483,49.4,West Bengal-COOCHBEHAR UTTAR
4,ANIL CHANDRA ROY,SOCIALIST UNITY CENTRE OF INDIA (COMMUNIST),1375,11,1386,0.57,West Bengal-COOCHBEHAR UTTAR
5,GOPAL ROY,Amra Bangalee,620,8,628,0.26,West Bengal-COOCHBEHAR UTTAR
6,SAMARESH RAY,Kamatapur Peopleâ€™s Party (United),1110,17,1127,0.46,West Bengal-COOCHBEHAR UTTAR
7,NARESH CHANDRA ROY,Independent,1374,5,1379,0.57,West Bengal-COOCHBEHAR UTTAR
8,NOTA,None of the Above,1555,15,1570,0.64,West Bengal-COOCHBEHAR UTTAR
1,Goutam Deb,All India Trinamool Congress,100844,651,101495,39.19,West Bengal-Dabgram-Fulbari
2,Dilip Singh,Communist Party of India  (Marxist),17747,251,17998,6.95,West Bengal-Dabgram-Fulbari
3,Radhakrishna Namadas,Bahujan Samaj Party,1391,4,1395,0.54,West Bengal-Dabgram-Fulbari
4,Sikha Chatterjee,Bharatiya Janata Party,128302,786,129088,49.85,West Bengal-Dabgram-Fulbari
5,Amitav Naskar,Republican Party of India (A),876,5,881,0.34,West Bengal-Dabgram-Fulbari
6,Maniul Islam,SOCIALIST UNITY CENTRE OF INDIA (COMMUNIST),544,3,547,0.21,West Bengal-Dabgram-Fulbari
7,Shambhu Sutradhar,Amra Bangalee,646,4,650,0.25,West Bengal-Dabgram-Fulbari
8,Maheswar Barman,Independent,1388,3,1391,0.54,West Bengal-Dabgram-Fulbari
9,Rakhi Mandal,Independent,1087,6,1093,0.42,West Bengal-Dabgram-Fulbari
10,Subash Biswas,Independent,1047,5,1052,0.41,West Bengal-Dabgram-Fulbari
11,NOTA,None of the Above,3358,21,3379,1.3,West Bengal-Dabgram-Fulbari
1,BIKRAM CHANDRA PRADHAN,All India Trinamool Congress,94609,600,95209,48.13,West Bengal-Dantan
2,Saktipada Nayak,Bharatiya Janata Party,93834,752,94586,47.82,West Bengal-Dantan
3,SISIR KUMAR PATRA,Communist Party of India,5556,96,5652,2.86,West Bengal-Dantan
4,SUBHAS DAS,SOCIALIST UNITY CENTRE OF INDIA (COMMUNIST),1096,5,1101,0.56,West Bengal-Dantan
5,NOTA,None of the Above,1245,5,1250,0.63,West Bengal-Dantan
1,GAUTAM RAJ RAI,Communist Party of India  (Marxist),1821,92,1913,1.13,West Bengal-Darjeeling
2,NEERAJ TAMANG ZIMBA,Bharatiya Janata Party,67161,1746,68907,40.88,West Bengal-Darjeeling
3,ANJANI SHARMA,Independent,1600,77,1677,0.99,West Bengal-Darjeeling
4,KESHAV RAJ SHARMA,Independent,46927,704,47631,28.26,West Bengal-Darjeeling
5,NIMA GYAMTSHO SHERPA,Independent,2042,46,2088,1.24,West Bengal-Darjeeling
6,PEMBA TSHERING,Independent,37804,436,38240,22.68,West Bengal-Darjeeling
7,BHARAT PRAKASH RAI,Independent,1286,41,1327,0.79,West Bengal-Darjeeling
8,MILAN THOKAR,Independent,1367,30,1397,0.83,West Bengal-Darjeeling
9,SURAJ GURUNG,Independent,2766,89,2855,1.69,West Bengal-Darjeeling
10,NOTA,None of the Above,2495,45,2540,1.51,West Bengal-Darjeeling
1,DHRUBA SEKHAR MANDAL,Communist Party of India  (Marxist),16649,396,17045,7.66,West Bengal-Daspur
2,PRASANTA BERA,Bharatiya Janata Party,87178,733,87911,39.52,West Bengal-Daspur
3,MAMATA BHUNIA,All India Trinamool Congress,113911,842,114753,51.58,West Bengal-Daspur
4,JAGADISH MONDAL ADHIKARY,SOCIALIST UNITY CENTRE OF INDIA (COMMUNIST),1379,8,1387,0.62,West Bengal-Daspur
5,NOTA,None of the Above,1356,12,1368,0.61,West Bengal-Daspur
1,PRANKRISHNA MONDAL,Communist Party of India  (Marxist),20450,273,20723,10.12,West Bengal-Debra
2,BHARATI GHOSH,Bharatiya Janata Party,83654,970,84624,41.31,West Bengal-Debra
3,HUMAYUN KABIR,All India Trinamool Congress,94683,1167,95850,46.79,West Bengal-Debra
4,DIPANKAR MAITY,SOCIALIST UNITY CENTRE OF INDIA (COMMUNIST),1501,8,1509,0.74,West Bengal-Debra
5,SUKANTA DAS,Independent,806,1,807,0.39,West Bengal-Debra
6,NOTA,None of the Above,1346,7,1353,0.66,West Bengal-Debra
1,DIPIKA CHATTARJEE,Bharatiya Janata Party,38308,138,38446,17.93,West Bengal-Deganga
2,MD. HASANOOR JAMAN CHOWDHURY,All India Forward Bloc,2930,12,2942,1.37,West Bengal-Deganga
3,RAHIMA MONDAL,All India Trinamool Congress,99686,419,100105,46.7,West Bengal-Deganga
4,SATTAR ALI,Bahujan Samaj Party,1353,1,1354,0.63,West Bengal-Deganga
5,AJOY SADHUKHAN,SOCIALIST UNITY CENTRE OF INDIA (COMMUNIST),787,0,787,0.37,West Bengal-Deganga
6,KARIM ALI,Rashtriya Secular Majlis Party,67454,114,67568,31.52,West Bengal-Deganga
7,MD. RAFIKUL ISLAM,Welfare Party Of India,1075,3,1078,0.5,West Bengal-Deganga
8,NOTA,None of the Above,2098,2,2100,0.98,West Bengal-Deganga
1,ANIRBAN SAHA,Indian National Congress,8929,104,9033,3.86,West Bengal-Dhanekhali
2,ASIMA PATRA,All India Trinamool Congress,123509,1267,124776,53.36,West Bengal-Dhanekhali
3,TUSAR KUMAR MAJUMDAR,Bharatiya Janata Party,93861,756,94617,40.46,West Bengal-Dhanekhali
4,SAJAL KUMAR DE,Communist Party of India  (Marxist-Leninist)  (Liberation),3215,15,3230,1.38,West Bengal-Dhanekhali
5,NOTA,None of the Above,2167,15,2182,0.93,West Bengal-Dhanekhali
1,PRADIP KUMAR ROY,Communist Party of India  (Marxist),12856,251,13107,5.72,West Bengal-Dhupguri
2,BISHNU PADA RAY,Bharatiya Janata Party,103533,1155,104688,45.65,West Bengal-Dhupguri
3,BEDODYUTI ROY,Bahujan Samaj Party,2171,7,2178,0.95,West Bengal-Dhupguri
4,MITALI ROY,All India Trinamool Congress,99293,1040,100333,43.75,West Bengal-Dhupguri
5,DHIRANJAN ROY,SOCIALIST UNITY CENTRE OF INDIA (COMMUNIST),1604,9,1613,0.7,West Bengal-Dhupguri
6,SUKUMAR ROY,Kamatapur Peopleâ€™s Party (United),2144,11,2155,0.94,West Bengal-Dhupguri
7,SUJAN BARMAN,Independent,1090,6,1096,0.48,West Bengal-Dhupguri
8,HRISHIKESH ROY,Independent,2167,2,2169,0.95,West Bengal-Dhupguri
9,NOTA,None of the Above,1976,8,1984,0.87,West Bengal-Dhupguri
1,GOLAM ALI SEKH,Bahujan Samaj Party,1086,2,1088,0.48,West Bengal-Diamond Harbour
2,DIPAK KUMAR HALDER,Bharatiya Janata Party,81098,384,81482,36.15,West Bengal-Diamond Harbour
3,PANNALAL HALDER,All India Trinamool Congress,98032,446,98478,43.69,West Bengal-Diamond Harbour
4,PRATIK UR RAHAMAN,Communist Party of India  (Marxist),38612,107,38719,17.18,West Bengal-Diamond Harbour
5,MONARAMA HALDER,SOCIALIST UNITY CENTRE OF INDIA (COMMUNIST),469,0,469,0.21,West Bengal-Diamond Harbour
6,SACHINDRA NATH HALDER,Republican Party of India (A),174,0,174,0.08,West Bengal-Diamond Harbour
7,KISHOR KUMAR MONDAL,Independent,164,1,165,0.07,West Bengal-Diamond Harbour
8,BISWAJIT SARDAR,Independent,234,0,234,0.1,West Bengal-Diamond Harbour
9,LATAB UDDIN MOLLA,Independent,750,4,754,0.33,West Bengal-Diamond Harbour
10,SAFIULLA KHAN,Independent,1585,0,1585,0.7,West Bengal-Diamond Harbour
11,SWAPAN MONDAL,Independent,800,0,800,0.35,West Bengal-Diamond Harbour
12,NOTA,None of the Above,1446,3,1449,0.64,West Bengal-Diamond Harbour
1,ABDUR ROUF,All India Forward Bloc,5916,153,6069,2.49,West Bengal-Dinhata
2,UDAYAN GUHA,All India Trinamool Congress,114887,1091,115978,47.58,West Bengal-Dinhata
3,NISITH PRAMANIK,Bharatiya Janata Party,114361,1674,116035,47.6,West Bengal-Dinhata
4,PRADIP ROY,SOCIALIST UNITY CENTRE OF INDIA (COMMUNIST),1364,11,1375,0.56,West Bengal-Dinhata
5,NIRMAL CHANDRA BARMAN,Independent,1361,9,1370,0.56,West Bengal-Dinhata
6,LEBU MIYAN,Independent,1386,1,1387,0.57,West Bengal-Dinhata
7,NOTA,None of the Above,1515,22,1537,0.63,West Bengal-Dinhata
1,UTTAM BERA,Communist Party of India  (Marxist),22727,41,22768,9.07,West Bengal-Domjur
2,KALYAN GHOSH,All India Trinamool Congress,130278,221,130499,52,West Bengal-Domjur
3,RAJIB BANERJEE    S/O- LATE DHANANJOY BANERJEE,Bharatiya Janata Party,87766,113,87879,35.01,West Bengal-Domjur
4,RAJANI BEGUM,Bharatiya Nyay-Adhikar Raksha Party,1300,0,1300,0.52,West Bengal-Domjur
5,TANMOY DAS,Independent,236,0,236,0.09,West Bengal-Domjur
6,NANDITA ROY,Independent,218,0,218,0.09,West Bengal-Domjur
7,RAJIB BANERJEE  S/O- AMARNATH BANERJEE,Independent,225,0,225,0.09,West Bengal-Domjur
8,RAJIB MONDAL,Independent,138,0,138,0.05,West Bengal-Domjur
9,SRIKUMAR NASKAR,Independent,198,0,198,0.08,West Bengal-Domjur
10,SANCHAYITA GHOSH,Independent,172,0,172,0.07,West Bengal-Domjur
11,SK. SHAMIM HOSSAIN,Independent,272,0,272,0.11,West Bengal-Domjur
12,SUBIR DALUI,Independent,424,0,424,0.17,West Bengal-Domjur
13,SUBHAS SANTRA,Independent,1712,0,1712,0.68,West Bengal-Domjur
14,SUMANTA KAYAL,Independent,2855,0,2855,1.14,West Bengal-Domjur
15,NOTA,None of the Above,2078,4,2082,0.83,West Bengal-Domjur
1,JAFIKUL ISLAM,All India Trinamool Congress,127173,498,127671,56.45,West Bengal-Domkal
2,BIYAMMA MONDAL (RUBIA),Bharatiya Janata Party,12247,101,12348,5.46,West Bengal-Domkal
3,MD. MOSTAFIJUR RAHAMAN (RANA),Communist Party of India  (Marxist),79968,474,80442,35.57,West Bengal-Domkal
4,AMIR SOHAIL,"Justice and Development Party,",678,1,679,0.3,West Bengal-Domkal
5,SAMSUZZAMAN(KAJAL),SOCIALIST UNITY CENTRE OF INDIA (COMMUNIST),291,2,293,0.13,West Bengal-Domkal
6,HIKMAT ALI,Indian Union Muslim League,518,3,521,0.23,West Bengal-Domkal
7,AYENUL HAQUE,Independent,469,0,469,0.21,West Bengal-Domkal
8,IMAN ALI BISWAS,Independent,729,0,729,0.32,West Bengal-Domkal
9,MD JEWEL MONDAL,Independent,611,1,612,0.27,West Bengal-Domkal
10,NOTA,None of the Above,2413,6,2419,1.07,West Bengal-Domkal
1,Anup Kumar Saha,Bharatiya Janata Party,97072,1011,98083,47.94,West Bengal-Dubrajpur
2,Debabrata Saha,All India Trinamool Congress,93279,941,94220,46.05,West Bengal-Dubrajpur
3,BIJOY BAGDI,All India Forward Bloc,5931,83,6014,2.94,West Bengal-Dubrajpur
4,Bhaskar Das,Bahujan Samaj Party,1087,6,1093,0.53,West Bengal-Dubrajpur
5,Sanjay Das,Bahujan Mukti Party,2027,5,2032,0.99,West Bengal-Dubrajpur
6,NOTA,None of the Above,3148,9,3157,1.54,West Bengal-Dubrajpur
1,PALASH DAS,Communist Party of India  (Marxist),30520,133,30653,16.54,West Bengal-Dum Dum
2,BIMALSHANKAR NANDA,Bharatiya Janata Party,61038,230,61268,33.06,West Bengal-Dum Dum
3,BRTYA BASU,All India Trinamool Congress,87543,456,87999,47.48,West Bengal-Dum Dum
4,SUBRATA KR. MAJUMDER,Bahujan Samaj Party,975,5,980,0.53,West Bengal-Dum Dum
5,RANA PAL CHOUDHURY,Bharatiya Nyay-Adhikar Raksha Party,737,2,739,0.4,West Bengal-Dum Dum
6,SHREE RAJU GHOSH,Independent,462,2,464,0.25,West Bengal-Dum Dum
7,RUPA SARKAR,Independent,771,3,774,0.42,West Bengal-Dum Dum
8,SUBRATA SEN,Independent,417,1,418,0.23,West Bengal-Dum Dum
9,NOTA,None of the Above,2035,4,2039,1.1,West Bengal-Dum Dum
1,DR. ARCHANA MAJUMDAR,Bharatiya Janata Party,66739,227,66966,31.42,West Bengal-Dum Dum Uttar
2,CHANDRIMA BHATTACHARYA,All India Trinamool Congress,95078,387,95465,44.79,West Bengal-Dum Dum Uttar
3,TANMOY BHATTACHARYA,Communist Party of India  (Marxist),45462,266,45728,21.45,West Bengal-Dum Dum Uttar
4,SOVA HOWLADER,Bahujan Samaj Party,996,9,1005,0.47,West Bengal-Dum Dum Uttar
5,SANTANU MANDAL,Democratic Socialist Party of India,642,3,645,0.3,West Bengal-Dum Dum Uttar
6,SUNIL SINGH,Bharatiya Nyay-Adhikar Raksha Party,1223,6,1229,0.58,West Bengal-Dum Dum Uttar
7,NOTA,None of the Above,2107,4,2111,0.99,West Bengal-Dum Dum Uttar
1,DEBESH CHAKRABORTY,Indian National Congress,17772,258,18030,9.16,West Bengal-Durgapur Paschim
2,PRABHUNATH SAH,Bahujan Samaj Party,1221,7,1228,0.62,West Bengal-Durgapur Paschim
3,BISWANATH PARIAL,All India Trinamool Congress,75828,694,76522,38.86,West Bengal-Durgapur Paschim
4,LAKSHMAN CHANDRA GHORUI,Bharatiya Janata Party,90589,597,91186,46.31,West Bengal-Durgapur Paschim
5,SANJIBAN HAZRA,Janata Dal  (United),910,5,915,0.46,West Bengal-Durgapur Paschim
6,SANDIP SIKDER,Republican Party of India (Athawale),874,5,879,0.45,West Bengal-Durgapur Paschim
7,SOMNATH BANERJEE,SOCIALIST UNITY CENTRE OF INDIA (COMMUNIST),683,8,691,0.35,West Bengal-Durgapur Paschim
8,CHANDRA MALLIKA BANDOPADHYAY,Independent,2029,9,2038,1.04,West Bengal-Durgapur Paschim
9,NAYAN MONDAL,Independent,2118,12,2130,1.08,West Bengal-Durgapur Paschim
10,SWAPAN BANERJEE,Independent,653,6,659,0.33,West Bengal-Durgapur Paschim
11,NOTA,None of the Above,2611,13,2624,1.33,West Bengal-Durgapur Paschim
1,ABHAS RAY CHAUDHURI,Communist Party of India  (Marxist),28719,344,29063,15.08,West Bengal-Durgapur Purba
2,COLONEL DIPTANSU CHAUDHURY,Bharatiya Janata Party,75000,557,75557,39.21,West Bengal-Durgapur Purba
3,PRADIP MAZUMDAR,All India Trinamool Congress,78457,846,79303,41.16,West Bengal-Durgapur Purba
4,SURESH PRASAD,Bahujan Samaj Party,1234,6,1240,0.64,West Bengal-Durgapur Purba
5,AMAL CHAKRABORTY,Amra Bangalee,469,2,471,0.24,West Bengal-Durgapur Purba
6,BIJOY LAXMI PANDEY,Republican Party of India (Athawale),525,3,528,0.27,West Bengal-Durgapur Purba
7,JUGAL KRISHNA PAKHIRA,SOCIALIST UNITY CENTRE OF INDIA (COMMUNIST),629,7,636,0.33,West Bengal-Durgapur Purba
8,DIPAK DHALI,Independent,1877,7,1884,0.98,West Bengal-Durgapur Purba
9,MD. SHOUKAT ALI KHAN,Independent,1363,1,1364,0.71,West Bengal-Durgapur Purba
10,NOTA,None of the Above,2609,19,2628,1.36,West Bengal-Durgapur Purba
1,ARUP DASH,Bharatiya Janata Party,106357,915,107272,44.55,West Bengal-Egra
2,TARUN KUMAR MAITY,All India Trinamool Congress,124805,958,125763,52.22,West Bengal-Egra
3,MANAS KUMAR KARMAHAPATRA,Indian National Congress,4997,89,5086,2.11,West Bengal-Egra
4,JAGADIS SAU,SOCIALIST UNITY CENTRE OF INDIA (COMMUNIST),1290,13,1303,0.54,West Bengal-Egra
5,NOTA,None of the Above,1388,5,1393,0.58,West Bengal-Egra
1,KRISHNENDU NARAYAN CHOUDHURY,All India Trinamool Congress,86163,1493,87656,40.64,West Bengal-Englishbazar
2,KOUSHIK MISRA(SAHEB),Communist Party of India  (Marxist),10377,576,10953,5.08,West Bengal-Englishbazar
3,SREERUPA MITRA CHAUDHURY(NIRBHOY DIDI),Bharatiya Janata Party,105422,2333,107755,49.96,West Bengal-Englishbazar
4,SURESH CHANDRA SARKAR,Bahujan Samaj Party,1024,15,1039,0.48,West Bengal-Englishbazar
5,UMA DAS (PAUL),Janata Dal  (United),273,2,275,0.13,West Bengal-Englishbazar
6,GAUTAM SARKAR,SOCIALIST UNITY CENTRE OF INDIA (COMMUNIST),266,1,267,0.12,West Bengal-Englishbazar
7,FIROZ AKHTAR,Bahujan Mukti Party,197,4,201,0.09,West Bengal-Englishbazar
8,ADITYA PRAKASH DASGUPTA,Independent,358,2,360,0.17,West Bengal-Englishbazar
9,NARESH PAL,Independent,1125,4,1129,0.52,West Bengal-Englishbazar
10,MD. ANISUR RAHAMAN,Independent,1786,1,1787,0.83,West Bengal-Englishbazar
11,SATISH RAJBANSHI,Independent,1056,1,1057,0.49,West Bengal-Englishbazar
12,NOTA,None of the Above,3168,28,3196,1.48,West Bengal-Englishbazar
1,Md. Fayaz,Bahujan Samaj Party,824,3,827,0.53,West Bengal-Entally
2,Priyanka Tibrewal,Bharatiya Janata Party,43248,204,43452,27.7,West Bengal-Entally
3,Swarna Kamal Saha,All India Trinamool Congress,101266,443,101709,64.83,West Bengal-Entally
4,Goutam Prasad,West Bengal Socialist Party,797,1,798,0.51,West Bengal-Entally
5,Md. Enayetullah Ansari,All India Minorities Front,248,1,249,0.16,West Bengal-Entally
6,Md. Iqbal Alam,Rashtriya Secular Majlis Party,4297,57,4354,2.78,West Bengal-Entally
7,Md. Nurul Huda,Janata Dal  (United),135,2,137,0.09,West Bengal-Entally
8,Swarnalata Sarkar,Bharatiya Nyay-Adhikar Raksha Party,131,1,132,0.08,West Bengal-Entally
9,Arindam Roy,Independent,137,0,137,0.09,West Bengal-Entally
10,Ashok Das,Independent,155,1,156,0.1,West Bengal-Entally
11,Kundan Kumar Shaw,Independent,205,2,207,0.13,West Bengal-Entally
12,Md. Imran,Independent,349,1,350,0.22,West Bengal-Entally
13,Mousumi Roy,Independent,769,1,770,0.49,West Bengal-Entally
14,Prabir Dasgupta,Independent,1934,0,1934,1.23,West Bengal-Entally
15,Saleha Tabassum,Independent,671,0,671,0.43,West Bengal-Entally
16,NOTA,None of the Above,980,11,991,0.63,West Bengal-Entally
1,KSHITISH CHANDRA RAY,Communist Party of India  (Marxist),10496,276,10772,4.89,West Bengal-Falakata
2,DIPAK BARMAN,Bharatiya Janata Party,101833,1160,102993,46.71,West Bengal-Falakata
3,SUBHASH CHANDRA ROY,All India Trinamool Congress,98181,822,99003,44.9,West Bengal-Falakata
4,TAPAN ADHIKARI,Samajwadi Jan Parishad,1367,10,1377,0.62,West Bengal-Falakata
5,TARANI ROY,SOCIALIST UNITY CENTRE OF INDIA (COMMUNIST),608,5,613,0.28,West Bengal-Falakata
6,BIMAL ROY,Amra Bangalee,446,3,449,0.2,West Bengal-Falakata
7,DIPAK CHANDRA MANDAL (SANTOSH),Independent,1675,3,1678,0.76,West Bengal-Falakata
8,SWAPAN ROY,Independent,1639,6,1645,0.75,West Bengal-Falakata
9,NOTA,None of the Above,1964,6,1970,0.89,West Bengal-Falakata
1,ATAL KUMAR PURKAIT,Bahujan Samaj Party,772,4,776,0.37,West Bengal-Falta
2,ABDUR RAZZAK MOLLA,Indian National Congress,7413,39,7452,3.58,West Bengal-Falta
3,BIDHAN PARUI,Bharatiya Janata Party,76033,372,76405,36.75,West Bengal-Falta
4,SANKAR KUMAR NASKAR,All India Trinamool Congress,116077,1102,117179,56.35,West Bengal-Falta
5,JULFIKAR SHAIK,Independent,1177,6,1183,0.57,West Bengal-Falta
6,DEEPAK RAM,Independent,272,1,273,0.13,West Bengal-Falta
7,MILAN DHUM,Independent,364,1,365,0.18,West Bengal-Falta
8,M. RAQUIBUL HASAN MALLICK,Independent,1674,3,1677,0.81,West Bengal-Falta
9,SANTOSH SAMANTA,Independent,1019,7,1026,0.49,West Bengal-Falta
10,SOMNATH MONDAL,Independent,407,4,411,0.2,West Bengal-Falta
11,NOTA,None of the Above,1180,5,1185,0.57,West Bengal-Falta
1,GHOSH  HEMANTA,Bharatiya Janata Party,42173,201,42374,22.73,West Bengal-Farakka
2,MAINUL HAQUE,Indian National Congress,35932,273,36205,19.42,West Bengal-Farakka
3,MANIRUL ISLAM,All India Trinamool Congress,102039,280,102319,54.89,West Bengal-Farakka
4,MD MERAJ SORIF,Rashtriya Secular Majlis Party,1559,0,1559,0.84,West Bengal-Farakka
5,ANUP KUMAR SINHA,Independent,1646,1,1647,0.88,West Bengal-Farakka
6,KANAI GHOSH,Independent,681,1,682,0.37,West Bengal-Farakka
7,NOTA,None of the Above,1638,0,1638,0.88,West Bengal-Farakka
1,KAPIL KRISHNA THAKUR,Communist Party of India,14576,262,14838,6.96,West Bengal-Gaighata
2,NAROTTAM BISWAS,All India Trinamool Congress,90150,1080,91230,42.78,West Bengal-Gaighata
3,BEAUTY SARKAR,Bahujan Samaj Party,1378,7,1385,0.65,West Bengal-Gaighata
4,SUBRATA THAKUR,Bharatiya Janata Party,99753,1055,100808,47.27,West Bengal-Gaighata
5,NANIBALA BISWAS (DAS),SOCIALIST UNITY CENTRE OF INDIA (COMMUNIST),808,6,814,0.38,West Bengal-Gaighata
6,TUSHAR KANTI HALDER,Independent,685,1,686,0.32,West Bengal-Gaighata
7,BISWAJIT ROY,Independent,545,2,547,0.26,West Bengal-Gaighata
8,DR. SAJAL BISWAS,Independent,1521,5,1526,0.72,West Bengal-Gaighata
9,NOTA,None of the Above,1399,10,1409,0.66,West Bengal-Gaighata
1,NANDALAL PONDIT,All India Forward Bloc,16929,91,17020,7.65,West Bengal-Galsi
2,NEPAL GHORUI,All India Trinamool Congress,108875,629,109504,49.21,West Bengal-Galsi
3,BIKASH BISWAS,Bharatiya Janata Party,89907,335,90242,40.55,West Bengal-Galsi
4,SANDIP SARKAR,Bahujan Samaj Party,3511,7,3518,1.58,West Bengal-Galsi
5,NOTA,None of the Above,2247,7,2254,1.01,West Bengal-Galsi
1,ARUN KANTI BALA,Bahujan Samaj Party,1166,3,1169,0.62,West Bengal-Gangarampur
2,GOUTAM DAS,All India Trinamool Congress,83281,851,84132,44.4,West Bengal-Gangarampur
3,NANDA LAL HAZRA,Communist Party of India  (Marxist),11935,338,12273,6.48,West Bengal-Gangarampur
4,SATYENDRA NATH  RAY,Bharatiya Janata Party,87561,1163,88724,46.82,West Bengal-Gangarampur
5,AKSHAY SARKAR,Kamatapur Peopleâ€™s Party (United),1139,6,1145,0.6,West Bengal-Gangarampur
6,SUBRATA ROY,Communist Party of India (Marxist-Leninist) Red Star,889,1,890,0.47,West Bengal-Gangarampur
7,NOTA,None of the Above,1135,14,1149,0.61,West Bengal-Gangarampur
1,Uttara Singha (Hazra),All India Trinamool Congress,94358,570,94928,45.71,West Bengal-Garbeta
2,Ghosh Kumar Tapan,Communist Party of India  (Marxist),22912,130,23042,11.09,West Bengal-Garbeta
3,Madan Ruidas,Bharatiya Janata Party,83739,617,84356,40.62,West Bengal-Garbeta
4,Tapas Kumar Mishra,SOCIALIST UNITY CENTRE OF INDIA (COMMUNIST),1796,7,1803,0.87,West Bengal-Garbeta
5,Kutubuddin Khan,Independent,830,3,833,0.4,West Bengal-Garbeta
6,NOTA,None of the Above,2701,18,2719,1.31,West Bengal-Garbeta
1,ARUN KUMAR BISWAS,Communist Party of India  (Marxist),13796,154,13950,6.31,West Bengal-Gazole
2,CHINMOY DEB BARMAN,Bharatiya Janata Party,99773,882,100655,45.5,West Bengal-Gazole
3,BASANTI BARMAN,All India Trinamool Congress,98267,590,98857,44.69,West Bengal-Gazole
4,SANATAN RISHI,Bahujan Samaj Party,1935,8,1943,0.88,West Bengal-Gazole
5,BIPAD  BHANJAN  ROY,Bahujan Mukti Party,822,2,824,0.37,West Bengal-Gazole
6,Minu Sarkar (Barman),Kamatapur Peopleâ€™s Party (United),741,0,741,0.33,West Bengal-Gazole
7,SUPEN KUMAR ROY,SOCIALIST UNITY CENTRE OF INDIA (COMMUNIST),1380,1,1381,0.62,West Bengal-Gazole
8,SATISH RAJBANSHI,Independent,1127,0,1127,0.51,West Bengal-Gazole
9,NOTA,None of the Above,1728,8,1736,0.78,West Bengal-Gazole
1,KAMAL CHANDRA DOLUI,Communist Party of India  (Marxist),9931,234,10165,4.51,West Bengal-Ghatal
2,SITAL KAPAT,Bharatiya Janata Party,104753,1059,105812,46.95,West Bengal-Ghatal
3,SHANKAR DOLAI,All India Trinamool Congress,104044,802,104846,46.52,West Bengal-Ghatal
4,ANJAN JANA,SOCIALIST UNITY CENTRE OF INDIA (COMMUNIST),1998,10,2008,0.89,West Bengal-Ghatal
5,TAPAN KUMAR DOLUI,Independent,1232,7,1239,0.55,West Bengal-Ghatal
6,NOTA,None of the Above,1295,10,1305,0.58,West Bengal-Ghatal
1,MD. GHULAM RABBANI,All India Trinamool Congress,105083,566,105649,65.4,West Bengal-Goalpokhar
2,MD. GHULAM SARWAR,Bharatiya Janata Party,32029,106,32135,19.89,West Bengal-Goalpokhar
3,MASOOD MD. NASEEM AHSEN,Indian National Congress,19305,86,19391,12,West Bengal-Goalpokhar
4,SUNIL BISWAS,Bahujan Samaj Party,861,4,865,0.54,West Bengal-Goalpokhar
5,NABIN CHANDRA SINGHA,SOCIALIST UNITY CENTRE OF INDIA (COMMUNIST),378,2,380,0.24,West Bengal-Goalpokhar
6,RAGHU NATH SINGHA,Independent,405,0,405,0.25,West Bengal-Goalpokhar
7,SHAMBHU LAL ROY,Independent,693,1,694,0.43,West Bengal-Goalpokhar
8,NOTA,None of the Above,2014,2,2016,1.25,West Bengal-Goalpokhar
1,BISWANATH KARAK,Bharatiya Janata Party,101743,484,102227,46.56,West Bengal-Goghat
2,MANAS MAJUMDAR,All India Trinamool Congress,97523,557,98080,44.67,West Bengal-Goghat
3,SHIBA PRASAD MALICK,All India Forward Bloc,14288,90,14378,6.55,West Bengal-Goghat
4,SAMIR ROY,Bahujan Samaj Party,2364,14,2378,1.08,West Bengal-Goghat
5,NOTA,None of the Above,2472,10,2482,1.13,West Bengal-Goghat
1,Dr. Khagendra Nath Mahata,All India Trinamool Congress,102710,1405,104115,52.3,West Bengal-Gopiballavpur
2,Prasanta Kumar Das,Communist Party of India  (Marxist),5689,130,5819,2.92,West Bengal-Gopiballavpur
3,Banamali Nayek,Bahujan Samaj Party,1248,12,1260,0.63,West Bengal-Gopiballavpur
4,Sanjit Mahata,Bharatiya Janata Party,79106,1241,80347,40.36,West Bengal-Gopiballavpur
5,Ashoke Mahata,Independent,972,8,980,0.49,West Bengal-Gopiballavpur
6,Jiten Giri,Independent,572,17,589,0.3,West Bengal-Gopiballavpur
7,Rajesh Mahato,Independent,1162,5,1167,0.59,West Bengal-Gopiballavpur
8,Subhas Mahata (Bula Babu),Independent,1214,10,1224,0.61,West Bengal-Gopiballavpur
9,Susanta Kumar Das,Independent,767,11,778,0.39,West Bengal-Gopiballavpur
10,NOTA,None of the Above,2781,10,2791,1.4,West Bengal-Gopiballavpur
1,ANIL CHANDRA MONDAL,Revolutionary Socialist Party,4848,23,4871,2.49,West Bengal-Gosaba
2,JAYANTA NASKAR,All India Trinamool Congress,104758,965,105723,53.99,West Bengal-Gosaba
3,BARUN PRAMANIK (CHITTA),Bharatiya Janata Party,81515,499,82014,41.88,West Bengal-Gosaba
4,HARIPADA MANDAL,Bahujan Samaj Party,1270,1,1271,0.65,West Bengal-Gosaba
5,TAPAN MISTRI,SOCIALIST UNITY CENTRE OF INDIA (COMMUNIST),910,2,912,0.47,West Bengal-Gosaba
6,NOTA,None of the Above,1013,4,1017,0.52,West Bengal-Gosaba
1,JOYEL MURMU,Bharatiya Janata Party,92982,1093,94075,47.52,West Bengal-Habibpur
2,THAKUR TUDU,Communist Party of India  (Marxist),13649,156,13805,6.97,West Bengal-Habibpur
3,PRODIP BASKEY,All India Trinamool Congress,73956,602,74558,37.66,West Bengal-Habibpur
4,SHRINATH TUDU,Bahujan Samaj Party,1658,9,1667,0.84,West Bengal-Habibpur
5,PRATAP KORAMUDI,Ambedkarite Party of India,1879,8,1887,0.95,West Bengal-Habibpur
6,BABURAM KISKU,Bahujan Mukti Party,5878,18,5896,2.98,West Bengal-Habibpur
7,BISWANATH MARDI,Kamatapur Peopleâ€™s Party (United),742,5,747,0.38,West Bengal-Habibpur
8,NIRMAL SOREN,Independent,655,6,661,0.33,West Bengal-Habibpur
9,PROVAT KISKU,Independent,1696,5,1701,0.86,West Bengal-Habibpur
10,MURMU JOY,Independent,829,1,830,0.42,West Bengal-Habibpur
11,NOTA,None of the Above,2145,17,2162,1.09,West Bengal-Habibpur
1,RIJINANDAN BISWAS,Communist Party of India  (Marxist),21781,213,21994,10.77,West Bengal-Habra
2,JYOTI PRIYA MALLICK,All India Trinamool Congress,89860,673,90533,44.34,West Bengal-Habra
3,BISWAJIT SINHA,Bharatiya Janata Party,86208,484,86692,42.46,West Bengal-Habra
4,SANTOSH BISWAS,Bahujan Samaj Party,1120,5,1125,0.55,West Bengal-Habra
5,KISHOR BISWAS,Purvanchal Mahapanchayat,360,0,360,0.18,West Bengal-Habra
6,PROBODH KUMAR SARKAR,SOCIALIST UNITY CENTRE OF INDIA (COMMUNIST),1054,8,1062,0.52,West Bengal-Habra
7,AMAR KRISHNA MANDAL,Independent,1113,2,1115,0.55,West Bengal-Habra
8,NOTA,None of the Above,1276,14,1290,0.63,West Bengal-Habra
1,Kar Paik Manika,Communist Party of India  (Marxist),22510,178,22688,10.27,West Bengal-Haldia
2,Tapasi Mondal,Bharatiya Janata Party,103489,637,104126,47.15,West Bengal-Haldia
3,Subrata Ghorai,Bahujan Samaj Party,1920,2,1922,0.87,West Bengal-Haldia
4,Swapan Naskar,All India Trinamool Congress,88663,455,89118,40.36,West Bengal-Haldia
5,Narayan Pramanik,SOCIALIST UNITY CENTRE OF INDIA (COMMUNIST),1548,8,1556,0.7,West Bengal-Haldia
6,NOTA,None of the Above,1408,5,1413,0.64,West Bengal-Haldia
1,Dr. ASOK KUMAR CHATTOPADHYAY,All India Trinamool Congress,107429,860,108289,51.42,West Bengal-Hansan
2,NIKHIL BANERJEE,Bharatiya Janata Party,57123,553,57676,27.39,West Bengal-Hansan
3,MILTAN RASID,Indian National Congress,39424,391,39815,18.9,West Bengal-Hansan
4,SUSHEN DAS,Bahujan Samaj Party,1170,7,1177,0.56,West Bengal-Hansan
5,JUTHIKA DHIBAR,SOCIALIST UNITY CENTRE OF INDIA (COMMUNIST),1225,4,1229,0.58,West Bengal-Hansan
6,NOTA,None of the Above,2418,2,2420,1.15,West Bengal-Hansan
1,TANMOY BISWAS,Bharatiya Janata Party,18261,117,18378,8.51,West Bengal-Hariharpara
2,NIAMOT SHEIKH,All India Trinamool Congress,101982,678,102660,47.51,West Bengal-Hariharpara
3,MIR ALAMGIR (PALASH),Indian National Congress,88000,594,88594,41,West Bengal-Hariharpara
4,GOLAM AMBIA,SOCIALIST UNITY CENTRE OF INDIA (COMMUNIST),1711,14,1725,0.8,West Bengal-Hariharpara
5,ABUBAKKAR MANDAL,Independent,265,2,267,0.12,West Bengal-Hariharpara
6,ALAMGIR MANDAL,Independent,230,1,231,0.11,West Bengal-Hariharpara
7,INDRAJIT BAGDI,Independent,153,1,154,0.07,West Bengal-Hariharpara
8,WAHED ANSARY,Independent,202,0,202,0.09,West Bengal-Hariharpara
9,MINTU HALDAR,Independent,673,1,674,0.31,West Bengal-Hariharpara
10,RAFIKUL ISLAM,Independent,1079,0,1079,0.5,West Bengal-Hariharpara
11,SAHABUR RAHAMAN  KHA,Independent,994,0,994,0.46,West Bengal-Hariharpara
12,NOTA,None of the Above,1105,12,1117,0.52,West Bengal-Hariharpara
1,ALAKESH DAS,Communist Party of India  (Marxist),24635,165,24800,11.76,West Bengal-Haringhata
2,ASIM KUMAR SARKAR,Bharatiya Janata Party,96970,696,97666,46.31,West Bengal-Haringhata
3,NILIMA NAG (MALLICK),All India Trinamool Congress,81686,780,82466,39.11,West Bengal-Haringhata
4,SAMIR BISWAS,Bahujan Samaj Party,1153,0,1153,0.55,West Bengal-Haringhata
5,Biplab Chandra Das,SOCIALIST UNITY CENTRE OF INDIA (COMMUNIST),403,1,404,0.19,West Bengal-Haringhata
6,MADHAB BISWAS,Party for Democratic Socialism,376,0,376,0.18,West Bengal-Haringhata
7,HARISH CHANDRA BISWAS,Purvanchal Mahapanchayat,444,2,446,0.21,West Bengal-Haringhata
8,NAYAN HALDER,Independent,1154,2,1156,0.55,West Bengal-Haringhata
9,SHIBU DAS,Independent,980,0,980,0.46,West Bengal-Haringhata
10,NOTA,None of the Above,1420,7,1427,0.68,West Bengal-Haringhata
1,Dr. Karabi Manna,All India Trinamool Congress,109128,1087,110215,49.92,West Bengal-Haripal
2,Totan Bag,Bahujan Samaj Party,2108,24,2132,0.97,West Bengal-Haripal
3,Samiran Mitra,Bharatiya Janata Party,86561,582,87143,39.47,West Bengal-Haripal
4,Biswanath Ghosh,SOCIALIST UNITY CENTRE OF INDIA (COMMUNIST),2103,19,2122,0.96,West Bengal-Haripal
5,Simal Saren,Rashtriya Secular Majlis Party,15662,133,15795,7.15,West Bengal-Haripal
6,NOTA,None of the Above,3344,23,3367,1.53,West Bengal-Haripal
1,NILANJAN ROY,Bharatiya Janata Party,72793,666,73459,39.15,West Bengal-Harirampur
2,BIPLAB MITRA,All India Trinamool Congress,95432,699,96131,51.23,West Bengal-Harirampur
3,RAFIKUL ISLAM,Communist Party of India  (Marxist),12268,176,12444,6.63,West Bengal-Harirampur
4,SHANKAR MARDI,Bahujan Mukti Party,569,2,571,0.3,West Bengal-Harirampur
5,HARISH MAHATO,SOCIALIST UNITY CENTRE OF INDIA (COMMUNIST),277,1,278,0.15,West Bengal-Harirampur
6,JALALUDDIN AHMED,Independent,333,0,333,0.18,West Bengal-Harirampur
7,PRADIP KUMAR PRAMANIK,Independent,769,3,772,0.41,West Bengal-Harirampur
8,BIJAN CHAKRABORTY,Independent,1829,2,1831,0.98,West Bengal-Harirampur
9,NOTA,None of the Above,1818,5,1823,0.97,West Bengal-Harirampur
1,ALAM MD RAFIQUL,All India Forward Bloc,1272,13,1285,0.63,West Bengal-Harischandrapur
2,ALAM MOSTAQUE,Indian National Congress,29179,217,29396,14.47,West Bengal-Harischandrapur
3,TAJMUL HOSSAIN,All India Trinamool Congress,121850,677,122527,60.31,West Bengal-Harischandrapur
4,MD. MATIBUR RAHAMAN,Bharatiya Janata Party,44841,213,45054,22.18,West Bengal-Harischandrapur
5,RAM BILAS MANDAL,Bahujan Samaj Party,1304,1,1305,0.64,West Bengal-Harischandrapur
6,MUSARAF HOSSAIN,SOCIALIST UNITY CENTRE OF INDIA (COMMUNIST),629,0,629,0.31,West Bengal-Harischandrapur
7,MD OLIUR RAHAMAN,Independent,1473,0,1473,0.73,West Bengal-Harischandrapur
8,SUBRATA DAS,Independent,472,0,472,0.23,West Bengal-Harischandrapur
9,NOTA,None of the Above,1008,4,1012,0.5,West Bengal-Harischandrapur
1,ISLAM SK NURUL (HAJI),All India Trinamool Congress,129743,655,130398,57.34,West Bengal-Haroa
2,RAJENDRA SAHA (SOMU),Bharatiya Janata Party,38349,157,38506,16.93,West Bengal-Haroa
3,AKHER ALI MOLLA,United Socialist Party,2395,6,2401,1.06,West Bengal-Haroa
4,ABUL KALAM,"Justice and Development Party,",1254,2,1256,0.55,West Bengal-Haroa
5,KUTUBUDDIN FATHE,Rashtriya Secular Majlis Party,49326,94,49420,21.73,West Bengal-Haroa
6,MD KUTUBUDDIN,Independent,2484,0,2484,1.09,West Bengal-Haroa
7,NOTA,None of the Above,2928,2,2930,1.29,West Bengal-Haroa
1,CHANDIMA ROY,Bharatiya Janata Party,88481,729,89210,39.95,West Bengal-Hemtabad
2,BINAY KUMAR ROY,Bahujan Samaj Party,1406,5,1411,0.63,West Bengal-Hemtabad
3,BHUPEN BARMAN,Communist Party of India  (Marxist),9297,156,9453,4.23,West Bengal-Hemtabad
4,SATYAJIT BARMAN,All India Trinamool Congress,115346,1079,116425,52.14,West Bengal-Hemtabad
5,JYOTIRMAY BARMAN,SOCIALIST UNITY CENTRE OF INDIA (COMMUNIST),1510,8,1518,0.68,West Bengal-Hemtabad
6,MANINDRA BARMAN,Amra Bangalee,1580,1,1581,0.71,West Bengal-Hemtabad
7,DIPU BARMAN,Independent,699,2,701,0.31,West Bengal-Hemtabad
8,SANKAR BARMAN,Independent,840,2,842,0.38,West Bengal-Hemtabad
9,NOTA,None of the Above,2154,6,2160,0.97,West Bengal-Hemtabad
1,DEBES MANDAL,All India Trinamool Congress,103666,1040,104706,53.78,West Bengal-Hingalganj
2,NEMAI DAS,Bharatiya Janata Party,78962,828,79790,40.98,West Bengal-Hingalganj
3,NIRMAL MUDI,Bahujan Samaj Party,836,14,850,0.44,West Bengal-Hingalganj
4,RANJAN KUMAR MONDAL,Communist Party of India,5922,86,6008,3.09,West Bengal-Hingalganj
5,SANJIT MONDAL,Jan Sangh Party,431,2,433,0.22,West Bengal-Hingalganj
6,KRISHNA GAYEN,Independent,1156,2,1158,0.59,West Bengal-Hingalganj
7,NOTA,None of the Above,1734,2,1736,0.89,West Bengal-Hingalganj
1,NANDITA CHOWDHURY,All India Trinamool Congress,116651,188,116839,53.86,West Bengal-Howrah Dakshin
2,RANTIDEV  SENGUPTA,Bharatiya Janata Party,66088,182,66270,30.55,West Bengal-Howrah Dakshin
3,SUMITRO ADHIKARY,Communist Party of India  (Marxist),27168,119,27287,12.58,West Bengal-Howrah Dakshin
4,AMIT KUMAR GHOSH,Janata Dal  (United),654,0,654,0.3,West Bengal-Howrah Dakshin
5,TAPAS KUMAR  DAS,SOCIALIST UNITY CENTRE OF INDIA (COMMUNIST),320,2,322,0.15,West Bengal-Howrah Dakshin
6,PABITRA BISWAS,Independent,135,1,136,0.06,West Bengal-Howrah Dakshin
7,MAMATA BANERJEE,Independent,321,1,322,0.15,West Bengal-Howrah Dakshin
8,RAJESH KUMAR SINGH,Independent,170,1,171,0.08,West Bengal-Howrah Dakshin
9,SAJAL SARDAR,Independent,157,0,157,0.07,West Bengal-Howrah Dakshin
10,SAMIR BACHAR,Independent,313,0,313,0.14,West Bengal-Howrah Dakshin
11,SAMRAT CHATTOPADHYAY,Independent,457,1,458,0.21,West Bengal-Howrah Dakshin
12,SUSHANTA MONDAL,Independent,1063,0,1063,0.49,West Bengal-Howrah Dakshin
13,NOTA,None of the Above,2937,11,2948,1.36,West Bengal-Howrah Dakshin
1,"Arup Roy, S/o Late Prabhat Roy",All India Trinamool Congress,111343,211,111554,57.16,West Bengal-Howrah Madhya
2,Palash Bhandari,Indian National Congress,12904,38,12942,6.63,West Bengal-Howrah Madhya
3,Sanjay Singh,Bharatiya Janata Party,64885,122,65007,33.31,West Bengal-Howrah Madhya
4,Anamika Singh,Janata Dal  (United),544,1,545,0.28,West Bengal-Howrah Madhya
5,Chandrakant Jaiswal,Vikas India Party,153,1,154,0.08,West Bengal-Howrah Madhya
6,Shrirup Das,SOCIALIST UNITY CENTRE OF INDIA (COMMUNIST),282,2,284,0.15,West Bengal-Howrah Madhya
7,"Arup Roy, S/o Late Gopal Roy",Independent,267,0,267,0.14,West Bengal-Howrah Madhya
8,Pankoj Gar,Independent,238,1,239,0.12,West Bengal-Howrah Madhya
9,Pradip Kanji,Independent,101,0,101,0.05,West Bengal-Howrah Madhya
10,Babu Malick,Independent,124,1,125,0.06,West Bengal-Howrah Madhya
11,Md. Nazir Alam,Independent,243,0,243,0.12,West Bengal-Howrah Madhya
12,Samir Mondal,Independent,488,0,488,0.25,West Bengal-Howrah Madhya
13,Subrata Mondal,Independent,460,0,460,0.24,West Bengal-Howrah Madhya
14,NOTA,None of the Above,2734,1,2735,1.4,West Bengal-Howrah Madhya
1,UMESH RAI,Bharatiya Janata Party,65936,117,66053,44.12,West Bengal-Howrah Uttar
2,GAUTAM CHOWDHURI,All India Trinamool Congress,71408,167,71575,47.81,West Bengal-Howrah Uttar
3,PAWAN KUMAR SINGH,Communist Party of India  (Marxist),8091,42,8133,5.43,West Bengal-Howrah Uttar
4,ASHOK KUMAR SHARMA,Hindustani Awam Morcha (Secular),250,1,251,0.17,West Bengal-Howrah Uttar
5,GANESHLAL GUPTA,National Republic Party Of India,98,0,98,0.07,West Bengal-Howrah Uttar
6,RAJ KUMAR PASWAN,Bharatiya Momin Front,91,0,91,0.06,West Bengal-Howrah Uttar
7,DHARMENDRA RAI,Independent,103,1,104,0.07,West Bengal-Howrah Uttar
8,VIJAY SHAH,Independent,162,0,162,0.11,West Bengal-Howrah Uttar
9,VINIT KUMAR RAI,Independent,97,0,97,0.06,West Bengal-Howrah Uttar
10,SISIR SAMANTA,Independent,104,2,106,0.07,West Bengal-Howrah Uttar
11,SHYAM PRASAD RAM,Independent,167,0,167,0.11,West Bengal-Howrah Uttar
12,SUNIL SAU,Independent,302,0,302,0.2,West Bengal-Howrah Uttar
13,SUBHASH KUMAR SINGHI,Independent,911,0,911,0.61,West Bengal-Howrah Uttar
14,NOTA,None of the Above,1668,2,1670,1.12,West Bengal-Howrah Uttar
1,NAYAN KUMAR SHILL (BAGDI),Communist Party of India  (Marxist),12503,116,12619,5.78,West Bengal-Indus
2,NIRMAL KUMAR DHARA,Bharatiya Janata Party,104163,773,104936,48.04,West Bengal-Indus
3,RUNU METE,All India Trinamool Congress,96808,908,97716,44.73,West Bengal-Indus
4,NOTA,None of the Above,3164,18,3182,1.46,West Bengal-Indus
1,ABDUL KARIM CHOWDHARY,All India Trinamool Congress,99380,751,100131,58.91,West Bengal-Islampur
2,SADIQUL ISLAM,Indian National Congress,3405,56,3461,2.04,West Bengal-Islampur
3,SAUMYAROOP MANDAL,Bharatiya Janata Party,61909,782,62691,36.88,West Bengal-Islampur
4,BIRENDRA NATH SINHA,SOCIALIST UNITY CENTRE OF INDIA (COMMUNIST),1142,10,1152,0.68,West Bengal-Islampur
5,MD. NAIYAR ALAM,Independent,563,0,563,0.33,West Bengal-Islampur
6,NOTA,None of the Above,1962,14,1976,1.16,West Bengal-Islampur
1,AMIT KUMAR KUNDU,Bharatiya Janata Party,69949,721,70670,36.43,West Bengal-Itahar
2,MOSARAF HUSSEN,All India Trinamool Congress,113867,778,114645,59.1,West Bengal-Itahar
3,SRIKUMAR MUKHERJEE,Communist Party of India,4801,107,4908,2.53,West Bengal-Itahar
4,MOFAKKERUL ISLAM,All India Majlis-E-Ittehadul Muslimeen,828,3,831,0.43,West Bengal-Itahar
5,TUFAN BARMAN,Independent,185,4,189,0.1,West Bengal-Itahar
6,DILIP KUMAR BARMAN,Independent,131,2,133,0.07,West Bengal-Itahar
7,FIROJ ALAM,Independent,344,2,346,0.18,West Bengal-Itahar
8,MOJAMMEL HAQUE,Independent,1024,0,1024,0.53,West Bengal-Itahar
9,NOTA,None of the Above,1239,1,1240,0.64,West Bengal-Itahar
1,DEBABRATA MAJUMDAR (MALAY),All India Trinamool Congress,97152,948,98100,45.54,West Bengal-Jadavpur
2,RINKU NASKAR,Bharatiya Janata Party,52795,344,53139,24.67,West Bengal-Jadavpur
3,Dr. SUJAN CHAKRABORTY,Communist Party of India  (Marxist),58666,565,59231,27.5,West Bengal-Jadavpur
4,SUJOY NASKAR,Bahujan Samaj Party,639,10,649,0.3,West Bengal-Jadavpur
5,MONALISA GUPTA (DEBROY),Party for Democratic Socialism,380,5,385,0.18,West Bengal-Jadavpur
6,ATANU CHATTERJEE,Independent,100,0,100,0.05,West Bengal-Jadavpur
7,ASHUTOSH DEY,Independent,86,5,91,0.04,West Bengal-Jadavpur
8,TANUJIT DAS,Independent,106,4,110,0.05,West Bengal-Jadavpur
9,NRIPENDRA KRISHNA ROY,Independent,225,4,229,0.11,West Bengal-Jadavpur
10,MISTOO DAS,Independent,255,0,255,0.12,West Bengal-Jadavpur
11,MEGHA CHATTERJEE,Independent,398,2,400,0.19,West Bengal-Jadavpur
12,NOTA,None of the Above,2713,17,2730,1.27,West Bengal-Jadavpur
1,ANUPAM GHOSH,Bharatiya Janata Party,87016,350,87366,37.06,West Bengal-Jagatballavpur
2,SITANATH GHOSH,All India Trinamool Congress,116137,425,116562,49.45,West Bengal-Jagatballavpur
3,GOBARDHAN MANNA,Indian Unity Centre,1971,1,1972,0.84,West Bengal-Jagatballavpur
4,SK SABBIR AHMED,Rashtriya Secular Majlis Party,25279,83,25362,10.76,West Bengal-Jagatballavpur
5,PANCHANAN MAHANTA,Independent,1688,2,1690,0.72,West Bengal-Jagatballavpur
6,NOTA,None of the Above,2760,9,2769,1.17,West Bengal-Jagatballavpur
1,ARINDAM BHATTACHARYA,Bharatiya Janata Party,68221,445,68666,37.88,West Bengal-Jagatdal
2,KRISHNA CHANDRA SARKAR,Bahujan Samaj Party,899,9,908,0.5,West Bengal-Jagatdal
3,NEMAI SAHA,All India Forward Bloc,16555,193,16748,9.24,West Bengal-Jagatdal
4,SOMENATH SHYAM ICHINI,All India Trinamool Congress,86266,764,87030,48.01,West Bengal-Jagatdal
5,RATANMOHAN LASKAR,SOCIALIST UNITY CENTRE OF INDIA (COMMUNIST),800,7,807,0.45,West Bengal-Jagatdal
6,AJAY MAJUMDAR,Independent,436,0,436,0.24,West Bengal-Jagatdal
7,DEBASISH BHATTACHARJEE,Independent,443,1,444,0.24,West Bengal-Jagatdal
8,BRAHMDEO GUPTA,Revolutionary Socialist Party of India(Marxist),259,1,260,0.14,West Bengal-Jagatdal
9,RAJA ANSARI,Independent,452,2,454,0.25,West Bengal-Jagatdal
10,SUVAMAY PAN,Independent,1514,8,1522,0.84,West Bengal-Jagatdal
11,SURAJ TIWARI,Independent,567,2,569,0.31,West Bengal-Jagatdal
12,SOMNATH SARKAR,Independent,868,7,875,0.48,West Bengal-Jagatdal
13,NOTA,None of the Above,2558,10,2568,1.42,West Bengal-Jagatdal
1,ABDUR RAZZAK,All India Trinamool Congress,123096,744,123840,55.74,West Bengal-Jalangi
2,CHANDAN MANDAL,Bharatiya Janata Party,43395,378,43773,19.7,West Bengal-Jalangi
3,SAIFUL ISLAM MOLLA,Communist Party of India  (Marxist),44224,340,44564,20.06,West Bengal-Jalangi
4,ALSOKUAT JAMAN,All India Majlis-E-Ittehadul Muslimeen,1327,11,1338,0.6,West Bengal-Jalangi
5,ENAMUL HAQUE,SOCIALIST UNITY CENTRE OF INDIA (COMMUNIST),261,3,264,0.12,West Bengal-Jalangi
6,MD. ABDUL HAMID,Bahujan Mukti Party,277,0,277,0.12,West Bengal-Jalangi
7,SARIFUL MANDAL,"Justice and Development Party,",253,1,254,0.11,West Bengal-Jalangi
8,SUBIR KUMAR SARKAR,Amra Bangalee,381,7,388,0.17,West Bengal-Jalangi
9,NABENDU KUMAR MONDAL,Independent,726,3,729,0.33,West Bengal-Jalangi
10,RAFIKA SULTANA,Independent,4172,17,4189,1.89,West Bengal-Jalangi
11,NOTA,None of the Above,2540,11,2551,1.15,West Bengal-Jalangi
1,DR. PRADIP KUMAR BARMA,All India Trinamool Congress,93648,2020,95668,42.34,West Bengal-Jalpaiguri
2,SUKHBILAS BARMA,Indian National Congress,23173,1055,24228,10.72,West Bengal-Jalpaiguri
3,SUBHASH KUMAR SARKAR,Bahujan Samaj Party,1590,19,1609,0.71,West Bengal-Jalpaiguri
4,SOUJIT SINGHA (PIKU),Bharatiya Janata Party,92373,2354,94727,41.93,West Bengal-Jalpaiguri
5,ISWAR BARAI,Amra Bangalee,999,12,1011,0.45,West Bengal-Jalpaiguri
6,PALENDRA NATH ROY,SOCIALIST UNITY CENTRE OF INDIA (COMMUNIST),884,14,898,0.4,West Bengal-Jalpaiguri
7,PRAHLAD ROY,Independent,725,21,746,0.33,West Bengal-Jalpaiguri
8,RAKHI SARKAR,Independent,1537,19,1556,0.69,West Bengal-Jalpaiguri
9,HARIDAS BISWAS,Independent,949,13,962,0.43,West Bengal-Jalpaiguri
10,HAREKRISHNA SARKAR,Independent,1142,5,1147,0.51,West Bengal-Jalpaiguri
11,NOTA,None of the Above,3334,47,3381,1.5,West Bengal-Jalpaiguri
1,ALOK KUMAR MAJHI,All India Trinamool Congress,96460,539,96999,46.93,West Bengal-Jamalpur
2,GAURHARI PATRA,Bahujan Samaj Party,2018,6,2024,0.98,West Bengal-Jamalpur
3,BALARAM BAPARI,Bharatiya Janata Party,78693,335,79028,38.24,West Bengal-Jamalpur
4,SAMAR HAZRA,Communist Party of India  (Marxist),23184,114,23298,11.27,West Bengal-Jamalpur
5,KARTIK KSHETRAPAL,Bahujan Mukti Party,1285,6,1291,0.62,West Bengal-Jamalpur
6,TARUN KANTI MAJHI,Communist Party of India  (Marxist-Leninist)  (Liberation),1182,3,1185,0.57,West Bengal-Jamalpur
7,NOTA,None of the Above,2859,6,2865,1.39,West Bengal-Jamalpur
1,AISHE GHOSH,Communist Party of India  (Marxist),24596,222,24818,14.89,West Bengal-Jamuria
2,TAPAS KUMAR ROY,Bharatiya Janata Party,62620,331,62951,37.76,West Bengal-Jamuria
3,BHANU PRATAP SHARMA,Bahujan Samaj Party,2401,8,2409,1.45,West Bengal-Jamuria
4,HARERAM SINGH,All India Trinamool Congress,70533,469,71002,42.59,West Bengal-Jamuria
5,GOURI SANKAR BANERJEE,Janata Dal  (United),1482,2,1484,0.89,West Bengal-Jamuria
6,LAKHIRAM HANSDA,Bahujan Mukti Party,1681,5,1686,1.01,West Bengal-Jamuria
7,NOTA,None of the Above,2346,7,2353,1.41,West Bengal-Jamuria
1,DEBJIT SARKAR,Bharatiya Janata Party,83474,485,83959,39.9,West Bengal-Jangipara
2,SNEHASIS CHAKRABORTY,All India Trinamool Congress,101054,831,101885,48.42,West Bengal-Jangipara
3,SK. MAINUDDIN,Rashtriya Secular Majlis Party,17661,95,17756,8.44,West Bengal-Jangipara
4,TANUSREE GHOSH,Independent,654,7,661,0.31,West Bengal-Jangipara
5,SAMIR BANDYOPADHYAY,Independent,449,18,467,0.22,West Bengal-Jangipara
6,SK. AMJAD ALI,Independent,953,5,958,0.46,West Bengal-Jangipara
7,SK. SAMSUDDIN,Independent,1681,4,1685,0.8,West Bengal-Jangipara
8,NOTA,None of the Above,3031,9,3040,1.44,West Bengal-Jangipara
1,APURBA PRAMANIK (APU),Communist Party of India  (Marxist),17308,60,17368,8.58,West Bengal-Jaynagar
2,BISWANATH DAS,All India Trinamool Congress,104527,425,104952,51.85,West Bengal-Jaynagar
3,RABIN SARDAR,Bharatiya Janata Party,65943,326,66269,32.74,West Bengal-Jaynagar
4,SANKAR DEB MONDAL,Bahujan Samaj Party,809,2,811,0.4,West Bengal-Jaynagar
5,AMITAV NASKAR,Republican Party of India (A),186,1,187,0.09,West Bengal-Jaynagar
6,UTPAL MANDAL,Lok Jan Shakti Party,245,3,248,0.12,West Bengal-Jaynagar
7,TARUN KANTI NASKAR,SOCIALIST UNITY CENTRE OF INDIA (COMMUNIST),9354,69,9423,4.65,West Bengal-Jaynagar
8,MONOTOSH NASKAR,Bahujan Mukti Party,571,3,574,0.28,West Bengal-Jaynagar
9,SWAPAN KUMAR NASKAR,Independent,1433,2,1435,0.71,West Bengal-Jaynagar
10,NOTA,None of the Above,1162,2,1164,0.58,West Bengal-Jaynagar
1,BIRBAHA HANSDA,All India Trinamool Congress,108044,1449,109493,54.26,West Bengal-Jhargram
2,MADHUJA SEN ROY,Communist Party of India  (Marxist),10179,251,10430,5.17,West Bengal-Jhargram
3,RAMKRISHNA SARKAR,Bahujan Samaj Party,1786,16,1802,0.89,West Bengal-Jhargram
4,SUKHAMAY SATPATHY (JAHAR),Bharatiya Janata Party,70048,1205,71253,35.31,West Bengal-Jhargram
5,ARCHANA SAIN,SOCIALIST UNITY CENTRE OF INDIA (COMMUNIST),1187,6,1193,0.59,West Bengal-Jhargram
6,LAXMAN HANSDA,Amra Bangalee,573,7,580,0.29,West Bengal-Jhargram
7,ASHUTOSH RANA,Independent,488,11,499,0.25,West Bengal-Jhargram
8,MADHUSUDAN SINGHA,Independent,1155,4,1159,0.57,West Bengal-Jhargram
9,SIBAJI MAHATA,Independent,786,14,800,0.4,West Bengal-Jhargram
10,HAMLET BASKEY,Independent,941,11,952,0.47,West Bengal-Jhargram
11,NOTA,None of the Above,3615,21,3636,1.8,West Bengal-Jhargram
1,AJMAL KHAN,Indian National Congress,4736,33,4769,4.82,West Bengal-Jorasanko
2,MEENA DEVI PUROHIT,Bharatiya Janata Party,39238,142,39380,39.8,West Bengal-Jorasanko
3,NIRMAL KANTI SAMADDAR,Bahujan Samaj Party,411,1,412,0.42,West Bengal-Jorasanko
4,VIVEK GUPTA,All India Trinamool Congress,51904,219,52123,52.67,West Bengal-Jorasanko
5,BIJNAN KUMAR BERA,SOCIALIST UNITY CENTRE OF INDIA (COMMUNIST),405,3,408,0.41,West Bengal-Jorasanko
6,ANAND SINGH KHARWAR,Independent,96,0,96,0.1,West Bengal-Jorasanko
7,ANIL KUMAR CHOUDHARY,Independent,94,1,95,0.1,West Bengal-Jorasanko
8,NAWAL MONDAL,Independent,359,2,361,0.36,West Bengal-Jorasanko
9,RANJIT KUMAR THAKUR,Independent,103,1,104,0.11,West Bengal-Jorasanko
10,SUSHANTA GHOSH,Independent,178,1,179,0.18,West Bengal-Jorasanko
11,NOTA,None of the Above,1024,4,1028,1.04,West Bengal-Jorasanko
1,Dhirendra Nath Mahato,All India Forward Bloc,19200,213,19413,9.57,West Bengal-Joypur
2,Nara Hari Mahato,Bharatiya Janata Party,73713,667,74380,36.68,West Bengal-Joypur
3,Phanibhushan Kumar,Indian National Congress,61611,569,62180,30.67,West Bengal-Joypur
4,Jawahar Lal Mahato,Mulnibasi Party of India,2086,16,2102,1.04,West Bengal-Joypur
5,Tirthanath Mahata,Akhil Bharat Hindu Mahasabha,606,7,613,0.3,West Bengal-Joypur
6,Bhagirath Mahato,SOCIALIST UNITY CENTRE OF INDIA (COMMUNIST),1121,5,1126,0.56,West Bengal-Joypur
7,Dibyajoti Singh Deo,Independent,35281,148,35429,17.47,West Bengal-Joypur
8,Nageswar Mahato,Independent,1405,14,1419,0.7,West Bengal-Joypur
9,Nepal Chandra Mahato,Independent,1928,52,1980,0.98,West Bengal-Joypur
10,Bahadur Kushbaha Kuiri,Independent,1162,7,1169,0.58,West Bengal-Joypur
11,NOTA,None of the Above,2944,12,2956,1.46,West Bengal-Joypur
1,INDRANIL ROUT,Indian National Congress,12208,26,12234,5.57,West Bengal-Kakdwip
2,DIPANKAR JANA,Bharatiya Janata Party,88926,265,89191,40.62,West Bengal-Kakdwip
3,PARBATI BHUNIA,Bahujan Samaj Party,1628,2,1630,0.74,West Bengal-Kakdwip
4,MANTURAM PAKHIRA,All India Trinamool Congress,113940,553,114493,52.14,West Bengal-Kakdwip
5,JHANTU MAITY,SOCIALIST UNITY CENTRE OF INDIA (COMMUNIST),1023,3,1026,0.47,West Bengal-Kakdwip
6,NOTA,None of the Above,1018,5,1023,0.47,West Bengal-Kakdwip
1,AVIJIT NARJINARY,Indian National Congress,5386,96,5482,2.8,West Bengal-Kalchini
2,ASHOK LAMA,National People's Party,794,9,803,0.41,West Bengal-Kalchini
3,PASSANG LAMA,All India Trinamool Congress,73896,632,74528,38.06,West Bengal-Kalchini
4,BISHAL LAMA,Bharatiya Janata Party,102247,857,103104,52.65,West Bengal-Kalchini
5,CHANCHAL NARJINARY,Lok Jan Shakti Party,1163,1,1164,0.59,West Bengal-Kalchini
6,MADAN KUMAR URAON,Janata Dal  (United),419,4,423,0.22,West Bengal-Kalchini
7,HAKIM MAHALI,Bahujan Mukti Party,475,4,479,0.24,West Bengal-Kalchini
8,PRAKASH KUJUR,Independent,1858,11,1869,0.95,West Bengal-Kalchini
9,BINAY NARJINARY,Independent,2416,9,2425,1.24,West Bengal-Kalchini
10,REKHA LAKRA (EKKA),Independent,2242,9,2251,1.15,West Bengal-Kalchini
11,SUKUMAR MINJ,Independent,907,3,910,0.46,West Bengal-Kalchini
12,NOTA,None of the Above,2370,7,2377,1.21,West Bengal-Kalchini
1,TAPAN DEB SINGHA,All India Trinamool Congress,93723,1225,94948,39.61,West Bengal-Kaliaganj
2,PRAVASH SARKAR,Indian National Congress,16451,319,16770,7,West Bengal-Kaliaganj
3,SOUMEN ROY,Bharatiya Janata Party,115577,1191,116768,48.71,West Bengal-Kaliaganj
4,GOPAL CHUNARY,SOCIALIST UNITY CENTRE OF INDIA (COMMUNIST),1070,3,1073,0.45,West Bengal-Kaliaganj
5,NAMALA KANTA SARKAR,Amra Bangalee,385,2,387,0.16,West Bengal-Kaliaganj
6,ALEN SARKAR,Independent,407,1,408,0.17,West Bengal-Kaliaganj
7,Dilip Chandra Ray,Independent,544,8,552,0.23,West Bengal-Kaliaganj
8,SHYAMA SARKAR,Independent,776,5,781,0.33,West Bengal-Kaliaganj
9,SUDHIR SARKAR,Independent,3978,26,4004,1.67,West Bengal-Kaliaganj
10,SURESH BARMAN,Independent,1025,3,1028,0.43,West Bengal-Kaliaganj
11,NOTA,None of the Above,2993,14,3007,1.25,West Bengal-Kaliaganj
1,MOHIUDDIN MONDAL,SOCIALIST UNITY CENTRE OF INDIA (COMMUNIST),877,2,879,0.42,West Bengal-Kaliganj
2,ABUL KASHEM,Indian National Congress,24771,305,25076,11.98,West Bengal-Kaliganj
3,SUJATA MANDAL,Bahujan Samaj Party,1556,11,1567,0.75,West Bengal-Kaliganj
4,ABHIJIT GHOSH,Bharatiya Janata Party,63629,1080,64709,30.91,West Bengal-Kaliganj
5,NASIRUDDIN AHAMED (LAL),All India Trinamool Congress,109917,1779,111696,53.35,West Bengal-Kaliganj
6,JAYANTA DAS,Bharatiya Nyay-Adhikar Raksha Party,980,2,982,0.47,West Bengal-Kaliganj
7,KABIL UDDIN SHAIKH,Independent,732,0,732,0.35,West Bengal-Kaliganj
8,ABHIJIT GHOSH,Independent,1683,4,1687,0.81,West Bengal-Kaliganj
9,NOTA,None of the Above,2044,7,2051,0.98,West Bengal-Kaliganj
1,DILIP PRADHAN,Indian National Congress,1632,83,1715,1.11,West Bengal-Kalimpong
2,PENJO GOMPU BHUTIA,National People's Party,1750,55,1805,1.17,West Bengal-Kalimpong
3,SUVA PRADHAN,Bharatiya Janata Party,53227,1109,54336,35.09,West Bengal-Kalimpong
4,UJJWAL RAI,Independent,1495,67,1562,1.01,West Bengal-Kalimpong
5,DR. R.B. BHUJEL,Independent,31479,377,31856,20.57,West Bengal-Kalimpong
6,BHUPENDRA LEPCHA,Independent,1463,40,1503,0.97,West Bengal-Kalimpong
7,RUDEN SADA LEPCHA,Independent,57344,862,58206,37.59,West Bengal-Kalimpong
8,SONGDEN LEPCHA,Independent,1688,32,1720,1.11,West Bengal-Kalimpong
9,NOTA,None of the Above,2142,18,2160,1.39,West Bengal-Kalimpong
1,DEBOPRASAD BAG (POLTU),All India Trinamool Congress,95704,369,96073,45.98,West Bengal-Kalna
2,NIRAB KHAN,Communist Party of India  (Marxist),18905,100,19005,9.1,West Bengal-Kalna
3,BISWAJIT KUNDU,Bharatiya Janata Party,88305,290,88595,42.4,West Bengal-Kalna
4,RADHESYAM MANDAL,Bahujan Samaj Party,2081,3,2084,1,West Bengal-Kalna
5,KALI CHARAN SARDAR,SOCIALIST UNITY CENTRE OF INDIA (COMMUNIST),686,1,687,0.33,West Bengal-Kalna
6,NOTA,None of the Above,2502,5,2507,1.2,West Bengal-Kalna
1,ANIRUDDHA BISWAS,All India Trinamool Congress,93421,1399,94820,43.03,West Bengal-Kalyani
2,AMBIKA ROY,Bharatiya Janata Party,95995,1031,97026,44.04,West Bengal-Kalyani
3,GOUTAM MALO,Bahujan Samaj Party,1631,30,1661,0.75,West Bengal-Kalyani
4,SABUJ DAS,Communist Party of India  (Marxist),21562,603,22165,10.06,West Bengal-Kalyani
5,SANGRAM BISWAS,Party for Democratic Socialism,669,4,673,0.31,West Bengal-Kalyani
6,AGNIV HIRA,Independent,456,3,459,0.21,West Bengal-Kalyani
7,AMIT KUMAR DAS,Independent,955,2,957,0.43,West Bengal-Kalyani
8,NOTA,None of the Above,2556,21,2577,1.17,West Bengal-Kalyani
1,Anindya Banerjee,Bharatiya Janata Party,38235,202,38437,26.64,West Bengal-Kamarhati
2,MADAN MITRA,All India Trinamool Congress,73491,354,73845,51.17,West Bengal-Kamarhati
3,Sayandeep Mitra,Communist Party of India  (Marxist),28138,172,28310,19.62,West Bengal-Kamarhati
4,BIDISHA ROYCHOWDHURY,Party for Democratic Socialism,488,0,488,0.34,West Bengal-Kamarhati
5,Rajesh Sah,Jan Sangh Party,145,0,145,0.1,West Bengal-Kamarhati
6,Aninda Banerjee,Independent,186,2,188,0.13,West Bengal-Kamarhati
7,Kapil Chandra Ghosh,Independent,174,4,178,0.12,West Bengal-Kamarhati
8,SANJIB PANDIT,Independent,335,3,338,0.23,West Bengal-Kamarhati
9,Satya Brata Bandyopadhyay,Independent,823,5,828,0.57,West Bengal-Kamarhati
10,NOTA,None of the Above,1546,7,1553,1.08,West Bengal-Kamarhati
1,APURBA SARKAR (DAVID),All India Trinamool Congress,94594,805,95399,51.16,West Bengal-Kandi
2,GOUTAM ROY,Bharatiya Janata Party,56625,694,57319,30.74,West Bengal-Kandi
3,SHAFIUL ALAM KHAN (BONU),Indian National Congress,27296,259,27555,14.78,West Bengal-Kandi
4,SHER ALAM,"Justice and Development Party,",357,3,360,0.19,West Bengal-Kandi
5,SUKHEN HALDAR,SOCIALIST UNITY CENTRE OF INDIA (COMMUNIST),262,2,264,0.14,West Bengal-Kandi
6,BODON DAS,Independent,210,1,211,0.11,West Bengal-Kandi
7,SUFAL BAGDI,Independent,473,0,473,0.25,West Bengal-Kandi
8,SYED AZIZUR HOSSAIN(NASHIM),Independent,1767,2,1769,0.95,West Bengal-Kandi
9,NOTA,None of the Above,3121,10,3131,1.68,West Bengal-Kandi
1,ANURUP PANDA,Communist Party of India,5895,119,6014,3.09,West Bengal-Kanthi Dakshin
2,ARUP KUMAR DAS,Bharatiya Janata Party,97499,978,98477,50.58,West Bengal-Kanthi Dakshin
3,JYOTIRMOY KAR,All India Trinamool Congress,87257,927,88184,45.3,West Bengal-Kanthi Dakshin
4,SHRABANI PAHARI,SOCIALIST UNITY CENTRE OF INDIA (COMMUNIST),1130,6,1136,0.58,West Bengal-Kanthi Dakshin
5,NOTA,None of the Above,863,7,870,0.45,West Bengal-Kanthi Dakshin
1,TARUN KUMAR JANA,All India Trinamool Congress,103116,1078,104194,45.62,West Bengal-Kanthi Uttar
2,SUTANU MAITY,Communist Party of India  (Marxist),6432,72,6504,2.85,West Bengal-Kanthi Uttar
3,SUMITA SINHA,Bharatiya Janata Party,112677,847,113524,49.7,West Bengal-Kanthi Uttar
4,PANCHANAN DAS,SOCIALIST UNITY CENTRE OF INDIA (COMMUNIST),767,6,773,0.34,West Bengal-Kanthi Uttar
5,BISWANATH DAS,Indian Unity Centre,198,0,198,0.09,West Bengal-Kanthi Uttar
6,DEBASIS DAS,Independent,213,0,213,0.09,West Bengal-Kanthi Uttar
7,PRABIR MISHRA,Independent,864,2,866,0.38,West Bengal-Kanthi Uttar
8,LIRIKA MUKTAR,Independent,649,3,652,0.29,West Bengal-Kanthi Uttar
9,NOTA,None of the Above,1486,6,1492,0.65,West Bengal-Kanthi Uttar
1,GOUTAM PAUL,All India Trinamool Congress,115956,638,116594,54.7,West Bengal-Karandighi
2,MD. HAFIZUL IQBAL,All India Forward Bloc,9077,69,9146,4.29,West Bengal-Karandighi
3,SUBHAS CHANDRA SINHA    S/O: HARANARAYAN SINHA,Bharatiya Janata Party,79417,551,79968,37.52,West Bengal-Karandighi
4,HARUN RASHID,Bahujan Samaj Party,1128,11,1139,0.53,West Bengal-Karandighi
5,BISHWAJIT SINHA,Amra Bangalee,266,5,271,0.13,West Bengal-Karandighi
6,SHANTILAL SINGHA,SOCIALIST UNITY CENTRE OF INDIA (COMMUNIST),201,6,207,0.1,West Bengal-Karandighi
7,SANTHAPAN HASDAK,Bahujan Mukti Party,229,2,231,0.11,West Bengal-Karandighi
8,ABDULLAH,Independent,631,1,632,0.3,West Bengal-Karandighi
9,DINESH CHANDRA SINGHA,Independent,536,1,537,0.25,West Bengal-Karandighi
10,BENOY KUMAR DAS,Independent,1266,3,1269,0.6,West Bengal-Karandighi
11,SUBHASH CHANDRA SINHA  S/O: BUYASU LAL SINGHA,Independent,690,3,693,0.33,West Bengal-Karandighi
12,NOTA,None of the Above,2443,6,2449,1.15,West Bengal-Karandighi
1,Jitendranath Halder,Bahujan Samaj Party,1261,11,1272,0.57,West Bengal-Karimpur
2,Prabhas Majumdar,Communist Party of India  (Marxist),16885,300,17185,7.76,West Bengal-Karimpur
3,Bimalendu Sinha Roy,All India Trinamool Congress,108966,1945,110911,50.07,West Bengal-Karimpur
4,Samarendranath Ghosh,Bharatiya Janata Party,85825,1511,87336,39.43,West Bengal-Karimpur
5,Dhanapati Mondal,SOCIALIST UNITY CENTRE OF INDIA (COMMUNIST),1460,9,1469,0.66,West Bengal-Karimpur
6,Premananda Mandal,Independent,1306,4,1310,0.59,West Bengal-Karimpur
7,Mousumi Saha Mandal,Independent,694,1,695,0.31,West Bengal-Karimpur
8,NOTA,None of the Above,1316,12,1328,0.6,West Bengal-Karimpur
1,AHMED JAVED KHAN,All India Trinamool Congress,120957,415,121372,54.39,West Bengal-Kasba
2,DR. INDRANIL KHAN,Bharatiya Janata Party,57559,191,57750,25.88,West Bengal-Kasba
3,SHATARUP GHOSH,Communist Party of India  (Marxist),38971,209,39180,17.56,West Bengal-Kasba
4,SHAMPA SARKAR,SOCIALIST UNITY CENTRE OF INDIA (COMMUNIST),671,2,673,0.3,West Bengal-Kasba
5,ARUNANSU KUMAR SARKAR,Independent,194,0,194,0.09,West Bengal-Kasba
6,GOUTAM DAS,Independent,264,2,266,0.12,West Bengal-Kasba
7,INDRANIL MITRA,Independent,307,3,310,0.14,West Bengal-Kasba
8,TUSHAN MUKHERJEE,Independent,429,1,430,0.19,West Bengal-Kasba
9,UMESH KR. SINGH,Independent,502,1,503,0.23,West Bengal-Kasba
10,NOTA,None of the Above,2465,11,2476,1.11,West Bengal-Kasba
1,KAMALAKANTA HANSDA,Bharatiya Janata Party,92061,877,92938,47.69,West Bengal-Kashipur
2,MALLIKA MAHATA,Communist Party of India  (Marxist),10744,183,10927,5.61,West Bengal-Kashipur
3,SWAPAN KUMAR BELTHARIA,All India Trinamool Congress,84829,722,85551,43.9,West Bengal-Kashipur
4,DIPAK MAHATO,SOCIALIST UNITY CENTRE OF INDIA (COMMUNIST),2257,12,2269,1.16,West Bengal-Kashipur
5,NARENDRA NATH MAHATA,Amra Bangalee,804,2,806,0.41,West Bengal-Kashipur
6,NOTA,None of the Above,2385,16,2401,1.23,West Bengal-Kashipur
1,Atin Ghosh,All India Trinamool Congress,75274,908,76182,56.48,West Bengal-Kashipur-Belgachhia
2,PRATIP DASGUPTA,Communist Party of India  (Marxist),14504,253,14757,10.94,West Bengal-Kashipur-Belgachhia
3,SHIO KUMAR KHATIK,Bahujan Samaj Party,532,7,539,0.4,West Bengal-Kashipur-Belgachhia
4,Sibaji Sinha Roy,Bharatiya Janata Party,40424,368,40792,30.24,West Bengal-Kashipur-Belgachhia
5,KUSH MAHALI,Independent,229,5,234,0.17,West Bengal-Kashipur-Belgachhia
6,MD SHAKIL,Independent,137,7,144,0.11,West Bengal-Kashipur-Belgachhia
7,Rajesh Kumar Das,Independent,233,1,234,0.17,West Bengal-Kashipur-Belgachhia
8,SHREE NARAYAN TANDON,Independent,206,1,207,0.15,West Bengal-Kashipur-Belgachhia
9,TAPAS GHOSH,Independent,206,0,206,0.15,West Bengal-Kashipur-Belgachhia
10,NOTA,None of the Above,1564,13,1577,1.17,West Bengal-Kashipur-Belgachhia
1,AKSHAY SANTRA,Indian National Congress,17560,197,17757,7.92,West Bengal-Katulpur
2,SANGEETA MALIK,All India Trinamool Congress,93147,1090,94237,42.05,West Bengal-Katulpur
3,HARAKALI PROTIHER,Bharatiya Janata Party,104635,1387,106022,47.31,West Bengal-Katulpur
4,HARU ROY,Bahujan Samaj Party,2505,14,2519,1.12,West Bengal-Katulpur
5,MOHAN SANTRA,SOCIALIST UNITY CENTRE OF INDIA (COMMUNIST),1722,10,1732,0.77,West Bengal-Katulpur
6,NOTA,None of the Above,1833,23,1856,0.83,West Bengal-Katulpur
1,Paritosh Chair,Bahujan Samaj Party,1593,5,1598,0.71,West Bengal-Katwa
2,Prabir Ganguli,Indian National Congress,12880,96,12976,5.78,West Bengal-Katwa
3,Rabindranath Chatterjee,All India Trinamool Congress,106907,987,107894,48.07,West Bengal-Katwa
4,Shyama Majumdar,Bharatiya Janata Party,98201,538,98739,43.99,West Bengal-Katwa
5,Apurba Chakraborty,SOCIALIST UNITY CENTRE OF INDIA (COMMUNIST),1467,5,1472,0.66,West Bengal-Katwa
6,NOTA,None of the Above,1770,10,1780,0.79,West Bengal-Katwa
1,PARESH MURMU,All India Trinamool Congress,105826,540,106366,50.01,West Bengal-Keshiary
2,DR. PULIN BIHARI BASKE,Communist Party of India  (Marxist),9165,105,9270,4.36,West Bengal-Keshiary
3,MITHUN MANDI,Bahujan Samaj Party,1899,5,1904,0.9,West Bengal-Keshiary
4,SONALI MURMU SOREN,Bharatiya Janata Party,90298,738,91036,42.8,West Bengal-Keshiary
5,JHARESWAR ROUTH,SOCIALIST UNITY CENTRE OF INDIA (COMMUNIST),1523,12,1535,0.72,West Bengal-Keshiary
6,NOTA,None of the Above,2564,6,2570,1.21,West Bengal-Keshiary
1,Pritish Ranjan Kuar,Bharatiya Janata Party,95859,413,96272,41.82,West Bengal-Keshpur
2,Rameswar Doloi,Communist Party of India  (Marxist),13572,98,13670,5.94,West Bengal-Keshpur
3,Seuli Saha,All India Trinamool Congress,116520,472,116992,50.81,West Bengal-Keshpur
4,NOTA,None of the Above,3287,11,3298,1.43,West Bengal-Keshpur
1,Anadi Ghosh (Mathura),Bharatiya Janata Party,87058,485,87543,40.66,West Bengal-Ketugram
2,Dr. Manik Chandra Pradhan,Bahujan Samaj Party,2288,5,2293,1.06,West Bengal-Ketugram
3,Mizanul Kabir (Dhiraj),Communist Party of India  (Marxist),20003,89,20092,9.33,West Bengal-Ketugram
4,Sekh Sahonawez,All India Trinamool Congress,99525,701,100226,46.55,West Bengal-Ketugram
5,Satya Narayan Mondal,SOCIALIST UNITY CENTRE OF INDIA (COMMUNIST),1541,2,1543,0.72,West Bengal-Ketugram
6,NOTA,None of the Above,3615,5,3620,1.68,West Bengal-Ketugram
1,MUNSI NAZBUL KARIM,All India Trinamool Congress,94067,452,94519,43.36,West Bengal-Khanakul
2,SUSANTA GHOSH,Bharatiya Janata Party,106819,584,107403,49.27,West Bengal-Khanakul
3,FAISAL KHAN,Rashtriya Secular Majlis Party,8666,66,8732,4.01,West Bengal-Khanakul
4,ATANU SAMANTA,Independent,905,21,926,0.42,West Bengal-Khanakul
5,ADITYA MANIK,Independent,1036,9,1045,0.48,West Bengal-Khanakul
6,CHANDAN SAMANTA,Independent,2085,3,2088,0.96,West Bengal-Khanakul
7,NOTA,None of the Above,3275,3,3278,1.5,West Bengal-Khanakul
1,ASIMA ROY,Communist Party of India  (Marxist),22765,158,22923,10.52,West Bengal-Khandaghosh
2,NABIN CHANDRA BAG,All India Trinamool Congress,103278,986,104264,47.85,West Bengal-Khandaghosh
3,PROTUL BISWAS,Bahujan Samaj Party,3458,7,3465,1.59,West Bengal-Khandaghosh
4,BIJAN MANDAL,Bharatiya Janata Party,82773,605,83378,38.26,West Bengal-Khandaghosh
5,BASUDEB RUIDAS,Bahujan Mukti Party,1920,3,1923,0.88,West Bengal-Khandaghosh
6,NOTA,None of the Above,1934,10,1944,0.89,West Bengal-Khandaghosh
1,TAPAN BHUYA,Bharatiya Janata Party,72505,992,73497,36.74,West Bengal-Kharagpur
2,DINEN ROY,All India Trinamool Congress,109250,477,109727,54.85,West Bengal-Kharagpur
3,SYED SADDAM ALI,Communist Party of India  (Marxist),11156,89,11245,5.62,West Bengal-Kharagpur
4,BARSHA MAHAPATRA,Amra Bangalee,611,6,617,0.31,West Bengal-Kharagpur
5,MANIK CHANDRA PARIA,SOCIALIST UNITY CENTRE OF INDIA (COMMUNIST),949,5,954,0.48,West Bengal-Kharagpur
6,SEKH ABDUR RAHAMAN,Humanity Universal Motion Party,1687,3,1690,0.84,West Bengal-Kharagpur
7,NOTA,None of the Above,2310,4,2314,1.16,West Bengal-Kharagpur
1,PRADIP SARKAR,All India Trinamool Congress,75461,375,75836,44.25,West Bengal-Kharagpur Sadar
2,REETA SHARMA,Indian National Congress,10705,86,10791,6.3,West Bengal-Kharagpur Sadar
3,HIRANMOY CHATTOPADHYAYA,Bharatiya Janata Party,79129,478,79607,46.45,West Bengal-Kharagpur Sadar
4,D. MADHUSUDAN RAO,Humanity Universal Motion Party,1697,4,1701,0.99,West Bengal-Kharagpur Sadar
5,SURANJAN MAHAPATRA,SOCIALIST UNITY CENTRE OF INDIA (COMMUNIST),800,7,807,0.47,West Bengal-Kharagpur Sadar
6,NOTA,None of the Above,2628,15,2643,1.54,West Bengal-Kharagpur Sadar
1,KAJAL SINHA,All India Trinamool Congress,89413,394,89807,49.04,West Bengal-Khardaha
2,DEBAJYOTI DAS (SUBHO),Communist Party of India  (Marxist),26730,186,26916,14.7,West Bengal-Khardaha
3,SILBHADRA DATTA,Bharatiya Janata Party,61372,295,61667,33.67,West Bengal-Khardaha
4,SAMAR DAS,Bahujan Samaj Party,1091,6,1097,0.6,West Bengal-Khardaha
5,BISWAJIT DAS,Independent,636,1,637,0.35,West Bengal-Khardaha
6,RAJU GHOSH,Independent,605,3,608,0.33,West Bengal-Khardaha
7,NOTA,None of the Above,2407,8,2415,1.32,West Bengal-Khardaha
1,ADITYA MOULIK,Bharatiya Janata Party,60281,401,60682,32.64,West Bengal-Khargram
2,ASHIS MARJIT,All India Trinamool Congress,92737,518,93255,50.15,West Bengal-Khargram
3,BIPAD TARAN BAGDI,Indian National Congress,27336,87,27423,14.75,West Bengal-Khargram
4,TULU BALA DAS,Communist Party of India  (Marxist-Leninist)  (Liberation),1509,2,1511,0.81,West Bengal-Khargram
5,MANIK KUMAR DAS,Janata Dal  (United),1378,2,1380,0.74,West Bengal-Khargram
6,NOTA,None of the Above,1683,2,1685,0.91,West Bengal-Khargram
1,PARTHA PRATIM DAS,All India Trinamool Congress,91814,628,92442,43.48,West Bengal-Khejuri
2,SANTANU PRAMANIK,Bharatiya Janata Party,109697,710,110407,51.93,West Bengal-Khejuri
3,HIMANGSHU DAS,Communist Party of India  (Marxist),7747,65,7812,3.67,West Bengal-Khejuri
4,Somnath Mandal,SOCIALIST UNITY CENTRE OF INDIA (COMMUNIST),817,7,824,0.39,West Bengal-Khejuri
5,NOTA,None of the Above,1129,7,1136,0.53,West Bengal-Khejuri
1,Awadh Kishore Gupta,Bharatiya Janata Party,36900,89,36989,24.26,West Bengal-Kolkata Port
2,Firhad Hakim,All India Trinamool Congress,105202,341,105543,69.23,West Bengal-Kolkata Port
3,Khan Sarfaraz,Bahujan Samaj Party,745,3,748,0.49,West Bengal-Kolkata Port
4,Md Mukhtar,Indian National Congress,5559,31,5590,3.67,West Bengal-Kolkata Port
5,Manjay Kumar Roy,Janata Dal  (United),174,1,175,0.11,West Bengal-Kolkata Port
6,Sk Jayed Hossain,SOCIALIST UNITY CENTRE OF INDIA (COMMUNIST),180,0,180,0.12,West Bengal-Kolkata Port
7,Biswajit Halder,Independent,126,0,126,0.08,West Bengal-Kolkata Port
8,Jay Prakash Shaw,Independent,164,1,165,0.11,West Bengal-Kolkata Port
9,Kalpana Chohan,Independent,427,1,428,0.28,West Bengal-Kolkata Port
10,Sanjay Dey,Independent,1139,0,1139,0.75,West Bengal-Kolkata Port
11,NOTA,None of the Above,1355,5,1360,0.89,West Bengal-Kolkata Port
1,ASHIS KUMAR BISWAS,Bharatiya Janata Party,116397,1271,117668,50.73,West Bengal-Krishnaganj
2,JHUNU BAIDYA,Communist Party of India  (Marxist),10761,152,10913,4.71,West Bengal-Krishnaganj
3,DR. TAPAS MANDAL,All India Trinamool Congress,95406,985,96391,41.56,West Bengal-Krishnaganj
4,DIPALI BISWAS,Bahujan Samaj Party,1781,20,1801,0.78,West Bengal-Krishnaganj
5,ANUP KUMAR MONDAL,New Democratic Party of India,365,2,367,0.16,West Bengal-Krishnaganj
6,ASIT BARAN BISWAS,SOCIALIST UNITY CENTRE OF INDIA (COMMUNIST),481,3,484,0.21,West Bengal-Krishnaganj
7,SANAND ADHIKARY,Purvanchal Mahapanchayat,1379,1,1380,0.59,West Bengal-Krishnaganj
8,ASHIS BISWAS,Independent,832,3,835,0.36,West Bengal-Krishnaganj
9,NOTA,None of the Above,2091,8,2099,0.9,West Bengal-Krishnaganj
1,UJJAL BISWAS,All India Trinamool Congress,90842,896,91738,46.88,West Bengal-Krishnanagar Dakshin
2,BISWAS SUMIT,Communist Party of India  (Marxist),15414,192,15606,7.98,West Bengal-Krishnanagar Dakshin
3,MAHADEV SARKAR,Bharatiya Janata Party,81609,824,82433,42.13,West Bengal-Krishnanagar Dakshin
4,SWAPAN KUMAR SARKAR,Bahujan Samaj Party,1214,3,1217,0.62,West Bengal-Krishnanagar Dakshin
5,SANTU BHATTACHARYA,Communist Party of India  (Marxist-Leninist)  (Liberation),865,3,868,0.44,West Bengal-Krishnanagar Dakshin
6,ANANDA MODAK,Independent,1072,4,1076,0.55,West Bengal-Krishnanagar Dakshin
7,DEBASISH MAJHI,Independent,582,0,582,0.3,West Bengal-Krishnanagar Dakshin
8,NOTA,None of the Above,2156,9,2165,1.11,West Bengal-Krishnanagar Dakshin
1,ASHOKE CHANDRA DAS,Bahujan Samaj Party,1344,14,1358,0.67,West Bengal-Krishnanagar Uttar
2,KOUSHANI MUKHERJEE,All India Trinamool Congress,73153,1115,74268,36.8,West Bengal-Krishnanagar Uttar
3,MUKUL ROY,Bharatiya Janata Party,107492,1865,109357,54.19,West Bengal-Krishnanagar Uttar
4,SILVI SAHA,Indian National Congress,11108,299,11407,5.65,West Bengal-Krishnanagar Uttar
5,JOYDIP CHAUDHURI,SOCIALIST UNITY CENTRE OF INDIA (COMMUNIST),719,8,727,0.36,West Bengal-Krishnanagar Uttar
6,DIPIKA PRAMANIK,Purvanchal Mahapanchayat,1455,5,1460,0.72,West Bengal-Krishnanagar Uttar
7,SADHAN KUMAR MANDAL,Independent,1370,7,1377,0.68,West Bengal-Krishnanagar Uttar
8,NOTA,None of the Above,1823,28,1851,0.92,West Bengal-Krishnanagar Uttar
1,PRANAB KUMAR MALLIK,Bharatiya Janata Party,62405,354,62759,32.5,West Bengal-Kulpi
2,JOGARANJAN HALDER,All India Trinamool Congress,96029,548,96577,50.01,West Bengal-Kulpi
3,RANAJIT SINGHA,SOCIALIST UNITY CENTRE OF INDIA (COMMUNIST),1189,2,1191,0.62,West Bengal-Kulpi
4,SIRAJ UDDIN GAZI,Rashtriya Secular Majlis Party,29880,81,29961,15.51,West Bengal-Kulpi
5,MRINMAY MANDAL,Independent,956,1,957,0.5,West Bengal-Kulpi
6,NOTA,None of the Above,1683,2,1685,0.87,West Bengal-Kulpi
1,KANAN BALA MONDAL,Bahujan Samaj Party,1427,5,1432,0.63,West Bengal-Kultali
2,Ganesh Chandra Mondal,All India Trinamool Congress,116581,657,117238,51.57,West Bengal-Kultali
3,Mintu Halder,Bharatiya Janata Party,69719,342,70061,30.82,West Bengal-Kultali
4,Ram Sankar Halder,Communist Party of India  (Marxist),19926,84,20010,8.8,West Bengal-Kultali
5,Kartick Mondal,Bahujan Mukti Party,454,4,458,0.2,West Bengal-Kultali
6,JAYKRISHNA HALDAR,SOCIALIST UNITY CENTRE OF INDIA (COMMUNIST),15209,97,15306,6.73,West Bengal-Kultali
7,Bablu Sanfui,Lok Jan Shakti Party,345,1,346,0.15,West Bengal-Kultali
8,Gobinda Majhi,Independent,447,3,450,0.2,West Bengal-Kultali
9,Ratan Kumar Naskar,Independent,999,3,1002,0.44,West Bengal-Kultali
10,NOTA,None of the Above,1045,3,1048,0.46,West Bengal-Kultali
1,AJAY  KUMAR PODDAR,Bharatiya Janata Party,80733,379,81112,46.41,West Bengal-Kulti
2,UJJAL CHATTERJEE,All India Trinamool Congress,79933,500,80433,46.02,West Bengal-Kulti
3,CHANDI DAS CHATTERJEE,Indian National Congress,5738,57,5795,3.32,West Bengal-Kulti
4,BAPI KUMAR RABIDAS,Bahujan Samaj Party,1041,6,1047,0.6,West Bengal-Kulti
5,ARUN RAJAK,Bahujan Mukti Party,822,2,824,0.47,West Bengal-Kulti
6,SURAJ KEWAT,Independent,2002,1,2003,1.15,West Bengal-Kulti
7,NOTA,None of the Above,3541,12,3553,2.03,West Bengal-Kulti
1,CHAUDHURI NARGIS BANU,Indian National Congress,17344,134,17478,10.23,West Bengal-Kumarganj
2,TORAF HOSSAIN MANDAL,All India Trinamool Congress,89117,646,89763,52.52,West Bengal-Kumarganj
3,Manas Sarkar,Bharatiya Janata Party,59736,660,60396,35.33,West Bengal-Kumarganj
4,RANAJIT DEB,SOCIALIST UNITY CENTRE OF INDIA (COMMUNIST),1211,4,1215,0.71,West Bengal-Kumarganj
5,RUBEL SARKAR,Kamatapur Peopleâ€™s Party (United),946,5,951,0.56,West Bengal-Kumarganj
6,NOTA,None of the Above,1115,10,1125,0.66,West Bengal-Kumarganj
1,KISHOR MINJ,Revolutionary Socialist Party,11100,153,11253,4.84,West Bengal-Kumargram
2,MANOJ KUMAR ORAON,Bharatiya Janata Party,110658,1316,111974,48.16,West Bengal-Kumargram
3,LEOS KUJUR (URAO),All India Trinamool Congress,100009,964,100973,43.43,West Bengal-Kumargram
4,KALAWATI CHIK BARAIK,Janata Dal  (United),1381,18,1399,0.6,West Bengal-Kumargram
5,Shailen Marandi,Bahujan Mukti Party,735,5,740,0.32,West Bengal-Kumargram
6,Shrilal Oron,Kamatapur Peopleâ€™s Party (United),1643,8,1651,0.71,West Bengal-Kumargram
7,Aron Murmu,Independent,1774,7,1781,0.77,West Bengal-Kumargram
8,NOTA,None of the Above,2706,12,2718,1.17,West Bengal-Kumargram
1,Uttam Brahman,Communist Party of India  (Marxist),2494,51,2545,1.45,West Bengal-Kurseong
2,Bishnu Prasad Sharma (alias B.P. Bajgain),Bharatiya Janata Party,72153,1322,73475,41.86,West Bengal-Kurseong
3,Ugam Lama,Independent,2235,64,2299,1.31,West Bengal-Kurseong
4,Tshering Lama,Independent,57044,916,57960,33.02,West Bengal-Kurseong
5,Narbu Lama,Independent,32770,324,33094,18.85,West Bengal-Kurseong
6,Pranav Pradhan,Independent,1341,25,1366,0.78,West Bengal-Kurseong
7,Bikram Rai,Independent,1402,27,1429,0.81,West Bengal-Kurseong
8,Bhupendra Lepcha,Independent,935,25,960,0.55,West Bengal-Kurseong
9,NOTA,None of the Above,2372,45,2417,1.38,West Bengal-Kurseong
1,NARMADA CHANDRA ROY,Revolutionary Socialist Party,12386,185,12571,6.83,West Bengal-Kushmandi
2,BISWANATH SARKAR,Bahujan Samaj Party,1428,8,1436,0.78,West Bengal-Kushmandi
3,RANJIT KUMAR ROY,Bharatiya Janata Party,76650,734,77384,42.04,West Bengal-Kushmandi
4,REKHA ROY,All India Trinamool Congress,89185,783,89968,48.88,West Bengal-Kushmandi
5,BHIMNAL SARKAR,Independent,1118,0,1118,0.61,West Bengal-Kushmandi
6,NOTA,None of the Above,1590,8,1598,0.87,West Bengal-Kushmandi
1,ABHIJIT SINHA (RANA),All India Trinamool Congress,107089,1334,108423,51.14,West Bengal-Labhpur
2,BISWAJIT MONDAL,Bharatiya Janata Party,89390,1058,90448,42.66,West Bengal-Labhpur
3,MURMU SUNIL,Bahujan Samaj Party,915,7,922,0.43,West Bengal-Labhpur
4,SYED MAHFUZUL KARIM,Communist Party of India  (Marxist),6369,110,6479,3.06,West Bengal-Labhpur
5,TAPAS MONDAL,Amra Bangalee,290,5,295,0.14,West Bengal-Labhpur
6,BAHADUR GHOSH,Purvanchal Mahapanchayat,408,3,411,0.19,West Bengal-Labhpur
7,ISLAM MONIRUL,Independent,1979,13,1992,0.94,West Bengal-Labhpur
8,NOTA,None of the Above,3049,8,3057,1.44,West Bengal-Labhpur
1,ABU HENA,Indian National Congress,46891,262,47153,24.76,West Bengal-Lalgola
2,ALI MOHAMMAD,All India Trinamool Congress,107703,157,107860,56.64,West Bengal-Lalgola
3,KALPANA GHOSH,Bharatiya Janata Party,29340,124,29464,15.47,West Bengal-Lalgola
4,BHARAT CHANDRA BISWAS,Bahujan Samaj Party,850,2,852,0.45,West Bengal-Lalgola
5,KAKALI DEBNATH,Lok Jan Shakti Party,417,0,417,0.22,West Bengal-Lalgola
6,NAJIMA KAYAL,SOCIAL DEMOCRATIC PARTY OF INDIA,953,1,954,0.5,West Bengal-Lalgola
7,MUNTASIR ZAMIL,SOCIALIST UNITY CENTRE OF INDIA (COMMUNIST),652,1,653,0.34,West Bengal-Lalgola
8,ABHIJIT  HALDAR,Independent,1691,0,1691,0.89,West Bengal-Lalgola
9,NOTA,None of the Above,1391,3,1394,0.73,West Bengal-Lalgola
1,UTTAM BARUA,Bahujan Samaj Party,1687,9,1696,1.02,West Bengal-Madarihat
2,PANCHU ORAON,National People's Party,1261,11,1272,0.76,West Bengal-Madarihat
3,MANOJ TIGGA,Bharatiya Janata Party,89913,805,90718,54.35,West Bengal-Madarihat
4,RAJESH LAKRA,All India Trinamool Congress,60591,442,61033,36.56,West Bengal-Madarihat
5,SUBHASH LOHAR,Revolutionary Socialist Party,6983,89,7072,4.24,West Bengal-Madarihat
6,VIVEK PRADEEP TETE,Bhartiya Tribal Party,1536,4,1540,0.92,West Bengal-Madarihat
7,SUDHIST BARAIK,SOCIALIST UNITY CENTRE OF INDIA (COMMUNIST),961,6,967,0.58,West Bengal-Madarihat
8,NOTA,None of the Above,2607,15,2622,1.57,West Bengal-Madarihat
1,RATHIN GHOSH,All India Trinamool Congress,111610,1131,112741,48.93,West Bengal-Madhyamgram
2,RAJASREE RAJBANSHI,Bharatiya Janata Party,64193,422,64615,28.04,West Bengal-Madhyamgram
3,HIMANGSHU MONDAL,Bahujan Samaj Party,1652,15,1667,0.72,West Bengal-Madhyamgram
4,BIPLAB DUTTA,SOCIALIST UNITY CENTRE OF INDIA (COMMUNIST),624,15,639,0.28,West Bengal-Madhyamgram
5,BISWAJIT MAITY,Rashtriya Secular Majlis Party,46461,287,46748,20.29,West Bengal-Madhyamgram
6,SAIFUDDIN MONDAL,Independent,863,6,869,0.38,West Bengal-Madhyamgram
7,NOTA,None of the Above,3137,15,3152,1.37,West Bengal-Madhyamgram
1,GIAS UDDIN MOLLA,All India Trinamool Congress,95974,1032,97006,49.93,West Bengal-Magrahat Paschim
2,DHURJATI SAHA (MANAS),Bharatiya Janata Party,49696,369,50065,25.77,West Bengal-Magrahat Paschim
3,AHAMMAD SARDAR,SOCIALIST UNITY CENTRE OF INDIA (COMMUNIST),614,1,615,0.32,West Bengal-Magrahat Paschim
4,MAIDUL ISLAM MOLLA,Rashtriya Secular Majlis Party,40526,159,40685,20.94,West Bengal-Magrahat Paschim
5,HARAN BISWAS,Party for Democratic Socialism,511,1,512,0.26,West Bengal-Magrahat Paschim
6,PALASH HALDER,Independent,206,3,209,0.11,West Bengal-Magrahat Paschim
7,HAJI MURSID UDDIN SEKH,Independent,528,10,538,0.28,West Bengal-Magrahat Paschim
8,SAMBHU NATH KANJI,Independent,837,2,839,0.43,West Bengal-Magrahat Paschim
9,SAMSUL HUDA LASKAR,Independent,606,1,607,0.31,West Bengal-Magrahat Paschim
10,HABUL KUMAR MANDAL,Independent,914,6,920,0.47,West Bengal-Magrahat Paschim
11,NOTA,None of the Above,2280,6,2286,1.18,West Bengal-Magrahat Paschim
1,CHANDAN KUMAR NASKAR,Bharatiya Janata Party,56541,325,56866,27.58,West Bengal-Magrahat Purba
2,CHANDAN SAHA,Communist Party of India  (Marxist),33665,157,33822,16.41,West Bengal-Magrahat Purba
3,NAMITA SAHA,All India Trinamool Congress,110331,614,110945,53.82,West Bengal-Magrahat Purba
4,SANJAY MANDAL,SOCIALIST UNITY CENTRE OF INDIA (COMMUNIST),1203,6,1209,0.59,West Bengal-Magrahat Purba
5,BISWAJIT BISWAS,Independent,430,3,433,0.21,West Bengal-Magrahat Purba
6,SUDIPTA SANFUI,Independent,935,4,939,0.46,West Bengal-Magrahat Purba
7,SOMNATH SARKAR,Independent,457,2,459,0.22,West Bengal-Magrahat Purba
8,NOTA,None of the Above,1480,0,1480,0.72,West Bengal-Magrahat Purba
1,UMESH DAS,Bharatiya Janata Party,65827,232,66059,30.03,West Bengal-Maheshtala
2,DULAL CHANDRA DAS,All India Trinamool Congress,123575,433,124008,56.38,West Bengal-Maheshtala
3,PRAVAT CHOWDHURY,Communist Party of India  (Marxist),25127,149,25276,11.49,West Bengal-Maheshtala
4,RINA DEBI,Bahujan Samaj Party,833,5,838,0.38,West Bengal-Maheshtala
5,DHRUBA KUMAR BOSE,Independent,573,1,574,0.26,West Bengal-Maheshtala
6,SUBHENDU BARIK,Independent,1162,3,1165,0.53,West Bengal-Maheshtala
7,NOTA,None of the Above,2043,6,2049,0.93,West Bengal-Maheshtala
1,TILAK KUMAR CHAKRABORTY,All India Trinamool Congress,100768,1218,101986,46.49,West Bengal-Mahishadal
2,BISWANATH BANERJEE,Bharatiya Janata Party,98635,965,99600,45.41,West Bengal-Mahishadal
3,TAPAN KUMAR MAITY,SOCIALIST UNITY CENTRE OF INDIA (COMMUNIST),969,13,982,0.45,West Bengal-Mahishadal
4,BIKRAM CHATTERJEE,Rashtriya Secular Majlis Party,13685,111,13796,6.29,West Bengal-Mahishadal
5,KOUSHIK DAS,Independent,429,9,438,0.2,West Bengal-Mahishadal
6,PHAJLUR RAHAMAN SEK,Independent,785,3,788,0.36,West Bengal-Mahishadal
7,NOTA,None of the Above,1759,6,1765,0.8,West Bengal-Mahishadal
1,BULU CHIK BARAIK,All India Trinamool Congress,98697,389,99086,46.46,West Bengal-Mal
2,MANU ORAON,Communist Party of India  (Marxist),10797,132,10929,5.12,West Bengal-Mal
3,MAHESH BAGEY,Bharatiya Janata Party,93106,515,93621,43.9,West Bengal-Mal
4,GITA ORAON,SOCIALIST UNITY CENTRE OF INDIA (COMMUNIST),3000,8,3008,1.41,West Bengal-Mal
5,BABLU MAJHI,Independent,1907,5,1912,0.9,West Bengal-Mal
6,NOTA,None of the Above,4688,11,4699,2.2,West Bengal-Mal
1,ABDUR RAHIM BOXI,All India Trinamool Congress,125654,503,126157,68.02,West Bengal-Malatipur
2,ALBERUNI ZULKARNAIN,Indian National Congress,19697,130,19827,10.69,West Bengal-Malatipur
3,MD. KAMRUL HODA,Bahujan Samaj Party,1021,2,1023,0.55,West Bengal-Malatipur
4,MOUSUMI DAS,Bharatiya Janata Party,33990,218,34208,18.44,West Bengal-Malatipur
5,GOLAM FARUQUE,Bahujan Mukti Party,591,1,592,0.32,West Bengal-Malatipur
6,MOTIUR RAHAMAN,All India Majlis-E-Ittehadul Muslimeen,1642,1,1643,0.89,West Bengal-Malatipur
7,NOTA,None of the Above,2032,2,2034,1.1,West Bengal-Malatipur
1,Ujjwal Kumar Chowdhury,All India Trinamool Congress,77152,790,77942,37.75,West Bengal-Maldaha
2,Gopal Chandra Saha,Bharatiya Janata Party,92364,1034,93398,45.23,West Bengal-Maldaha
3,Bhupendra Nath Halder (Arjun),Indian National Congress,26192,371,26563,12.86,West Bengal-Maldaha
4,Mukul Sarkar,Bahujan Samaj Party,1238,2,1240,0.6,West Bengal-Maldaha
5,Santosh Kumar Sarkar,Bahujan Mukti Party,1464,5,1469,0.71,West Bengal-Maldaha
6,Mirana Sarkar,Independent,930,1,931,0.45,West Bengal-Maldaha
7,Sujit Kumar Moulik,Independent,2124,4,2128,1.03,West Bengal-Maldaha
8,NOTA,None of the Above,2804,14,2818,1.36,West Bengal-Maldaha
1,GOURI SINGH SARDAR,Bharatiya Janata Party,86679,1103,87782,41.07,West Bengal-Manbazar
2,PURNA CHANDRA TUDU,Bahujan Samaj Party,1886,19,1905,0.89,West Bengal-Manbazar
3,YAMINIKANTA MANDI,Communist Party of India  (Marxist),16516,333,16849,7.88,West Bengal-Manbazar
4,SANDHYARANI TUDU,All India Trinamool Congress,102169,1129,103298,48.33,West Bengal-Manbazar
5,SWAPANKUMAR MURMU,Independent,1595,9,1604,0.75,West Bengal-Manbazar
6,NOTA,None of the Above,2272,19,2291,1.07,West Bengal-Manbazar
1,JOYDEB HALDER,All India Trinamool Congress,95309,525,95834,48.04,West Bengal-Mandirbazar
2,DILIP KUMAR JATUA,Bharatiya Janata Party,72001,341,72342,36.26,West Bengal-Mandirbazar
3,SOUMEN SARKAR,Bahujan Samaj Party,858,2,860,0.43,West Bengal-Mandirbazar
4,PARTHA HALDER,Bahujan Mukti Party,439,2,441,0.22,West Bengal-Mandirbazar
5,MONGAL NASKAR,Republican Party of India (A),236,2,238,0.12,West Bengal-Mandirbazar
6,SISIR KUMAR MONDAL,SOCIALIST UNITY CENTRE OF INDIA (COMMUNIST),1112,5,1117,0.56,West Bengal-Mandirbazar
7,SANCHAY KUMAR SARKAR,Rashtriya Secular Majlis Party,25334,63,25397,12.73,West Bengal-Mandirbazar
8,PABITRA HALDER,Independent,317,2,319,0.16,West Bengal-Mandirbazar
9,SANJAY HALDER,Independent,311,1,312,0.16,West Bengal-Mandirbazar
10,SUBESH KUMAR HALDER,Independent,807,1,808,0.41,West Bengal-Mandirbazar
11,NOTA,None of the Above,1822,0,1822,0.91,West Bengal-Mandirbazar
1,ALAM MOTTAKIN,Indian National Congress,11403,152,11555,5.58,West Bengal-Manikchak
2,GOUR CHANDRA MANDAL,Bharatiya Janata Party,75415,941,76356,36.89,West Bengal-Manikchak
3,CHANCHALA KARMAKAR,Bahujan Samaj Party,1737,3,1740,0.84,West Bengal-Manikchak
4,SABITRI MITRA,All India Trinamool Congress,109085,1149,110234,53.26,West Bengal-Manikchak
5,AMAL KUMAR RABIDAS,Bahujan Mukti Party,1517,2,1519,0.73,West Bengal-Manikchak
6,ANIL CH. MANDAL,Independent,2735,8,2743,1.33,West Bengal-Manikchak
7,DALIM MANDAL,Independent,649,2,651,0.31,West Bengal-Manikchak
8,SUMITRA DAS,Independent,824,2,826,0.4,West Bengal-Manikchak
9,NOTA,None of the Above,1360,7,1367,0.66,West Bengal-Manikchak
1,Ajay Prajapati,Bahujan Samaj Party,667,2,669,0.5,West Bengal-Maniktola
2,Kalyan Chaubey,Bharatiya Janata Party,47180,159,47339,35.6,West Bengal-Maniktola
3,Rupa Bagchi,Communist Party of India  (Marxist),13390,123,13513,10.16,West Bengal-Maniktola
4,Sadhan Pande,All India Trinamool Congress,67180,397,67577,50.82,West Bengal-Maniktola
5,Subir Das,Bahujan Mukti Party,405,3,408,0.31,West Bengal-Maniktola
6,Tarun Banerjee,Socialist Party (India),203,0,203,0.15,West Bengal-Maniktola
7,Bablu Dey,Independent,168,0,168,0.13,West Bengal-Maniktola
8,Moumita Manna,Independent,239,1,240,0.18,West Bengal-Maniktola
9,Nimai Nath,Independent,783,0,783,0.59,West Bengal-Maniktola
10,Somen Das,Independent,257,0,257,0.19,West Bengal-Maniktola
11,Somnath Das,Independent,390,0,390,0.29,West Bengal-Maniktola
12,NOTA,None of the Above,1413,7,1420,1.07,West Bengal-Maniktola
1,Ashok Barman,Communist Party of India  (Marxist),7553,165,7718,3.6,West Bengal-Mathabhanga
2,Girindra Nath Barman,All India Trinamool Congress,86470,645,87115,40.67,West Bengal-Mathabhanga
3,Sushil Barman,Bharatiya Janata Party,112146,1103,113249,52.87,West Bengal-Mathabhanga
4,Kangsa Raj Barman,Kamatapur Peopleâ€™s Party (United),1282,7,1289,0.6,West Bengal-Mathabhanga
5,Bikash Barman,SOCIALIST UNITY CENTRE OF INDIA (COMMUNIST),582,7,589,0.27,West Bengal-Mathabhanga
6,Ratan Barman,Amra Bangalee,481,5,486,0.23,West Bengal-Mathabhanga
7,Animesh Mohanta,Independent,1144,3,1147,0.54,West Bengal-Mathabhanga
8,Haradhan Roy,Independent,1166,1,1167,0.54,West Bengal-Mathabhanga
9,NOTA,None of the Above,1431,12,1443,0.67,West Bengal-Mathabhanga
1,Anandamay Barman,Bharatiya Janata Party,138819,966,139785,58.1,West Bengal-Matigara-Naxalbari
2,Rajen Sundas,All India Trinamool Congress,68454,483,68937,28.65,West Bengal-Matigara-Naxalbari
3,Sankar Malakar,Indian National Congress,22865,195,23060,9.58,West Bengal-Matigara-Naxalbari
4,Sudip Mandal,Bahujan Samaj Party,1564,13,1577,0.66,West Bengal-Matigara-Naxalbari
5,Harish Chandra Barman,SOCIALIST UNITY CENTRE OF INDIA (COMMUNIST),1261,13,1274,0.53,West Bengal-Matigara-Naxalbari
6,Rakesh Mondal,Independent,2032,14,2046,0.85,West Bengal-Matigara-Naxalbari
7,NOTA,None of the Above,3888,24,3912,1.63,West Bengal-Matigara-Naxalbari
1,Kaushik Roy,Bharatiya Janata Party,113928,1378,115306,48.84,West Bengal-Maynaguri
2,Ganesh Mandal,Bahujan Samaj Party,1539,11,1550,0.66,West Bengal-Maynaguri
3,Naresh Chandra Roy,Revolutionary Socialist Party,5592,168,5760,2.44,West Bengal-Maynaguri
4,Manoj Roy,All India Trinamool Congress,102341,1054,103395,43.79,West Bengal-Maynaguri
5,Uday Shankar Adhikari,Communist Party of India  (Marxist-Leninist)  (Liberation),1546,9,1555,0.66,West Bengal-Maynaguri
6,Binay Sarkar,Amra Bangalee,737,3,740,0.31,West Bengal-Maynaguri
7,Biswanath Roy,Kamatapur Peopleâ€™s Party (United),2843,25,2868,1.21,West Bengal-Maynaguri
8,Shyamal Roy,SOCIALIST UNITY CENTRE OF INDIA (COMMUNIST),737,8,745,0.32,West Bengal-Maynaguri
9,Bilash Sarkar,Independent,1075,4,1079,0.46,West Bengal-Maynaguri
10,NOTA,None of the Above,3072,23,3095,1.31,West Bengal-Maynaguri
1,ABHIJIT ROY,All India Trinamool Congress,99378,1047,100425,50.36,West Bengal-Mayureswar
2,GOPAL SARKAR,Bahujan Samaj Party,2259,26,2285,1.15,West Bengal-Mayureswar
3,Shyamapada Mondal,Bharatiya Janata Party,87149,1201,88350,44.3,West Bengal-Mayureswar
4,KASHINATH PAL,Rashtriya Secular Majlis Party,5492,70,5562,2.79,West Bengal-Mayureswar
5,NOTA,None of the Above,2777,26,2803,1.41,West Bengal-Mayureswar
1,June Maliah,All India Trinamool Congress,119964,1211,121175,50.72,West Bengal-Medinipur
2,TARUN KUMAR GHOSH,Communist Party of India,12565,419,12984,5.43,West Bengal-Medinipur
3,Samit Kumar Dash,Bharatiya Janata Party,95168,1610,96778,40.51,West Bengal-Medinipur
4,DEBASISH AICH,SOCIALIST UNITY CENTRE OF INDIA (COMMUNIST),1468,32,1500,0.63,West Bengal-Medinipur
5,Sukesh Palmal,Amra Bangalee,1548,17,1565,0.66,West Bengal-Medinipur
6,BISHWAJIT MAHATA,Independent,957,11,968,0.41,West Bengal-Medinipur
7,NOTA,None of the Above,3900,28,3928,1.64,West Bengal-Medinipur
1,ADHIKARY PARESH CHANDRA,All India Trinamool Congress,98790,548,99338,49.98,West Bengal-Mekliganj
2,GOBINDA CHANDRA ROY,All India Forward Bloc,6758,95,6853,3.45,West Bengal-Mekliganj
3,JYOTISH ROY,Bahujan Samaj Party,1019,6,1025,0.52,West Bengal-Mekliganj
4,DADHIRAM RAY,Bharatiya Janata Party,83991,662,84653,42.59,West Bengal-Mekliganj
5,KUKIL ADHIKARY,Kamatapur Peopleâ€™s Party (United),789,5,794,0.4,West Bengal-Mekliganj
6,CHINU ROY BARMAN,Amra Bangalee,396,4,400,0.2,West Bengal-Mekliganj
7,RANJIT KUMAR ROY,SOCIALIST UNITY CENTRE OF INDIA (COMMUNIST),1761,7,1768,0.89,West Bengal-Mekliganj
8,GOLAPI ROY,Independent,508,3,511,0.26,West Bengal-Mekliganj
9,SUBHASH BARMAN,Independent,953,2,955,0.48,West Bengal-Mekliganj
10,NOTA,None of the Above,2442,5,2447,1.23,West Bengal-Mekliganj
1,KALPANA MANDAL,Bahujan Samaj Party,2119,2,2121,0.97,West Bengal-Memari
2,BHISMADEB BHATTACHARYA,Bharatiya Janata Party,81513,260,81773,37.37,West Bengal-Memari
3,MADHUSUDAN BHATTACHARYA,All India Trinamool Congress,104374,477,104851,47.92,West Bengal-Memari
4,SANAT BANERJEE,Communist Party of India  (Marxist),25526,92,25618,11.71,West Bengal-Memari
5,TARUN KUMAR DHALI,Bahujan Mukti Party,1735,2,1737,0.79,West Bengal-Memari
6,MANAB BANERJEE,Independent,1029,0,1029,0.47,West Bengal-Memari
7,NOTA,None of the Above,1666,7,1673,0.76,West Bengal-Memari
1,ABDUL KHALEQUE MOLLA,All India Trinamool Congress,150792,274,151066,76.85,West Bengal-Metiaburuz
2,RAMJIT PRASAD,Bharatiya Janata Party,31357,105,31462,16,West Bengal-Metiaburuz
3,SAMSAD ALAM,Bahujan Samaj Party,607,2,609,0.31,West Bengal-Metiaburuz
4,FIROZA KHATUN,"Justice and Development Party,",308,3,311,0.16,West Bengal-Metiaburuz
5,NURUZAMAN MOLLA,Rashtriya Secular Majlis Party,7362,27,7389,3.76,West Bengal-Metiaburuz
6,PRANATI PAUL,Amra Bangalee,825,4,829,0.42,West Bengal-Metiaburuz
7,SABNAM BIBI,All India Minorities Front,404,5,409,0.21,West Bengal-Metiaburuz
8,ANWAR RAZA,Independent,268,1,269,0.14,West Bengal-Metiaburuz
9,MD. IMTIYAZ ALAM,Independent,495,0,495,0.25,West Bengal-Metiaburuz
10,KRISHNENDU SENGUPTA,Independent,731,4,735,0.37,West Bengal-Metiaburuz
11,NOTA,None of the Above,3004,4,3008,1.53,West Bengal-Metiaburuz
1,USHA RANI MONDAL,All India Trinamool Congress,109471,347,109818,51.72,West Bengal-Minakhan
2,JAYANTA MONDAL,Bharatiya Janata Party,53839,149,53988,25.42,West Bengal-Minakhan
3,PRADYUT ROY,Communist Party of India  (Marxist),44520,86,44606,21.01,West Bengal-Minakhan
4,NOTA,None of the Above,3937,3,3940,1.86,West Bengal-Minakhan
1,Apurba Chowdhury (Achal),All India Trinamool Congress,106851,745,107596,49.51,West Bengal-Mongalkote
2,ABDUS SABUR SK,Bahujan Samaj Party,2468,8,2476,1.14,West Bengal-Mongalkote
3,Choudhury Sahajahan,Communist Party of India  (Marxist),16695,88,16783,7.72,West Bengal-Mongalkote
4,Rana Protap Goswami,Bharatiya Janata Party,84792,467,85259,39.23,West Bengal-Mongalkote
5,Rasik Saren,SOCIALIST UNITY CENTRE OF INDIA (COMMUNIST),1388,1,1389,0.64,West Bengal-Mongalkote
6,NOTA,None of the Above,3816,10,3826,1.76,West Bengal-Mongalkote
1,ANUPAM GHOSH,Communist Party of India  (Marxist),24628,112,24740,11.84,West Bengal-Monteswar
2,CHOWDHURY SIDDIQULLAH,All India Trinamool Congress,104904,556,105460,50.45,West Bengal-Monteswar
3,SAIKAT PANJA,Bharatiya Janata Party,73323,332,73655,35.24,West Bengal-Monteswar
4,ANSARUL AMAN MONDAL (BABU),Communist Party of India  (Marxist-Leninist)  (Liberation),1873,4,1877,0.9,West Bengal-Monteswar
5,NASIMUL GANI SAYED,Party for Democratic Socialism,1691,2,1693,0.81,West Bengal-Monteswar
6,NOTA,None of the Above,1604,7,1611,0.77,West Bengal-Monteswar
1,YEASMIN SABINA,All India Trinamool Congress,96392,1005,97397,59.7,West Bengal-Mothabari
2,DULAL SK,Indian National Congress,16655,248,16903,10.36,West Bengal-Mothabari
3,SHYAMCHAND GHOSH,Bharatiya Janata Party,40436,388,40824,25.02,West Bengal-Mothabari
4,MST AKTARI KHATUN,Kamatapur Peopleâ€™s Party (United),556,0,556,0.34,West Bengal-Mothabari
5,MD. ALI KALIMULLAH (NUR HOQUE),Rashtriya Secular Majlis Party,3581,4,3585,2.2,West Bengal-Mothabari
6,MD EBRAHIM,Communist Party of India  (Marxist-Leninist)  (Liberation),299,1,300,0.18,West Bengal-Mothabari
7,MD FARUQUE HOSSAIN(SAHITYARATNA),Indian Union Muslim League,194,1,195,0.12,West Bengal-Mothabari
8,RAMCHANDRA CHOWDHURI,Independent,182,1,183,0.11,West Bengal-Mothabari
9,SAIDUR RAHAMAN,Independent,495,0,495,0.3,West Bengal-Mothabari
10,SUBODH SARKAR,Independent,565,1,566,0.35,West Bengal-Mothabari
11,NOTA,None of the Above,2139,0,2139,1.31,West Bengal-Mothabari
1,Ashoke Dinda,Bharatiya Janata Party,107054,1055,108109,48.17,West Bengal-Moyna
2,Kamal Bag,Bahujan Samaj Party,761,5,766,0.34,West Bengal-Moyna
3,Manik Bhaumik,Indian National Congress,5030,78,5108,2.28,West Bengal-Moyna
4,Sangram Kumar Dolai,All India Trinamool Congress,106027,822,106849,47.61,West Bengal-Moyna
5,Subrata Bag,SOCIALIST UNITY CENTRE OF INDIA (COMMUNIST),1658,16,1674,0.75,West Bengal-Moyna
6,Biplab Barai,Independent,232,0,232,0.1,West Bengal-Moyna
7,Mahammad Ali Sk,Independent,360,1,361,0.16,West Bengal-Moyna
8,NOTA,None of the Above,1324,11,1335,0.59,West Bengal-Moyna
1,ASIF EKBAL,Indian National Congress,17210,77,17287,7.93,West Bengal-Murarai
2,TARAK LET,Bahujan Samaj Party,1634,6,1640,0.75,West Bengal-Murarai
3,DEBASISH ROY,Bharatiya Janata Party,47930,320,48250,22.14,West Bengal-Murarai
4,DR MOSARRAF HOSSAIN,All India Trinamool Congress,145405,1091,146496,67.23,West Bengal-Murarai
5,ANSARUL SAIEKH,SOCIALIST UNITY CENTRE OF INDIA (COMMUNIST),1854,3,1857,0.85,West Bengal-Murarai
6,SAMSUL MIYA,Socialist Party (India),877,1,878,0.4,West Bengal-Murarai
7,NOTA,None of the Above,1501,8,1509,0.69,West Bengal-Murarai
1,GOURI SANKAR GHOSH,Bharatiya Janata Party,95330,637,95967,41.86,West Bengal-Murshidabad
2,NEAJUDDIN SK,Indian National Congress,28698,137,28835,12.58,West Bengal-Murshidabad
3,MADAN MOHAN MANDAL,Bahujan Samaj Party,1099,0,1099,0.48,West Bengal-Murshidabad
4,SHAONI SINGHA ROY,All India Trinamool Congress,93047,429,93476,40.78,West Bengal-Murshidabad
5,MILIA SAJEM,SOCIALIST UNITY CENTRE OF INDIA (COMMUNIST),1004,0,1004,0.44,West Bengal-Murshidabad
6,SUJAT SK,Democratic Socialist Party of India,238,0,238,0.1,West Bengal-Murshidabad
7,HABIB SAIKH,Rashtriya Secular Majlis Party,1441,1,1442,0.63,West Bengal-Murshidabad
8,GOURI DAS SARKAR,Independent,753,0,753,0.33,West Bengal-Murshidabad
9,BELLAL SK,Independent,2278,0,2278,0.99,West Bengal-Murshidabad
10,MAHIRAM MURMU,Independent,535,0,535,0.23,West Bengal-Murshidabad
11,SUBIR GHOSH,Independent,700,0,700,0.31,West Bengal-Murshidabad
12,NOTA,None of the Above,2897,7,2904,1.27,West Bengal-Murshidabad
1,PUNDARIKAKSHYA SAHA,All India Trinamool Congress,100661,1509,102170,48.52,West Bengal-Nabadwip
2,RAJNATH SARKAR,Bahujan Samaj Party,1611,6,1617,0.77,West Bengal-Nabadwip
3,SIDHARTHA SHANKAR NASKAR,Bharatiya Janata Party,82626,973,83599,39.7,West Bengal-Nabadwip
4,SWARNENDU SINHA,Communist Party of India  (Marxist),18218,322,18540,8.8,West Bengal-Nabadwip
5,RAMKRISHNA HALDER,Lok Jan Shakti Party,1131,5,1136,0.54,West Bengal-Nabadwip
6,SOUMEN SAHA,Independent,1177,6,1183,0.56,West Bengal-Nabadwip
7,NOTA,None of the Above,2331,13,2344,1.11,West Bengal-Nabadwip
1,KANAI CHANDRA MONDAL,All India Trinamool Congress,99722,733,100455,48.18,West Bengal-Nabagram
2,KRIPALINI GHOSH,Communist Party of India  (Marxist),38926,203,39129,18.77,West Bengal-Nabagram
3,MOHAN HALDER,Bharatiya Janata Party,64485,437,64922,31.14,West Bengal-Nabagram
4,BARUN MANDAL,SOCIALIST UNITY CENTRE OF INDIA (COMMUNIST),1378,3,1381,0.66,West Bengal-Nabagram
5,NOTA,None of the Above,2625,4,2629,1.26,West Bengal-Nabagram
1,PUNA BHENGRA,Bharatiya Janata Party,94371,351,94722,49.55,West Bengal-Nagrakata
2,JOSEPH MUNDA,All India Trinamool Congress,70999,248,71247,37.27,West Bengal-Nagrakata
3,SUKBIR SUBBA,Indian National Congress,12378,64,12442,6.51,West Bengal-Nagrakata
4,BENAM ORAON,Progressive People's Party,2243,4,2247,1.18,West Bengal-Nagrakata
5,ASHAN TIRKEY,Independent,1770,4,1774,0.93,West Bengal-Nagrakata
6,ROBAT MUNDA,Independent,3280,3,3283,1.72,West Bengal-Nagrakata
7,NOTA,None of the Above,5448,6,5454,2.85,West Bengal-Nagrakata
1,INDRANI KUNDU MUKHERJEE,Communist Party of India  (Marxist),15598,227,15825,10.11,West Bengal-Naihati
2,PABITRA ROY,Bahujan Samaj Party,906,7,913,0.58,West Bengal-Naihati
3,PARTHA BHOWMICK,All India Trinamool Congress,76925,828,77753,49.69,West Bengal-Naihati
4,PHALGUNI PATRA,Bharatiya Janata Party,58481,417,58898,37.64,West Bengal-Naihati
5,KANAI DAS,Independent,1373,5,1378,0.88,West Bengal-Naihati
6,NOTA,None of the Above,1689,12,1701,1.09,West Bengal-Naihati
1,Amal Chandra Sarkar,Bahujan Samaj Party,1074,6,1080,0.52,West Bengal-Nakashipara
2,Kallol Khan,All India Trinamool Congress,103666,1146,104812,50.01,West Bengal-Nakashipara
3,Santanu Dey,Bharatiya Janata Party,82258,1283,83541,39.86,West Bengal-Nakashipara
4,Sukla Saha,Communist Party of India  (Marxist),5254,111,5365,2.56,West Bengal-Nakashipara
5,Krishnachandra Debnath,SOCIALIST UNITY CENTRE OF INDIA (COMMUNIST),322,1,323,0.15,West Bengal-Nakashipara
6,Krishnapada Pramanik,Communist Party of India  (Marxist-Leninist)  (Liberation),1020,3,1023,0.49,West Bengal-Nakashipara
7,Swapan Mondal,Amra Bangalee,1003,0,1003,0.48,West Bengal-Nakashipara
8,Tanmay Ganguli,Independent,11194,83,11277,5.38,West Bengal-Nakashipara
9,NOTA,None of the Above,1135,11,1146,0.55,West Bengal-Nakashipara
1,TAPAS KUMAR YADAV(ANANDA YADAV),Bharatiya Janata Party,60076,457,60533,29.15,West Bengal-Nalhati
2,DINABANDHU MONDAL,Bahujan Samaj Party,1029,2,1031,0.5,West Bengal-Nalhati
3,DIPAK CHATTERJEE,All India Forward Bloc,21193,135,21328,10.27,West Bengal-Nalhati
4,RAJENDRA PRASAD SINGH (RAJU SINGH),All India Trinamool Congress,116667,771,117438,56.54,West Bengal-Nalhati
5,AMARJIT FULMALI,Janata Dal  (United),983,1,984,0.47,West Bengal-Nalhati
6,MD. MONIBUR RAHAMAN,"Justice and Development Party,",616,1,617,0.3,West Bengal-Nalhati
7,MANIK HANSDA,Bahujan Mukti Party,1581,5,1586,0.76,West Bengal-Nalhati
8,ABDUS SALAM,Independent,446,1,447,0.22,West Bengal-Nalhati
9,MOINUDDIN SHAMS,Independent,1816,16,1832,0.88,West Bengal-Nalhati
10,NOTA,None of the Above,1891,9,1900,0.91,West Bengal-Nalhati
1,ADHIKARY NILANJAN,Bharatiya Janata Party,102106,669,102775,45.22,West Bengal-Nandakumar
2,KARUNA SANKAR BHOWMIK,Communist Party of India  (Marxist),12651,131,12782,5.62,West Bengal-Nandakumar
3,SUKUMAR DE,All India Trinamool Congress,107330,851,108181,47.6,West Bengal-Nandakumar
4,Saumitra Pattanayak,SOCIALIST UNITY CENTRE OF INDIA (COMMUNIST),1341,8,1349,0.59,West Bengal-Nandakumar
5,Marphat Ali Khan,Independent,711,4,715,0.31,West Bengal-Nandakumar
6,NOTA,None of the Above,1471,2,1473,0.65,West Bengal-Nandakumar
1,ADHIKARI SUVENDU,Bharatiya Janata Party,109673,1091,110764,48.49,West Bengal-Nandigram
2,Mamata Banerjee,All India Trinamool Congress,107937,871,108808,47.64,West Bengal-Nandigram
3,Minakshi Mukherjee,Communist Party of India  (Marxist),6198,69,6267,2.74,West Bengal-Nandigram
4,MANOJ KUMAR DAS,SOCIALIST UNITY CENTRE OF INDIA (COMMUNIST),235,5,240,0.11,West Bengal-Nandigram
5,Dipak Kumar Gayen,Independent,74,0,74,0.03,West Bengal-Nandigram
6,Subrata Bose,Independent,72,1,73,0.03,West Bengal-Nandigram
7,Sk Saddam Hossain,Independent,310,3,313,0.14,West Bengal-Nandigram
8,Swapan Parua,Independent,773,3,776,0.34,West Bengal-Nandigram
9,NOTA,None of the Above,1089,1,1090,0.48,West Bengal-Nandigram
1,CHANDIPADA DAS,Bahujan Samaj Party,2729,10,2739,1.16,West Bengal-Nanoor
2,TARAKESWAR SAHA,Bharatiya Janata Party,104323,1123,105446,44.81,West Bengal-Nanoor
3,BIDHAN CHANDRA MAJHI,All India Trinamool Congress,110764,1352,112116,47.64,West Bengal-Nanoor
4,SHYAMALI PRADHAN,Communist Party of India  (Marxist),12731,147,12878,5.47,West Bengal-Nanoor
5,NOTA,None of the Above,2134,15,2149,0.91,West Bengal-Nanoor
1,ANUPAM MANDAL,Bharatiya Janata Party,43238,293,43531,21.51,West Bengal-Naoda
2,MOSARAF HOSSAIN MONDAL (MADHU),Indian National Congress,31442,146,31588,15.61,West Bengal-Naoda
3,SAHINA MOMTAZ KHAN,All India Trinamool Congress,117130,554,117684,58.16,West Bengal-Naoda
4,MD. WASIM AKRAM,Hindustani Awam Morcha (Secular),893,0,893,0.44,West Bengal-Naoda
5,SAHIDUL ISLAM (KALU),SOCIALIST UNITY CENTRE OF INDIA (COMMUNIST),350,2,352,0.17,West Bengal-Naoda
6,MOSARROF HOSSAIN,Independent,252,2,254,0.13,West Bengal-Naoda
7,SAMIK MANDAL,Independent,4323,70,4393,2.17,West Bengal-Naoda
8,SAMINUL ANSARY,Independent,1397,0,1397,0.69,West Bengal-Naoda
9,SAHINA MAMTAJ,Independent,946,3,949,0.47,West Bengal-Naoda
10,NOTA,None of the Above,1301,7,1308,0.65,West Bengal-Naoda
1,ATTA SURJA KANTA,All India Trinamool Congress,100440,454,100894,46.33,West Bengal-Narayangarh
2,TAPAS SINHA,Communist Party of India  (Marxist),13070,159,13229,6.08,West Bengal-Narayangarh
3,RAMA PRASAD GIRI,Bharatiya Janata Party,97758,720,98478,45.23,West Bengal-Narayangarh
4,SHYAMA PADA JANA,SOCIALIST UNITY CENTRE OF INDIA (COMMUNIST),2812,21,2833,1.3,West Bengal-Narayangarh
5,BANAMALI DAS,Independent,557,3,560,0.26,West Bengal-Narayangarh
6,NOTA,None of the Above,1750,6,1756,0.81,West Bengal-Narayangarh
1,Akik Hassan,Communist Party of India  (Marxist),11584,255,11839,5.45,West Bengal-Natabari
2,Mihir Goswami,Bharatiya Janata Party,110020,1723,111743,51.45,West Bengal-Natabari
3,Rabindra Nath Ghosh,All India Trinamool Congress,87098,1205,88303,40.66,West Bengal-Natabari
4,Abdus Salam,SOCIALIST UNITY CENTRE OF INDIA (COMMUNIST),1178,8,1186,0.55,West Bengal-Natabari
5,Ekramul Hoque,United Socialist Party,500,5,505,0.23,West Bengal-Natabari
6,Dalendra Nath Ray,Amra Bangalee,1103,7,1110,0.51,West Bengal-Natabari
7,Sahidul Hossain,Independent,1338,3,1341,0.62,West Bengal-Natabari
8,NOTA,None of the Above,1127,19,1146,0.53,West Bengal-Natabari
1,DULAL MURMU,All India Trinamool Congress,99825,1078,100903,52.46,West Bengal-Nayagram
2,BAKUL MURMU,Bharatiya Janata Party,77089,1060,78149,40.63,West Bengal-Nayagram
3,SHYAM MANDI,Bahujan Samaj Party,1844,14,1858,0.97,West Bengal-Nayagram
4,HARIPADA SAREN,Communist Party of India  (Marxist),5755,108,5863,3.05,West Bengal-Nayagram
5,KALICHARAN BESHRA,SOCIALIST UNITY CENTRE OF INDIA (COMMUNIST),685,4,689,0.36,West Bengal-Nayagram
6,BIDHAN CHANDRA SING,Independent,896,9,905,0.47,West Bengal-Nayagram
7,SHYAMLAL HANSDA,Independent,897,4,901,0.47,West Bengal-Nayagram
8,NOTA,None of the Above,3077,9,3086,1.6,West Bengal-Nayagram
1,MANJU BASU,All India Trinamool Congress,93515,688,94203,48.9,West Bengal-Noapara
2,RAJENDRA CHOUDHARY,Bahujan Samaj Party,1289,16,1305,0.68,West Bengal-Noapara
3,SUBHANKAR SARKAR,Indian National Congress,23210,292,23502,12.2,West Bengal-Noapara
4,SUNIL SINGH,Bharatiya Janata Party,67098,395,67493,35.04,West Bengal-Noapara
5,RANJIT BISWAS,Guru Chand Mukti Morcha,657,4,661,0.34,West Bengal-Noapara
6,AMIT KUMAR SHAW,Independent,276,1,277,0.14,West Bengal-Noapara
7,ANAND PANDEY,Independent,306,3,309,0.16,West Bengal-Noapara
8,RABISHANKAR PAUL,Independent,857,0,857,0.44,West Bengal-Noapara
9,RABINDRA NATH BISWAS,Independent,613,9,622,0.32,West Bengal-Noapara
10,SWAPAN KUMAR DEBNATH,Independent,513,6,519,0.27,West Bengal-Noapara
11,NOTA,None of the Above,2873,13,2886,1.5,West Bengal-Noapara
1,AMARNATH  SHAKHA,Bharatiya Janata Party,104248,692,104940,46.48,West Bengal-Onda
2,ARUP KUMAR KHAN,All India Trinamool Congress,92715,674,93389,41.37,West Bengal-Onda
3,TARAPADA CHAKRABARTI,All India Forward Bloc,15507,106,15613,6.92,West Bengal-Onda
4,APURBA MONDAL,SOCIALIST UNITY CENTRE OF INDIA (COMMUNIST),976,8,984,0.44,West Bengal-Onda
5,NIRMAL (BABLU) BANERJEE,Communist Party of India  (Marxist-Leninist)  (Liberation),918,4,922,0.41,West Bengal-Onda
6,BIKASH PATRA,Communist Party of India (Marxist-Leninist) Red Star,584,6,590,0.26,West Bengal-Onda
7,ABDUL HAI MALLIK,Independent,1000,3,1003,0.44,West Bengal-Onda
8,KRISHNA CHANDRA BAURI,Independent,3433,6,3439,1.52,West Bengal-Onda
9,NOTA,None of the Above,4869,10,4879,2.16,West Bengal-Onda
1,Bibhash Chandra Mandal,Bharatiya Janata Party,58144,794,58938,28.98,West Bengal-Palashipara
2,Dr. Manik Bhattacharya,All India Trinamool Congress,108872,1402,110274,54.22,West Bengal-Palashipara
3,Ratikanta Thakur,Bahujan Samaj Party,1677,13,1690,0.83,West Bengal-Palashipara
4,S.M. Sadi,Communist Party of India  (Marxist),25861,367,26228,12.9,West Bengal-Palashipara
5,Maniruzzaman Mondal,SOCIALIST UNITY CENTRE OF INDIA (COMMUNIST),1678,18,1696,0.83,West Bengal-Palashipara
6,Panchanan Mandal,Independent,300,1,301,0.15,West Bengal-Palashipara
7,Bijoy Dutta,Independent,916,0,916,0.45,West Bengal-Palashipara
8,Ramesh Barman,Independent,1688,0,1688,0.83,West Bengal-Palashipara
9,NOTA,None of the Above,1649,5,1654,0.81,West Bengal-Palashipara
1,GULSAN MULLICK,All India Trinamool Congress,104377,195,104572,48.19,West Bengal-Panchla
2,MOHIT LAL GHANTI,Bharatiya Janata Party,71695,126,71821,33.1,West Bengal-Panchla
3,AMAR CHATTERJEE,Amra Bangalee,1408,3,1411,0.65,West Bengal-Panchla
4,ABDUL JALIL SK,Rashtriya Secular Majlis Party,35543,33,35576,16.39,West Bengal-Panchla
5,SHYAMAL MONDAL,Independent,1218,0,1218,0.56,West Bengal-Panchla
6,NOTA,None of the Above,2405,6,2411,1.11,West Bengal-Panchla
1,KUMAR JITENDRA  TEWARI,Bharatiya Janata Party,69665,454,70119,42.68,West Bengal-Pandabeswar
2,NARENDRANATH CHAKRABORTY,All India Trinamool Congress,73015,907,73922,44.99,West Bengal-Pandabeswar
3,RAKESH KUMAR DAS,Bahujan Samaj Party,1134,3,1137,0.69,West Bengal-Pandabeswar
4,SUBHAS BAURI,Communist Party of India  (Marxist),12084,112,12196,7.42,West Bengal-Pandabeswar
5,ATUL CHANDRA BAURI,Bahujan Mukti Party,761,5,766,0.47,West Bengal-Pandabeswar
6,DANA GOSWAMI,SOCIALIST UNITY CENTRE OF INDIA (COMMUNIST),629,6,635,0.39,West Bengal-Pandabeswar
7,PRADIP KUMAR PODDAR,Independent,506,2,508,0.31,West Bengal-Pandabeswar
8,SANJAY YADAV,Independent,2270,3,2273,1.38,West Bengal-Pandabeswar
9,NOTA,None of the Above,2727,8,2735,1.66,West Bengal-Pandabeswar
1,Amjad Hossain Sk.,Communist Party of India  (Marxist),41205,269,41474,18.54,West Bengal-Pandua
2,Partha Sharma,Bharatiya Janata Party,70651,365,71016,31.75,West Bengal-Pandua
3,Mina Roy,Bahujan Samaj Party,1632,18,1650,0.74,West Bengal-Pandua
4,Dr. Ratna De Nag,All India Trinamool Congress,102128,746,102874,45.99,West Bengal-Pandua
5,Paban Mazumder,SOCIALIST UNITY CENTRE OF INDIA (COMMUNIST),1971,11,1982,0.89,West Bengal-Pandua
6,Balai Saren,Ambedkarite Party of India,1254,6,1260,0.56,West Bengal-Pandua
7,Sk. Nasiruddin,Lok Jan Shakti Party,1239,5,1244,0.56,West Bengal-Pandua
8,NOTA,None of the Above,2159,5,2164,0.97,West Bengal-Pandua
1,TAPAS MAJUMDER,Indian National Congress,21002,167,21169,12.14,West Bengal-Panihati
2,NIRMAL GHOSH,All India Trinamool Congress,85994,501,86495,49.61,West Bengal-Panihati
3,BHASKAR ROY,Bahujan Samaj Party,1320,6,1326,0.76,West Bengal-Panihati
4,SANMOY BANDYOPADHYAY,Bharatiya Janata Party,60987,331,61318,35.17,West Bengal-Panihati
5,MANISHA DASGUPTA,SOCIALIST UNITY CENTRE OF INDIA (COMMUNIST),878,9,887,0.51,West Bengal-Panihati
6,IMRAN KHAN,Independent,827,0,827,0.47,West Bengal-Panihati
7,NOTA,None of the Above,2326,8,2334,1.34,West Bengal-Panihati
1,CHITTARANJAN DASTHAKUR,Communist Party of India,14984,140,15124,6.46,West Bengal-Panskura Paschim
2,PHIROJA BIBI,All India Trinamool Congress,111047,658,111705,47.71,West Bengal-Panskura Paschim
3,SINTU SENAPATI,Bharatiya Janata Party,102144,672,102816,43.91,West Bengal-Panskura Paschim
4,PREETILATA DAS TEWARI,Lok Jan Shakti Party,813,4,817,0.35,West Bengal-Panskura Paschim
5,SUNIL KUMAR JANA,SOCIALIST UNITY CENTRE OF INDIA (COMMUNIST),1230,9,1239,0.53,West Bengal-Panskura Paschim
6,NARAYAN KINKAR MISHRA,Independent,1101,2,1103,0.47,West Bengal-Panskura Paschim
7,NOTA,None of the Above,1331,6,1337,0.57,West Bengal-Panskura Paschim
1,Ibrahim Ali Sk,Communist Party of India  (Marxist),20634,83,20717,10.44,West Bengal-Panskura Purba
2,Debabrata Pattanayek,Bharatiya Janata Party,81318,235,81553,41.11,West Bengal-Panskura Purba
3,Biplab Roy Chowdhury,All India Trinamool Congress,90972,241,91213,45.97,West Bengal-Panskura Purba
4,Chandramohan Manik,SOCIALIST UNITY CENTRE OF INDIA (COMMUNIST),1452,6,1458,0.73,West Bengal-Panskura Purba
5,Tarun Mandal,Indian Unity Centre,391,1,392,0.2,West Bengal-Panskura Purba
6,Bimal Poria,Amra Bangalee,904,0,904,0.46,West Bengal-Panskura Purba
7,Samir Hossain,Independent,977,3,980,0.49,West Bengal-Panskura Purba
8,NOTA,None of the Above,1177,6,1183,0.6,West Bengal-Panskura Purba
1,UMAPADA BAURI,All India Trinamool Congress,82986,354,83340,42.95,West Bengal-Para
2,NADIAR CHAND BOURI,Bharatiya Janata Party,86930,417,87347,45.02,West Bengal-Para
3,SUDARSHAN RAJWAR,Bahujan Samaj Party,1672,4,1676,0.86,West Bengal-Para
4,SWAPAN KUMAR BAURI,Communist Party of India  (Marxist),13596,85,13681,7.05,West Bengal-Para
5,JAGANNATH BAURI,SOCIALIST UNITY CENTRE OF INDIA (COMMUNIST),1891,6,1897,0.98,West Bengal-Para
6,BABITA BOURI,Independent,762,10,772,0.4,West Bengal-Para
7,SWAPAN BAURI,Independent,1649,2,1651,0.85,West Bengal-Para
8,NOTA,None of the Above,3647,10,3657,1.88,West Bengal-Para
1,AMBUJAKSHA MAHANTI,Bharatiya Janata Party,94402,903,95305,45.64,West Bengal-Patashpur
2,UTTAM BARIK,All India Trinamool Congress,104268,1031,105299,50.42,West Bengal-Patashpur
3,SAIKAT GIRI,Communist Party of India,6525,106,6631,3.18,West Bengal-Patashpur
4,SURJYENDU BIKASH PATRA,SOCIALIST UNITY CENTRE OF INDIA (COMMUNIST),721,10,731,0.35,West Bengal-Patashpur
5,NOTA,None of the Above,856,5,861,0.41,West Bengal-Patashpur
1,ASIT KUMAR HALDAR,Bharatiya Janata Party,97704,343,98047,42.3,West Bengal-Patharpratima
2,SHUKDEB BERA,Indian National Congress,10120,62,10182,4.39,West Bengal-Patharpratima
3,SAMIR KUMAR JANA,All India Trinamool Congress,119590,591,120181,51.85,West Bengal-Patharpratima
4,NARAYAN HALDAR,SOCIALIST UNITY CENTRE OF INDIA (COMMUNIST),1654,10,1664,0.72,West Bengal-Patharpratima
5,SRIDHAR CHANDRA BAGARI,Lok Samya Party,495,3,498,0.21,West Bengal-Patharpratima
6,NOTA,None of the Above,1213,1,1214,0.52,West Bengal-Patharpratima
1,Karuna Ranjan Soren,Bahujan Samaj Party,2284,7,2291,1.1,West Bengal-Phansidewa
2,Chhotan Kisku,All India Trinamool Congress,77599,341,77940,37.55,West Bengal-Phansidewa
3,Durga Murmu,Bharatiya Janata Party,105123,528,105651,50.89,West Bengal-Phansidewa
4,Sunil Chandra Tirkey,Indian National Congress,12747,68,12815,6.17,West Bengal-Phansidewa
5,Amit Lakra,Bhartiya Tribal Party,1683,16,1699,0.82,West Bengal-Phansidewa
6,Bhola Tirki,SOCIALIST UNITY CENTRE OF INDIA (COMMUNIST),1827,5,1832,0.88,West Bengal-Phansidewa
7,Sumanti Ekka,Communist Party of India  (Marxist-Leninist)  (Liberation),2769,18,2787,1.34,West Bengal-Phansidewa
8,NOTA,None of the Above,2564,11,2575,1.24,West Bengal-Phansidewa
1,AJIT MAITY,All India Trinamool Congress,111624,811,112435,49.17,West Bengal-Pingla
2,ANTARA BHATTACHARYYA,Bharatiya Janata Party,104754,1025,105779,46.26,West Bengal-Pingla
3,SAMIR ROY,Indian National Congress,7021,82,7103,3.11,West Bengal-Pingla
4,SISHIR KUMAR MANNA,SOCIALIST UNITY CENTRE OF INDIA (COMMUNIST),1270,9,1279,0.56,West Bengal-Pingla
5,NOTA,None of the Above,2060,13,2073,0.91,West Bengal-Pingla
1,ABHIJIT BHATTACHARYYA,Indian National Congress,15016,45,15061,6.99,West Bengal-Purbasthali Dakshin
2,RAJIB KUMAR BHOWMICK,Bharatiya Janata Party,87946,342,88288,41,West Bengal-Purbasthali Dakshin
3,SURAJIT MONDAL,Bahujan Samaj Party,3100,5,3105,1.44,West Bengal-Purbasthali Dakshin
4,SWAPAN DEBNATH,All India Trinamool Congress,105209,489,105698,49.08,West Bengal-Purbasthali Dakshin
5,SANTOSH KUMAR ADHIKARY,Purvanchal Mahapanchayat,1639,0,1639,0.76,West Bengal-Purbasthali Dakshin
6,NOTA,None of the Above,1559,3,1562,0.73,West Bengal-Purbasthali Dakshin
1,KESTO ROY,Bahujan Samaj Party,1899,8,1907,0.9,West Bengal-Purbasthali Uttar
2,GOBARDHAN DAS,Bharatiya Janata Party,85218,497,85715,40.37,West Bengal-Purbasthali Uttar
3,TAPAN CHATTERJEE,All India Trinamool Congress,91724,697,92421,43.52,West Bengal-Purbasthali Uttar
4,PRADIP KUMAR SAHA,Communist Party of India  (Marxist),27960,174,28134,13.25,West Bengal-Purbasthali Uttar
5,BIBHAS DAS,Purvanchal Mahapanchayat,1671,4,1675,0.79,West Bengal-Purbasthali Uttar
6,SAMILAN SUTRADHAR,Independent,1138,3,1141,0.54,West Bengal-Purbasthali Uttar
7,NOTA,None of the Above,1347,3,1350,0.64,West Bengal-Purbasthali Uttar
1,DILIP YADAV,All India Trinamool Congress,90505,651,91156,40.86,West Bengal-Pursurah
2,BIMAN GHOSH,Bharatiya Janata Party,118607,727,119334,53.5,West Bengal-Pursurah
3,MONIKA MALIK GHOSH,Indian National Congress,7733,95,7828,3.51,West Bengal-Pursurah
4,CHIRANJIT BARIK,Independent,1952,16,1968,0.88,West Bengal-Pursurah
5,NOTA,None of the Above,2776,12,2788,1.25,West Bengal-Pursurah
1,PARTHA PRATIM BANERJEE,Indian National Congress,24736,260,24996,12.08,West Bengal-Purulia
2,Manas Sardar,Bahujan Samaj Party,1032,2,1034,0.5,West Bengal-Purulia
3,Sujoy Banerjee,All India Trinamool Congress,82134,581,82715,39.98,West Bengal-Purulia
4,Sudip Kumar Mukherjee,Bharatiya Janata Party,88899,834,89733,43.38,West Bengal-Purulia
5,Rani Mahato,SOCIALIST UNITY CENTRE OF INDIA (COMMUNIST),1196,13,1209,0.58,West Bengal-Purulia
6,Harendra Nath Mahato,Amra Bangalee,385,4,389,0.19,West Bengal-Purulia
7,Abhijit Bhattacharya,Independent,424,0,424,0.2,West Bengal-Purulia
8,Aditya Mahato,Independent,1298,6,1304,0.63,West Bengal-Purulia
9,Birendranath Mahato,Independent,1916,2,1918,0.93,West Bengal-Purulia
10,MRITUNJOY PANDEY,Independent,554,4,558,0.27,West Bengal-Purulia
11,NOTA,None of the Above,2565,23,2588,1.25,West Bengal-Purulia
1,Akhruzzaman,All India Trinamool Congress,126467,367,126834,66.59,West Bengal-RaghunathGanj
2,Abul Kashem Biswas,Indian National Congress,12737,62,12799,6.72,West Bengal-RaghunathGanj
3,Golam Modaswer,Bharatiya Janata Party,28415,106,28521,14.97,West Bengal-RaghunathGanj
4,Md. Jakir Hossain,SOCIAL DEMOCRATIC PARTY OF INDIA,1354,7,1361,0.71,West Bengal-RaghunathGanj
5,Rabiul Alam,SOCIALIST UNITY CENTRE OF INDIA (COMMUNIST),911,2,913,0.48,West Bengal-RaghunathGanj
6,M A Hannan,Welfare Party Of India,865,3,868,0.46,West Bengal-RaghunathGanj
7,Nasir Saikh,Independent,16222,22,16244,8.53,West Bengal-RaghunathGanj
8,NOTA,None of the Above,2935,3,2938,1.54,West Bengal-RaghunathGanj
1,Ganesh Bouri,Communist Party of India  (Marxist),14579,159,14738,6.86,West Bengal-Raghunathpur
2,Bouri Parimal,Bahujan Samaj Party,1692,15,1707,0.8,West Bengal-Raghunathpur
3,Bouri Hazari,All India Trinamool Congress,89671,661,90332,42.08,West Bengal-Raghunathpur
4,Vivekananda Bauri,Bharatiya Janata Party,94994,776,95770,44.61,West Bengal-Raghunathpur
5,Pashupati Roy,SOCIALIST UNITY CENTRE OF INDIA (COMMUNIST),3802,27,3829,1.78,West Bengal-Raghunathpur
6,Mihir Bauri,Independent,2343,11,2354,1.1,West Bengal-Raghunathpur
7,Sumanta Bouri,Independent,2386,17,2403,1.12,West Bengal-Raghunathpur
8,NOTA,None of the Above,3537,20,3557,1.66,West Bengal-Raghunathpur
1,ALOKE JALDATA,All India Trinamool Congress,114651,1056,115707,48.47,West Bengal-Raidighi
2,KANTI GANGULY,Communist Party of India  (Marxist),36689,242,36931,15.47,West Bengal-Raidighi
3,MINTU MISTRI,Bahujan Samaj Party,793,2,795,0.33,West Bengal-Raidighi
4,SANTANU BAPULI,Bharatiya Janata Party,79602,537,80139,33.57,West Bengal-Raidighi
5,GUNASINDHU HALDAR,SOCIALIST UNITY CENTRE OF INDIA (COMMUNIST),2818,44,2862,1.2,West Bengal-Raidighi
6,BABLU HALDAR,Independent,290,2,292,0.12,West Bengal-Raidighi
7,SOUVIK BAPULI,Independent,530,2,532,0.22,West Bengal-Raidighi
8,NOTA,None of the Above,1457,5,1462,0.61,West Bengal-Raidighi
1,AGARWAL KANAIA LAL,All India Trinamool Congress,58007,1020,59027,36.58,West Bengal-Raiganj
2,KRISHNA KALYANI,Bharatiya Janata Party,78308,1467,79775,49.44,West Bengal-Raiganj
3,MOHIT SENGUPTA,Indian National Congress,16524,674,17198,10.66,West Bengal-Raiganj
4,GOUTAM BISWAS,Amra Bangalee,204,4,208,0.13,West Bengal-Raiganj
5,BAHAMONI HANSDA,Bahujan Mukti Party,128,5,133,0.08,West Bengal-Raiganj
6,BHABATOSH LAHIRI,Janata Dal  (United),73,0,73,0.05,West Bengal-Raiganj
7,SANATAN MAJUMDAR,SOCIALIST UNITY CENTRE OF INDIA (COMMUNIST),133,0,133,0.08,West Bengal-Raiganj
8,JYOTI BARMAN,Independent,98,1,99,0.06,West Bengal-Raiganj
9,DIPENDU SARKAR,Independent,208,3,211,0.13,West Bengal-Raiganj
10,MANJU DAS (MANDAL),Independent,194,2,196,0.12,West Bengal-Raiganj
11,MINAKSHI ROY,Independent,462,3,465,0.29,West Bengal-Raiganj
12,RAJU PAUL,Independent,1361,0,1361,0.84,West Bengal-Raiganj
13,NOTA,None of the Above,2459,9,2468,1.53,West Bengal-Raiganj
1,Pallab Biswas,Bahujan Samaj Party,1861,10,1871,0.82,West Bengal-Raina
2,Basudeb Khan,Communist Party of India  (Marxist),25141,191,25332,11.05,West Bengal-Raina
3,Manik Roy,Bharatiya Janata Party,89999,548,90547,39.51,West Bengal-Raina
4,Shampa Dhara,All India Trinamool Congress,107918,834,108752,47.46,West Bengal-Raina
5,Rabi Routh,Bahujan Mukti Party,1098,3,1101,0.48,West Bengal-Raina
6,NOTA,None of the Above,1556,7,1563,0.68,West Bengal-Raina
1,MRITYUNJOY MURMU,All India Trinamool Congress,100387,656,101043,51.96,West Bengal-Raipur
2,SUDHANSHU HANSDA,Bharatiya Janata Party,80760,885,81645,41.98,West Bengal-Raipur
3,MILAN MANDI,Rashtriya Secular Majlis Party,6496,97,6593,3.39,West Bengal-Raipur
4,SHYAMAPADA MUDI,SOCIALIST UNITY CENTRE OF INDIA (COMMUNIST),1041,7,1048,0.54,West Bengal-Raipur
5,SUKCHAND SAREN,Independent,1154,7,1161,0.6,West Bengal-Raipur
6,NOTA,None of the Above,2973,13,2986,1.54,West Bengal-Raipur
1,ADITI MUNSHI,All India Trinamool Congress,87219,431,87650,49.04,West Bengal-Rajarhat  Gopalpur
2,SAMIK BHATTACHARYA,Bharatiya Janata Party,62092,262,62354,34.89,West Bengal-Rajarhat  Gopalpur
3,SUBHAJIT DASGUPTA,Communist Party of India  (Marxist),24333,178,24511,13.71,West Bengal-Rajarhat  Gopalpur
4,JAGANMOY KARMAKAR,SOCIALIST UNITY CENTRE OF INDIA (COMMUNIST),454,1,455,0.25,West Bengal-Rajarhat  Gopalpur
5,RINA DEY,Bharatiya Nyay-Adhikar Raksha Party,365,5,370,0.21,West Bengal-Rajarhat  Gopalpur
6,APURBA MONDAL,Independent,94,1,95,0.05,West Bengal-Rajarhat  Gopalpur
7,AMITAVA BASU,Independent,90,0,90,0.05,West Bengal-Rajarhat  Gopalpur
8,INDRANI HALDER,Independent,82,2,84,0.05,West Bengal-Rajarhat  Gopalpur
9,GOPAL MONDAL,Independent,101,1,102,0.06,West Bengal-Rajarhat  Gopalpur
10,DR. NITAI CHANDRA ROY,Independent,149,1,150,0.08,West Bengal-Rajarhat  Gopalpur
11,MD. JAVED,Independent,279,1,280,0.16,West Bengal-Rajarhat  Gopalpur
12,LALU NEYE,Independent,324,0,324,0.18,West Bengal-Rajarhat  Gopalpur
13,NOTA,None of the Above,2251,7,2258,1.26,West Bengal-Rajarhat  Gopalpur
1,BHASKAR ROY  S/O - DULAL ROY,Bharatiya Janata Party,70658,284,70942,30.2,West Bengal-Rajarhat New Town
2,BHASKAR ROY S/O - KRISHNA KANTA ROY,Bahujan Samaj Party,1127,10,1137,0.48,West Bengal-Rajarhat New Town
3,SAPTARSHI DEB,Communist Party of India  (Marxist),31419,124,31543,13.43,West Bengal-Rajarhat New Town
4,TAPASH CHATTERJEE,All India Trinamool Congress,126945,429,127374,54.22,West Bengal-Rajarhat New Town
5,SUBHENDU GHOSH,Independent,1310,3,1313,0.56,West Bengal-Rajarhat New Town
6,SUBIR SAMADDAR,Independent,563,2,565,0.24,West Bengal-Rajarhat New Town
7,NOTA,None of the Above,2028,4,2032,0.87,West Bengal-Rajarhat New Town
1,KHAGESWAR ROY,All India Trinamool Congress,103587,1054,104641,48.5,West Bengal-Rajganj
2,RATAN KUMAR ROY,Communist Party of India  (Marxist),11897,211,12108,5.61,West Bengal-Rajganj
3,SANTI KISHOR BARARI,Bahujan Samaj Party,1498,12,1510,0.7,West Bengal-Rajganj
4,SUPEN ROY,Bharatiya Janata Party,87822,1046,88868,41.19,West Bengal-Rajganj
5,UDAY ROY,SOCIALIST UNITY CENTRE OF INDIA (COMMUNIST),1590,15,1605,0.74,West Bengal-Rajganj
6,TAPATI ROY (BARMAN),Kamatapur Peopleâ€™s Party (United),1851,9,1860,0.86,West Bengal-Rajganj
7,NIRODE CHANDRA ADHIKARY,Amra Bangalee,833,9,842,0.39,West Bengal-Rajganj
8,DIGBIJAY MANDAL,Independent,1137,9,1146,0.53,West Bengal-Rajganj
9,NOTA,None of the Above,3161,14,3175,1.47,West Bengal-Rajganj
1,AKHIL GIRI,All India Trinamool Congress,111870,752,112622,50.72,West Bengal-Ramnagar
2,SABYASACHI JANA,Communist Party of India  (Marxist),6657,94,6751,3.04,West Bengal-Ramnagar
3,SWADESH RANJAN NAYAK,Bharatiya Janata Party,99477,628,100105,45.08,West Bengal-Ramnagar
4,ARATI PAHARI,SOCIALIST UNITY CENTRE OF INDIA (COMMUNIST),942,2,944,0.43,West Bengal-Ramnagar
5,TRAYEE PRADHAN,Right to Recall Party,399,6,405,0.18,West Bengal-Ramnagar
6,NOTA,None of the Above,1230,3,1233,0.56,West Bengal-Ramnagar
1,ASISH BANERJEE,All India Trinamool Congress,102251,1025,103276,47.52,West Bengal-Rampurhat
2,BIPAD TARAN DOM,Bahujan Samaj Party,1587,0,1587,0.73,West Bengal-Rampurhat
3,SUBHASIS CHOUDHURY (KHOKAN),Bharatiya Janata Party,93574,1230,94804,43.62,West Bengal-Rampurhat
4,SANJIB BARMAN (GOPI),Communist Party of India  (Marxist),11578,129,11707,5.39,West Bengal-Rampurhat
5,IBANE RASUL (ANGUR MIYA),Bahujan Maha Party,1607,1,1608,0.74,West Bengal-Rampurhat
6,FORIDA YASMIN (KEYA),SOCIALIST UNITY CENTRE OF INDIA (COMMUNIST),956,4,960,0.44,West Bengal-Rampurhat
7,NOTA,None of the Above,3369,12,3381,1.56,West Bengal-Rampurhat
1,PRASANTA BISWAS,Bahujan Samaj Party,1654,12,1666,0.69,West Bengal-Ranaghat Dakshin
2,BARNALI DEY ROY,All India Trinamool Congress,101882,863,102745,42.51,West Bengal-Ranaghat Dakshin
3,MUKUT MANI ADHIKARI,Bharatiya Janata Party,118374,886,119260,49.34,West Bengal-Ranaghat Dakshin
4,RAMA BISWAS,Communist Party of India  (Marxist),14921,203,15124,6.26,West Bengal-Ranaghat Dakshin
5,NANIGOPAL MISTRI,SOCIALIST UNITY CENTRE OF INDIA (COMMUNIST),1313,2,1315,0.54,West Bengal-Ranaghat Dakshin
6,NOTA,None of the Above,1561,16,1577,0.65,West Bengal-Ranaghat Dakshin
1,AMAL SARKAR,Bahujan Samaj Party,1299,13,1312,0.59,West Bengal-Ranaghat Uttar Paschim
2,PARTHASARATHI CHATTERJEE,Bharatiya Janata Party,112413,1224,113637,50.91,West Bengal-Ranaghat Uttar Paschim
3,BIJAYENDU BISWAS (HABU),Indian National Congress,10134,211,10345,4.64,West Bengal-Ranaghat Uttar Paschim
4,SANKAR SINGHA,All India Trinamool Congress,89503,1006,90509,40.55,West Bengal-Ranaghat Uttar Paschim
5,APARNA GUHA,SOCIALIST UNITY CENTRE OF INDIA (COMMUNIST),1062,6,1068,0.48,West Bengal-Ranaghat Uttar Paschim
6,SOURAV CHAKRABORTY,Socialist Party (India),701,0,701,0.31,West Bengal-Ranaghat Uttar Paschim
7,ALPANA BANDYOPADHYAY,Independent,1064,6,1070,0.48,West Bengal-Ranaghat Uttar Paschim
8,RATAN MALAKAR,Independent,1157,3,1160,0.52,West Bengal-Ranaghat Uttar Paschim
9,RABINDRA NATH BISWAS,Independent,1125,8,1133,0.51,West Bengal-Ranaghat Uttar Paschim
10,NOTA,None of the Above,2216,42,2258,1.01,West Bengal-Ranaghat Uttar Paschim
1,ASHIM BISWAS,Bharatiya Janata Party,115665,1121,116786,54.39,West Bengal-Ranaghat Uttar Purba
2,SANJIT KUMAR MANDAL,Bahujan Samaj Party,2087,30,2117,0.99,West Bengal-Ranaghat Uttar Purba
3,SAMIR KUMAR PODDAR,All India Trinamool Congress,84146,858,85004,39.59,West Bengal-Ranaghat Uttar Purba
4,DINESH CHANDRA BISWAS,Rashtriya Secular Majlis Party,5115,89,5204,2.42,West Bengal-Ranaghat Uttar Purba
5,SAMIR KUMAR BISWAS,Bahujan Mukti Party,486,2,488,0.23,West Bengal-Ranaghat Uttar Purba
6,SWADHIN BISWAS,Purvanchal Mahapanchayat,482,3,485,0.23,West Bengal-Ranaghat Uttar Purba
7,APURBA LAL ROY,Independent,1224,4,1228,0.57,West Bengal-Ranaghat Uttar Purba
8,KAMAL SARKAR,Independent,1060,5,1065,0.5,West Bengal-Ranaghat Uttar Purba
9,NOTA,None of the Above,2339,20,2359,1.1,West Bengal-Ranaghat Uttar Purba
1,Kshudiram Tudu,Bharatiya Janata Party,85922,1067,86989,41.19,West Bengal-Ranibandh
2,Jyotsna Mandi,All India Trinamool Congress,90064,864,90928,43.06,West Bengal-Ranibandh
3,Deblina Hembram,Communist Party of India  (Marxist),19821,236,20057,9.5,West Bengal-Ranibandh
4,Goutam Kumar Mudi,SOCIALIST UNITY CENTRE OF INDIA (COMMUNIST),1614,19,1633,0.77,West Bengal-Ranibandh
5,Fulchand Hansda,Bahujan Mukti Party,1053,12,1065,0.5,West Bengal-Ranibandh
6,Sudhir Kumar Murmu,Communist Party of India  (Marxist-Leninist)  (Liberation),1456,9,1465,0.69,West Bengal-Ranibandh
7,Biswanath Sardar,Independent,4794,13,4807,2.28,West Bengal-Ranibandh
8,NOTA,None of the Above,4215,11,4226,2,West Bengal-Ranibandh
1,AVIJIT BOWRI,Bahujan Samaj Party,1533,7,1540,0.85,West Bengal-Raniganj
2,TAPAS BANERJEE,All India Trinamool Congress,77528,636,78164,42.9,West Bengal-Raniganj
3,DR. BIJAN MUKHERJEE,Bharatiya Janata Party,74233,375,74608,40.95,West Bengal-Raniganj
4,HEMANT KUMAR PRABHAKAR,Communist Party of India  (Marxist),21434,254,21688,11.9,West Bengal-Raniganj
5,NIRAJ RAJAK,Purvanchal Mahapanchayat,981,3,984,0.54,West Bengal-Raniganj
6,NILKANTHA BAURI,Bahujan Mukti Party,1608,1,1609,0.88,West Bengal-Raniganj
7,RAJ KUMAR,Janata Dal  (United),1612,0,1612,0.88,West Bengal-Raniganj
8,NOTA,None of the Above,1994,12,2006,1.1,West Bengal-Raniganj
1,ABDUL SOUMIK HOSSAIN,All India Trinamool Congress,134346,611,134957,60.79,West Bengal-Raninagar
2,FIROZA BEGAM,Indian National Congress,54918,337,55255,24.89,West Bengal-Raninagar
3,MST MASUARA KHATUN,Bharatiya Janata Party,21010,128,21138,9.52,West Bengal-Raninagar
4,RULIYA PARVIN,Bahujan Samaj Party,584,3,587,0.26,West Bengal-Raninagar
5,ABDUL HAI,Bahujan Maha Party,246,1,247,0.11,West Bengal-Raninagar
6,GOLAM MASUM REJA,Rashtriya Secular Majlis Party,2752,2,2754,1.24,West Bengal-Raninagar
7,NASRIN NAHER LUCY,SOCIALIST UNITY CENTRE OF INDIA (COMMUNIST),497,4,501,0.23,West Bengal-Raninagar
8,MD SAHER ALAM,SOCIAL DEMOCRATIC PARTY OF INDIA,1385,8,1393,0.63,West Bengal-Raninagar
9,SAIRA BIBI,United Socialist Party,198,4,202,0.09,West Bengal-Raninagar
10,FIROZA BIBI,Independent,882,2,884,0.4,West Bengal-Raninagar
11,SAFIUR RAHAMAN MANDAL,Independent,496,0,496,0.22,West Bengal-Raninagar
12,HASIBUL ISLAM,Independent,827,1,828,0.37,West Bengal-Raninagar
13,NOTA,None of the Above,2769,5,2774,1.25,West Bengal-Raninagar
1,ASHUTOSH CHATTERJEE,Indian National Congress,10156,158,10314,8.29,West Bengal-Rashbehari
2,DEBASISH KUMAR,All India Trinamool Congress,64838,866,65704,52.79,West Bengal-Rashbehari
3,LT. GEN. (DR.) SUBRATA SAHA,Bharatiya Janata Party,43907,383,44290,35.59,West Bengal-Rashbehari
4,ROMIT CHOWDHURY,National Republic Party Of India,310,11,321,0.26,West Bengal-Rashbehari
5,SUSMITA PAL,SOCIALIST UNITY CENTRE OF INDIA (COMMUNIST),536,10,546,0.44,West Bengal-Rashbehari
6,SWAPAN DAS,Bahujan Mukti Party,70,2,72,0.06,West Bengal-Rashbehari
7,DEBASHIS NATH,Independent,121,2,123,0.1,West Bengal-Rashbehari
8,GOPAL GHOSH,Independent,96,1,97,0.08,West Bengal-Rashbehari
9,MUSARAT PARVEEN,Independent,131,3,134,0.11,West Bengal-Rashbehari
10,NIRAJ AGARWAL,Independent,177,4,181,0.15,West Bengal-Rashbehari
11,PANKAJ THAKKAR,Independent,341,1,342,0.27,West Bengal-Rashbehari
12,PREETAM KUNDU,Independent,666,3,669,0.54,West Bengal-Rashbehari
13,NOTA,None of the Above,1641,21,1662,1.34,West Bengal-Rashbehari
1,Abishek Singhania,Bharatiya Janata Party,54326,698,55024,25.11,West Bengal-Ratua
2,Khatun Najema,Indian National Congress,15997,176,16173,7.38,West Bengal-Ratua
3,Chaitanya Rabidas,Bahujan Samaj Party,1680,2,1682,0.77,West Bengal-Ratua
4,Samar Mukherjee,All India Trinamool Congress,129805,869,130674,59.63,West Bengal-Ratua
5,Arafat Ali,Welfare Party Of India,2097,5,2102,0.96,West Bengal-Ratua
6,Ashok Chowdhury,Independent,1383,4,1387,0.63,West Bengal-Ratua
7,Payel Khatun,Independent,8596,32,8628,3.94,West Bengal-Ratua
8,Sabina Easmin,Independent,856,0,856,0.39,West Bengal-Ratua
9,Sk Israil,Independent,570,1,571,0.26,West Bengal-Ratua
10,NOTA,None of the Above,2047,4,2051,0.94,West Bengal-Ratua
1,ARABINDA BISWAS,Bharatiya Janata Party,49611,615,50226,23.87,West Bengal-Rejinagar
2,KAFIRUDDIN SK,Indian National Congress,36988,294,37282,17.72,West Bengal-Rejinagar
3,RABIUL ALAM CHOWDHURY,All India Trinamool Congress,117625,869,118494,56.31,West Bengal-Rejinagar
4,MUJIBUR RAHAMAN,Indian Union Muslim League,1035,4,1039,0.49,West Bengal-Rejinagar
5,Md. Babar Ali,SOCIALIST UNITY CENTRE OF INDIA (COMMUNIST),1338,0,1338,0.64,West Bengal-Rejinagar
6,HASANUR ZAMAN SK,Hindustani Awam Morcha (Secular),504,2,506,0.24,West Bengal-Rejinagar
7,NOTA,None of the Above,1550,10,1560,0.74,West Bengal-Rejinagar
1,AMULYA MAITY,Bharatiya Janata Party,100807,1427,102234,43.28,West Bengal-Sabang
2,CHIRANJIB BHOWMIK,Indian National Congress,17099,344,17443,7.38,West Bengal-Sabang
3,MANAS RANJAN BHUNIA,All India Trinamool Congress,110370,1728,112098,47.46,West Bengal-Sabang
4,DEBASHIS BARMAN,Amra Bangalee,1408,2,1410,0.6,West Bengal-Sabang
5,Harekrishna Maiti,SOCIALIST UNITY CENTRE OF INDIA (COMMUNIST),1453,29,1482,0.63,West Bengal-Sabang
6,NOTA,None of the Above,1515,19,1534,0.65,West Bengal-Sabang
1,KAMILA BIKASH,Bharatiya Janata Party,98496,658,99154,41.48,West Bengal-Sagar
2,BANKIM CHANDRA HAZRA,All India Trinamool Congress,127861,1139,129000,53.96,West Bengal-Sagar
3,SK MUKLESUR RAHAMAN,Communist Party of India  (Marxist),9033,63,9096,3.8,West Bengal-Sagar
4,SWARAJ DAS,SOCIALIST UNITY CENTRE OF INDIA (COMMUNIST),787,5,792,0.33,West Bengal-Sagar
5,NOTA,None of the Above,1023,2,1025,0.43,West Bengal-Sagar
1,KHATUN MAFUJA,Bharatiya Janata Party,44692,291,44983,24.08,West Bengal-Sagardighi
2,DHANANJAY BANERJEE,Bahujan Samaj Party,978,3,981,0.53,West Bengal-Sagardighi
3,SUBRATA SAHA,All India Trinamool Congress,94880,309,95189,50.95,West Bengal-Sagardighi
4,SK M HASANUZZAMAN (BAPPA),Indian National Congress,36055,289,36344,19.45,West Bengal-Sagardighi
5,ABDUT TAWAB,SOCIAL DEMOCRATIC PARTY OF INDIA,1278,2,1280,0.69,West Bengal-Sagardighi
6,NURE MAHABOOB ALAM,All India Majlis-E-Ittehadul Muslimeen,3449,1,3450,1.85,West Bengal-Sagardighi
7,MIRZA LUTFUL HOQUE,SOCIALIST UNITY CENTRE OF INDIA (COMMUNIST),694,4,698,0.37,West Bengal-Sagardighi
8,SUPAL MURMU,Bahujan Mukti Party,1654,2,1656,0.89,West Bengal-Sagardighi
9,SANTA BHATTACHERJEE,Independent,527,3,530,0.28,West Bengal-Sagardighi
10,NOTA,None of the Above,1705,0,1705,0.91,West Bengal-Sagardighi
1,TARAPADA BADYAKAR,Bahujan Samaj Party,2092,6,2098,0.95,West Bengal-Sainthia
2,NILABATI SAHA,All India Trinamool Congress,109041,1531,110572,49.84,West Bengal-Sainthia
3,PIYA SAHA,Bharatiya Janata Party,94174,1155,95329,42.97,West Bengal-Sainthia
4,MAUSUMI KONAI,Communist Party of India  (Marxist),10239,130,10369,4.67,West Bengal-Sainthia
5,NABA KUMAR DAS,SOCIALIST UNITY CENTRE OF INDIA (COMMUNIST),1751,5,1756,0.79,West Bengal-Sainthia
6,NOTA,None of the Above,1727,15,1742,0.79,West Bengal-Sainthia
1,Ghosh Susanta,Communist Party of India  (Marxist),19650,209,19859,7.97,West Bengal-Salboni
2,Rajib Kundu,Bharatiya Janata Party,92415,961,93376,37.47,West Bengal-Salboni
3,Srikanta Mahata,All India Trinamool Congress,125097,923,126020,50.57,West Bengal-Salboni
4,Akshaya Kumar Mahata,Amra Bangalee,1591,18,1609,0.65,West Bengal-Salboni
5,Paresh Chandra Dutta,SOCIALIST UNITY CENTRE OF INDIA (COMMUNIST),563,2,565,0.23,West Bengal-Salboni
6,Md. Kabirul Islam Khan,Humanity Universal Motion Party,753,3,756,0.3,West Bengal-Salboni
7,Animesh Mahata,Independent,741,4,745,0.3,West Bengal-Salboni
8,Rasbihari Mahata,Independent,2632,11,2643,1.06,West Bengal-Salboni
9,Laksmi Kanta Murmu,Independent,1643,14,1657,0.66,West Bengal-Salboni
10,NOTA,None of the Above,1956,9,1965,0.79,West Bengal-Salboni
1,NANDADULAL BAURI,Communist Party of India  (Marxist),13982,102,14084,6.96,West Bengal-Saltora
2,BAURI CHANDANA,Bharatiya Janata Party,91032,616,91648,45.28,West Bengal-Saltora
3,SONTOSH KUMAR MONDAL,All India Trinamool Congress,86814,689,87503,43.23,West Bengal-Saltora
4,ADITYA KUMAR BAURI,Bahujan Mukti Party,3539,15,3554,1.76,West Bengal-Saltora
5,DIPEN BAURI,SOCIALIST UNITY CENTRE OF INDIA (COMMUNIST),2256,5,2261,1.12,West Bengal-Saltora
6,NOTA,None of the Above,3350,13,3363,1.66,West Bengal-Saltora
1,DR. BHASKAR SARDAR,Bharatiya Janata Party,72416,349,72765,35.36,West Bengal-Sandeshkhali
2,SUKUMAR MAHATA,All India Trinamool Congress,111970,480,112450,54.64,West Bengal-Sandeshkhali
3,BARUN MAHATO,Rashtriya Secular Majlis Party,14340,47,14387,6.99,West Bengal-Sandeshkhali
4,KHOKAN SARDAR,Independent,702,3,705,0.34,West Bengal-Sandeshkhali
5,SUBAL CHANDRA SARDAR,Independent,1058,5,1063,0.52,West Bengal-Sandeshkhali
6,HARISH CHANDRA SARDAR,Independent,1955,6,1961,0.95,West Bengal-Sandeshkhali
7,NOTA,None of the Above,2454,2,2456,1.19,West Bengal-Sandeshkhali
1,PROBHAKAR PANDIT,Bharatiya Janata Party,71333,128,71461,32.17,West Bengal-Sankrail
2,PRIYA PAUL,All India Trinamool Congress,111758,130,111888,50.37,West Bengal-Sankrail
3,SAMIR MALICK,Communist Party of India  (Marxist),34077,67,34144,15.37,West Bengal-Sankrail
4,TAPAS DOLUI,Independent,518,2,520,0.23,West Bengal-Sankrail
5,BIMAL KANTI NASKAR,Independent,396,0,396,0.18,West Bengal-Sankrail
6,BUDHEN PATRA,Independent,339,1,340,0.15,West Bengal-Sankrail
7,SUVOMAY KHELO,Independent,522,0,522,0.24,West Bengal-Sankrail
8,SAMIR SHIT,Independent,1006,0,1006,0.45,West Bengal-Sankrail
9,NOTA,None of the Above,1848,2,1850,0.83,West Bengal-Sankrail
1,AJOY DEY,All India Trinamool Congress,92715,1129,93844,42.72,West Bengal-Santipur
2,RITZU GHOSAL,Indian National Congress,9725,123,9848,4.48,West Bengal-Santipur
3,JAGANNATH SARKAR,Bharatiya Janata Party,108638,1084,109722,49.94,West Bengal-Santipur
4,PROFULLA KUMAR ROY,Bahujan Samaj Party,1288,6,1294,0.59,West Bengal-Santipur
5,NADIA CHAND BISWAS,SOCIALIST UNITY CENTRE OF INDIA (COMMUNIST),599,9,608,0.28,West Bengal-Santipur
6,SUKDEB BISWAS,Purvanchal Mahapanchayat,1095,4,1099,0.5,West Bengal-Santipur
7,SUFAL SARKAR,Jan Sangh Party,885,7,892,0.41,West Bengal-Santipur
8,NOTA,None of the Above,2364,21,2385,1.09,West Bengal-Santipur
1,TAPAN DASGUPTA,All India Trinamool Congress,92689,639,93328,48.56,West Bengal-Saptagram
2,DEBABRATA BISWAS,Bharatiya Janata Party,83128,428,83556,43.48,West Bengal-Saptagram
3,PABITRA DEB,Indian National Congress,8233,99,8332,4.34,West Bengal-Saptagram
4,Ajoy Das,Independent,556,12,568,0.3,West Bengal-Saptagram
5,Paritosh Karmakar,Independent,306,10,316,0.16,West Bengal-Saptagram
6,Bishnu Chowdhuri,Independent,595,6,601,0.31,West Bengal-Saptagram
7,Milan Das,Independent,706,1,707,0.37,West Bengal-Saptagram
8,Subir Roy,Independent,1745,0,1745,0.91,West Bengal-Saptagram
9,NOTA,None of the Above,3031,6,3037,1.58,West Bengal-Saptagram
1,GOUTAM PAL,Communist Party of India  (Marxist),16134,86,16220,6.89,West Bengal-Satgachhia
2,CHANDAN PAL,Bharatiya Janata Party,94927,390,95317,40.47,West Bengal-Satgachhia
3,MOHAN CHANDRA NASKAR,All India Trinamool Congress,117974,661,118635,50.37,West Bengal-Satgachhia
4,SANJAY KUMAR SAH,Bahujan Samaj Party,1377,2,1379,0.59,West Bengal-Satgachhia
5,SK RABIYAL,SOCIALIST UNITY CENTRE OF INDIA (COMMUNIST),1622,3,1625,0.69,West Bengal-Satgachhia
6,DEBAJYOTI BASU,Independent,990,3,993,0.42,West Bengal-Satgachhia
7,NOTA,None of the Above,1374,3,1377,0.58,West Bengal-Satgachhia
1,Jagannath Bhattacharyya,All India Forward Bloc,24817,153,24970,13.7,West Bengal-Shibpur
2,Manoj Tiwary,All India Trinamool Congress,92048,324,92372,50.69,West Bengal-Shibpur
3,Rathin Chakrabarty,Bharatiya Janata Party,59574,195,59769,32.8,West Bengal-Shibpur
4,Kartick Shil,SOCIALIST UNITY CENTRE OF INDIA (COMMUNIST),600,1,601,0.33,West Bengal-Shibpur
5,Anupam Sarkar,Independent,342,1,343,0.19,West Bengal-Shibpur
6,Abhisek Kumar Chatterjee,Independent,244,5,249,0.14,West Bengal-Shibpur
7,Arim Roy,Independent,186,1,187,0.1,West Bengal-Shibpur
8,Pritam Das,Independent,267,4,271,0.15,West Bengal-Shibpur
9,Rajib Bhattacharya,Independent,638,0,638,0.35,West Bengal-Shibpur
10,Surojit Das,Independent,905,2,907,0.5,West Bengal-Shibpur
11,NOTA,None of the Above,1901,11,1912,1.05,West Bengal-Shibpur
1,JIBAN PRAKASH SAHA,All India Forward Bloc,10655,173,10828,10.52,West Bengal-Shyampukur
2,SANDIPAN BISWAS,Bharatiya Janata Party,33099,166,33265,32.31,West Bengal-Shyampukur
3,Dr. SHASHI PANJA,All India Trinamool Congress,55184,601,55785,54.18,West Bengal-Shyampukur
4,MUNNI MALI,Sajag Samaj Party,406,3,409,0.4,West Bengal-Shyampukur
5,Chhaya Ghosh,Independent,119,3,122,0.12,West Bengal-Shyampukur
6,CHINMOY BISWAS,Independent,106,4,110,0.11,West Bengal-Shyampukur
7,DILIP DAS,Independent,49,1,50,0.05,West Bengal-Shyampukur
8,PRAVEEN KUMAR JAIN,Independent,138,1,139,0.13,West Bengal-Shyampukur
9,PURNIMA BANERJEE,Independent,94,0,94,0.09,West Bengal-Shyampukur
10,SANJAY NANDI,Independent,180,6,186,0.18,West Bengal-Shyampukur
11,SURAJIT GHOSH,Independent,639,0,639,0.62,West Bengal-Shyampukur
12,TARKESH RAI,Independent,279,1,280,0.27,West Bengal-Shyampukur
13,NOTA,None of the Above,1053,10,1063,1.03,West Bengal-Shyampukur
1,AMITABHA CHAKRABORTI,Indian National Congress,20382,26,20408,9.2,West Bengal-Shyampur
2,KALIPADA MANDAL,All India Trinamool Congress,114542,262,114804,51.74,West Bengal-Shyampur
3,TNUSREE CHAKRABORTY,Bharatiya Janata Party,83129,164,83293,37.54,West Bengal-Shyampur
4,PRADIP MANDAL,SOCIALIST UNITY CENTRE OF INDIA (COMMUNIST),1001,1,1002,0.45,West Bengal-Shyampur
5,TUSHARKANTI MAL,Independent,607,1,608,0.27,West Bengal-Shyampur
6,SANKAR MANDAL,Independent,632,0,632,0.28,West Bengal-Shyampur
7,NOTA,None of the Above,1141,1,1142,0.51,West Bengal-Shyampur
1,Asok Bhattacharya,Communist Party of India  (Marxist),28269,566,28835,16.14,West Bengal-Siliguri
2,Dr. Omprakash Mishra,All India Trinamool Congress,53153,631,53784,30.11,West Bengal-Siliguri
3,Kakali Majumdar (Roy),Bahujan Samaj Party,1241,14,1255,0.7,West Bengal-Siliguri
4,Sankar Ghosh,Bharatiya Janata Party,88580,790,89370,50.03,West Bengal-Siliguri
5,Chayan Guha,Amra Bangalee,592,2,594,0.33,West Bengal-Siliguri
6,Chhotan Saha,Republican Party of India (Athawale),301,5,306,0.17,West Bengal-Siliguri
7,Dipti Roy,SOCIALIST UNITY CENTRE OF INDIA (COMMUNIST),368,11,379,0.21,West Bengal-Siliguri
8,Nintu Dutta,Republican Party of India (A),645,4,649,0.36,West Bengal-Siliguri
9,Bhushan Kumar Soni,Janata Dal  (United),443,4,447,0.25,West Bengal-Siliguri
10,Habul Ghosh,Independent,951,6,957,0.54,West Bengal-Siliguri
11,NOTA,None of the Above,2035,39,2074,1.16,West Bengal-Siliguri
1,BECHARAM MANNA,All India Trinamool Congress,99852,1225,101077,48.15,West Bengal-Singur
2,RABINDRANATH BHATTACHARYA,Bharatiya Janata Party,74595,559,75154,35.8,West Bengal-Singur
3,SRIJAN BHATTACHARYYA,Communist Party of India  (Marxist),29639,377,30016,14.3,West Bengal-Singur
4,SHANKAR JANA,SOCIALIST UNITY CENTRE OF INDIA (COMMUNIST),1339,7,1346,0.64,West Bengal-Singur
5,NOTA,None of the Above,2335,10,2345,1.12,West Bengal-Singur
1,KESHAB CHANDRA RAY,Indian National Congress,3900,64,3964,1.66,West Bengal-Sitai
2,JAGADISH CHANDRA BARMA BASUNIA,All India Trinamool Congress,116850,1058,117908,49.42,West Bengal-Sitai
3,DIPAK KUMAR ROY,Bharatiya Janata Party,106723,1073,107796,45.18,West Bengal-Sitai
4,ANIL CHANDRA BARMAN ROY,SOCIALIST UNITY CENTRE OF INDIA (COMMUNIST),1371,10,1381,0.58,West Bengal-Sitai
5,PROSHANTA BARMAN,Lok Jan Shakti Party,548,2,550,0.23,West Bengal-Sitai
6,PRASANNA KUMAR ROY,Amra Bangalee,364,5,369,0.15,West Bengal-Sitai
7,KASHIKANTA BARMAN,Independent,862,4,866,0.36,West Bengal-Sitai
8,LALCHAND BARMAN,Independent,1773,3,1776,0.74,West Bengal-Sitai
9,SUNIL MAHANTA,Independent,2387,4,2391,1,West Bengal-Sitai
10,NOTA,None of the Above,1564,13,1577,0.66,West Bengal-Sitai
1,Partha Pratim Ray,All India Trinamool Congress,106527,613,107140,43.56,West Bengal-Sitalkuchi
2,Baren Chandra Barman,Bharatiya Janata Party,124120,835,124955,50.8,West Bengal-Sitalkuchi
3,Sudhangshu Pramanik,Communist Party of India  (Marxist),6622,98,6720,2.73,West Bengal-Sitalkuchi
4,Kamal Barman,Amra Bangalee,719,2,721,0.29,West Bengal-Sitalkuchi
5,Jagadish Adhikari,SOCIALIST UNITY CENTRE OF INDIA (COMMUNIST),691,2,693,0.28,West Bengal-Sitalkuchi
6,Manik Chandra Barman,Kamatapur Peopleâ€™s Party (United),970,6,976,0.4,West Bengal-Sitalkuchi
7,Hare Krishna Sarkar,Independent,2018,0,2018,0.82,West Bengal-Sitalkuchi
8,NOTA,None of the Above,2738,5,2743,1.12,West Bengal-Sitalkuchi
1,AJIT RAY,Communist Party of India  (Marxist),15479,246,15725,7.57,West Bengal-Sonamukhi
2,DIBAKAR GHARAMI,Bharatiya Janata Party,97203,958,98161,47.25,West Bengal-Sonamukhi
3,DR. SHYAMAL SANTRA,All India Trinamool Congress,86451,822,87273,42.01,West Bengal-Sonamukhi
4,AVRANIL MANDAL,SOCIALIST UNITY CENTRE OF INDIA (COMMUNIST),2758,14,2772,1.33,West Bengal-Sonamukhi
5,ASIM KUMAR MANDAL,Independent,1725,7,1732,0.83,West Bengal-Sonamukhi
6,NOTA,None of the Above,2062,14,2076,1,West Bengal-Sonamukhi
1,ANJANA BASU,Bharatiya Janata Party,82518,523,83041,35.67,West Bengal-Sonarpur Dakshin
2,ARUNDHUTI MAITRA (LOVELY),All India Trinamool Congress,108408,814,109222,46.92,West Bengal-Sonarpur Dakshin
3,BIMAL KRISHNA MANDAL,Bahujan Samaj Party,1099,11,1110,0.48,West Bengal-Sonarpur Dakshin
4,SHUVAM BANERJEE,Communist Party of India,31467,311,31778,13.65,West Bengal-Sonarpur Dakshin
5,TRAYEE PRADHAN,Right to Recall Party,369,3,372,0.16,West Bengal-Sonarpur Dakshin
6,DIBAKAR HALDER,SOCIALIST UNITY CENTRE OF INDIA (COMMUNIST),436,5,441,0.19,West Bengal-Sonarpur Dakshin
7,DEBASHIS RAKSHIT,Bahujan Mukti Party,124,2,126,0.05,West Bengal-Sonarpur Dakshin
8,SANJAY ROY,Amra Bangalee,144,2,146,0.06,West Bengal-Sonarpur Dakshin
9,ARUN SARKAR,Independent,194,1,195,0.08,West Bengal-Sonarpur Dakshin
10,UTTAM SAMUL,Independent,315,1,316,0.14,West Bengal-Sonarpur Dakshin
11,DILIP KUMAR ROY,Independent,600,1,601,0.26,West Bengal-Sonarpur Dakshin
12,PROVASH MONDAL,Independent,500,0,500,0.21,West Bengal-Sonarpur Dakshin
13,RANGALAL BARIK,Independent,501,1,502,0.22,West Bengal-Sonarpur Dakshin
14,SHAMPA DAS,Independent,1901,6,1907,0.82,West Bengal-Sonarpur Dakshin
15,NOTA,None of the Above,2541,9,2550,1.1,West Bengal-Sonarpur Dakshin
1,AJIT BAUL,Bahujan Samaj Party,1351,5,1356,0.56,West Bengal-Sonarpur Uttar
2,FIRDOUSI BEGUM,All India Trinamool Congress,119272,685,119957,49.88,West Bengal-Sonarpur Uttar
3,MONALISA SINHA,Communist Party of India  (Marxist),29152,248,29400,12.22,West Bengal-Sonarpur Uttar
4,RANJAN BAIDYA,Bharatiya Janata Party,83523,344,83867,34.87,West Bengal-Sonarpur Uttar
5,DULAL DAS,Independent,704,4,708,0.29,West Bengal-Sonarpur Uttar
6,NEPAL CHANDRA NASKAR,Independent,990,3,993,0.41,West Bengal-Sonarpur Uttar
7,BINANDA SING,Independent,576,3,579,0.24,West Bengal-Sonarpur Uttar
8,SAMIR BHATTACHARYA,Independent,1520,1,1521,0.63,West Bengal-Sonarpur Uttar
9,NOTA,None of the Above,2105,9,2114,0.88,West Bengal-Sonarpur Uttar
1,ALOK RANJAN BANERJEE,Indian National Congress,19223,178,19401,10.32,West Bengal-Sreerampur
2,KABIR SHANKAR BOSE,Bharatiya Janata Party,69241,347,69588,37,West Bengal-Sreerampur
3,DR. SUDIPTO ROY,All India Trinamool Congress,92435,586,93021,49.46,West Bengal-Sreerampur
4,MANGAL SARKAR,Bahujan Maha Party,905,9,914,0.49,West Bengal-Sreerampur
5,SAMIR SARKAR,SOCIALIST UNITY CENTRE OF INDIA (COMMUNIST),757,11,768,0.41,West Bengal-Sreerampur
6,BISWANATH BHATTACHERJEE,Independent,1073,2,1075,0.57,West Bengal-Sreerampur
7,SANTOSH KUMAR SINGH,Independent,906,8,914,0.49,West Bengal-Sreerampur
8,NOTA,None of the Above,2387,13,2400,1.28,West Bengal-Sreerampur
1,Isha Khan Choudhury,Indian National Congress,22042,240,22282,10.73,West Bengal-Sujapur
2,Md Abdul Ghani,All India Trinamool Congress,151658,787,152445,73.44,West Bengal-Sujapur
3,Rafiqul Islam,Bahujan Samaj Party,1458,3,1461,0.7,West Bengal-Sujapur
4,Sk Ziauddin,Bharatiya Janata Party,14655,134,14789,7.12,West Bengal-Sujapur
5,Nasmul Hoque,Party for Democratic Socialism,546,0,546,0.26,West Bengal-Sujapur
6,Md. Nur Islam Sekh,Rashtriya Secular Majlis Party,11162,11,11173,5.38,West Bengal-Sujapur
7,Md Monirul Hasan,Jamat-E-Seratul Mustakim,241,0,241,0.12,West Bengal-Sujapur
8,Manjur Alahi Munshi,Independent,452,2,454,0.22,West Bengal-Sujapur
9,Md. Saidul Hoque,Independent,352,0,352,0.17,West Bengal-Sujapur
10,Md. Rahim Biswas,Independent,2321,0,2321,1.12,West Bengal-Sujapur
11,NOTA,None of the Above,1522,5,1527,0.74,West Bengal-Sujapur
1,KHURSHID ALAM,Bahujan Samaj Party,1314,4,1318,0.6,West Bengal-Suri
2,CHANCHAL CHATTERJEE,Indian National Congress,8082,185,8267,3.78,West Bengal-Suri
3,CHATTOPADHYAY JAGANNATH,Bharatiya Janata Party,96891,1660,98551,45.08,West Bengal-Suri
4,BIKASH ROYCHOUDHURY,All India Trinamool Congress,104445,1426,105871,48.43,West Bengal-Suri
5,NITAI ANKUR,SOCIALIST UNITY CENTRE OF INDIA (COMMUNIST),2078,6,2084,0.95,West Bengal-Suri
6,DHANANJOY MAZUMDAR,Independent,660,4,664,0.3,West Bengal-Suri
7,NOTA,None of the Above,1806,29,1835,0.84,West Bengal-Suri
1,EMANI BISWAS,All India Trinamool Congress,126755,596,127351,58.87,West Bengal-Suti
2,KOUSHIK DAS,Bharatiya Janata Party,56389,261,56650,26.19,West Bengal-Suti
3,HUMAYUN REZA,Indian National Congress,18668,92,18760,8.67,West Bengal-Suti
4,ANUP SINGHA,SOCIALIST UNITY CENTRE OF INDIA (COMMUNIST),842,9,851,0.39,West Bengal-Suti
5,MAHFUJUR  RAHAMAN,Welfare Party Of India,515,1,516,0.24,West Bengal-Suti
6,ENAMUL HAQUE,Independent,482,0,482,0.22,West Bengal-Suti
7,MAIDUL ISLAM,Independent,7995,11,8006,3.7,West Bengal-Suti
8,MD. HASAN JAHANGIR,Independent,988,0,988,0.46,West Bengal-Suti
9,NOTA,None of the Above,2723,1,2724,1.26,West Bengal-Suti
1,BISWAJIT MANDAL,Communist Party of India  (Marxist),43164,118,43282,20.43,West Bengal-Swarupnagar
2,BINA MONDAL,All India Trinamool Congress,99438,346,99784,47.11,West Bengal-Swarupnagar
3,BRINDABAN SARKAR,Bharatiya Janata Party,64666,318,64984,30.68,West Bengal-Swarupnagar
4,DEBABRATA BISWAS,SOCIALIST UNITY CENTRE OF INDIA (COMMUNIST),820,1,821,0.39,West Bengal-Swarupnagar
5,PRABIR SARKAR,Independent,753,1,754,0.36,West Bengal-Swarupnagar
6,MRINMOY MONDAL,Independent,923,0,923,0.44,West Bengal-Swarupnagar
7,NOTA,None of the Above,1254,2,1256,0.59,West Bengal-Swarupnagar
1,ARUP CHAKRABORTY,All India Trinamool Congress,91146,880,92026,45.29,West Bengal-Taldangra
2,MANORANJAN PATRA,Communist Party of India  (Marxist),22961,228,23189,11.41,West Bengal-Taldangra
3,SHYAMAL KUMAR SARKAR (BENU),Bharatiya Janata Party,78593,1056,79649,39.2,West Bengal-Taldangra
4,SUBHENDU MAHATA,SOCIALIST UNITY CENTRE OF INDIA (COMMUNIST),973,13,986,0.49,West Bengal-Taldangra
5,SANJAY BAURI,Bahujan Mukti Party,347,6,353,0.17,West Bengal-Taldangra
6,RAMKRISHNA MAJI,Independent,501,6,507,0.25,West Bengal-Taldangra
7,SANDIP KUMAR DEY,Independent,1881,8,1889,0.93,West Bengal-Taldangra
8,SUNIL MURMU,Independent,1058,11,1069,0.53,West Bengal-Taldangra
9,NOTA,None of the Above,3509,9,3518,1.73,West Bengal-Taldangra
1,Goutam Panda,Communist Party of India,14552,166,14718,6.24,West Bengal-Tamluk
2,Saumen Kumar Mahapatra,All India Trinamool Congress,107441,802,108243,45.86,West Bengal-Tamluk
3,Hare Krishna Bera,Bharatiya Janata Party,106624,826,107450,45.52,West Bengal-Tamluk
4,Jnanananda Roy,SOCIALIST UNITY CENTRE OF INDIA (COMMUNIST),2739,17,2756,1.17,West Bengal-Tamluk
5,Sulalit Mallick,Amra Bangalee,189,3,192,0.08,West Bengal-Tamluk
6,Bhim Patra,Independent,773,1,774,0.33,West Bengal-Tamluk
7,Sandip Batabyal,Independent,760,2,762,0.32,West Bengal-Tamluk
8,NOTA,None of the Above,1130,6,1136,0.48,West Bengal-Tamluk
1,RAGHU UROW,Revolutionary Socialist Party,11847,241,12088,6.49,West Bengal-Tapan
2,KALPANA KISKU,All India Trinamool Congress,81939,792,82731,44.41,West Bengal-Tapan
3,BABLU KISKU,Bahujan Samaj Party,2142,4,2146,1.15,West Bengal-Tapan
4,BUDHRAI TUDU,Bharatiya Janata Party,83172,1209,84381,45.29,West Bengal-Tapan
5,ALBINUS HASDA,Bahujan Mukti Party,1311,4,1315,0.71,West Bengal-Tapan
6,KALICHARAN EKKA,SOCIALIST UNITY CENTRE OF INDIA (COMMUNIST),816,4,820,0.44,West Bengal-Tapan
7,NIPESH TIRKI,Kamatapur Peopleâ€™s Party (United),1123,2,1125,0.6,West Bengal-Tapan
8,NOTA,None of the Above,1675,28,1703,0.91,West Bengal-Tapan
1,RAMENDU SINHARAY,All India Trinamool Congress,95384,1314,96698,46.96,West Bengal-Tarakeswar
2,SURAJIT GHOSH,Communist Party of India  (Marxist),14396,199,14595,7.09,West Bengal-Tarakeswar
3,Dr. Swapan Dasgupta,Bharatiya Janata Party,88461,753,89214,43.33,West Bengal-Tarakeswar
4,Sanju Chakraborty,Republican Party of India (Athawale),1690,7,1697,0.82,West Bengal-Tarakeswar
5,Sukumar Khanra,Independent,954,7,961,0.47,West Bengal-Tarakeswar
6,NOTA,None of the Above,2740,12,2752,1.34,West Bengal-Tarakeswar
1,Ashutosh Paul,Bharatiya Janata Party,89503,1430,90933,41.69,West Bengal-Tehatta
2,Tapas Kumar Saha,All India Trinamool Congress,96249,1599,97848,44.86,West Bengal-Tehatta
3,Tarak Nath Biswas,Bahujan Samaj Party,1846,30,1876,0.86,West Bengal-Tehatta
4,Subodh Chandra Biswas,Communist Party of India  (Marxist),22905,334,23239,10.65,West Bengal-Tehatta
5,Surya Biswas,Purvanchal Mahapanchayat,632,6,638,0.29,West Bengal-Tehatta
6,Chiranjit Sardar,Independent,395,5,400,0.18,West Bengal-Tehatta
7,Rabindranath Halder,Independent,1437,2,1439,0.66,West Bengal-Tehatta
8,NOTA,None of the Above,1726,10,1736,0.8,West Bengal-Tehatta
1,AROOP BISWAS,All India Trinamool Congress,100491,949,101440,51.4,West Bengal-Tollyganj
2,DEBDUT GHOSH,Communist Party of India  (Marxist),40260,337,40597,20.57,West Bengal-Tollyganj
3,BABUL SUPRIYO,Bharatiya Janata Party,51064,296,51360,26.02,West Bengal-Tollyganj
4,DEBABRATA BERA,SOCIALIST UNITY CENTRE OF INDIA (COMMUNIST),451,3,454,0.23,West Bengal-Tollyganj
5,ANINDITA BASU,Independent,128,5,133,0.07,West Bengal-Tollyganj
6,AVIJIT SARKAR,Independent,101,1,102,0.05,West Bengal-Tollyganj
7,DEBASHIS DAS,Independent,94,0,94,0.05,West Bengal-Tollyganj
8,RABI MALIK,Independent,102,1,103,0.05,West Bengal-Tollyganj
9,RAJ KUMAR MISHRA,Independent,123,3,126,0.06,West Bengal-Tollyganj
10,SUBHODEEP DAS,Independent,145,3,148,0.07,West Bengal-Tollyganj
11,SAMAR KUMAR BISWAS,Independent,195,0,195,0.1,West Bengal-Tollyganj
12,SUDIPTA SOM,Independent,302,1,303,0.15,West Bengal-Tollyganj
13,NOTA,None of the Above,2297,13,2310,1.17,West Bengal-Tollyganj
1,Pranab Kumar Dey,All India Trinamool Congress,82546,759,83305,39.79,West Bengal-Tufanganj
2,Malati Rava Roy,Bharatiya Janata Party,112609,1894,114503,54.69,West Bengal-Tufanganj
3,Rabin Roy,Indian National Congress,5804,169,5973,2.85,West Bengal-Tufanganj
4,Jiban Kumar Saha,Amra Bangalee,422,1,423,0.2,West Bengal-Tufanganj
5,Bhola Saha,SOCIALIST UNITY CENTRE OF INDIA (COMMUNIST),481,10,491,0.23,West Bengal-Tufanganj
6,Dhananjay Barman,Independent,541,11,552,0.26,West Bengal-Tufanganj
7,Prahallad Layek,Independent,600,1,601,0.29,West Bengal-Tufanganj
8,Sushil Chandra Das,Independent,1458,3,1461,0.7,West Bengal-Tufanganj
9,NOTA,None of the Above,2047,22,2069,0.99,West Bengal-Tufanganj
1,ALOKE KOLEY,Indian National Congress,5158,20,5178,2.61,West Bengal-Udaynarayanpur
2,SAMIR KUMAR PANJA,All India Trinamool Congress,101023,487,101510,51.21,West Bengal-Udaynarayanpur
3,SUMIT RANJAN KARAR,Bharatiya Janata Party,87338,174,87512,44.15,West Bengal-Udaynarayanpur
4,ARNAB ADHIKARY,Independent,1716,2,1718,0.87,West Bengal-Udaynarayanpur
5,SAMIT KARMAKAR,Independent,1072,1,1073,0.54,West Bengal-Udaynarayanpur
6,NOTA,None of the Above,1216,4,1220,0.62,West Bengal-Udaynarayanpur
1,SK KUTUB UDDIN AHMED,All India Forward Bloc,21098,12,21110,10.44,West Bengal-Uluberia Dakshin
2,PAPIA DEY (ADHIKARY),Bharatiya Janata Party,73363,79,73442,36.31,West Bengal-Uluberia Dakshin
3,PULAK ROY,All India Trinamool Congress,101796,84,101880,50.37,West Bengal-Uluberia Dakshin
4,JAYANTA KHATUA,SOCIALIST UNITY CENTRE OF INDIA (COMMUNIST),1165,0,1165,0.58,West Bengal-Uluberia Dakshin
5,RAM PROSAD GHORAI,Indian Unity Centre,1024,0,1024,0.51,West Bengal-Uluberia Dakshin
6,AMAL KUMAR BARMAN,Independent,1314,0,1314,0.65,West Bengal-Uluberia Dakshin
7,SUJIT MONDAL,Independent,857,0,857,0.42,West Bengal-Uluberia Dakshin
8,NOTA,None of the Above,1473,1,1474,0.73,West Bengal-Uluberia Dakshin
1,PRATYUSH MANDAL,Bharatiya Janata Party,69110,290,69400,35.95,West Bengal-Uluberia Purba
2,BIDESH RANJAN BOSE,All India Trinamool Congress,86322,204,86526,44.83,West Bengal-Uluberia Purba
3,ANOWAR MALLICK,Indian Unity Centre,1231,2,1233,0.64,West Bengal-Uluberia Purba
4,ABBAS UDDIN KHAN,Rashtriya Secular Majlis Party,30377,81,30458,15.78,West Bengal-Uluberia Purba
5,GANESH DAS,Independent,1074,1,1075,0.56,West Bengal-Uluberia Purba
6,SIYABADDIN KAJI,Independent,600,1,601,0.31,West Bengal-Uluberia Purba
7,SUSHANTA DOLUI,Independent,1616,1,1617,0.84,West Bengal-Uluberia Purba
8,NOTA,None of the Above,2100,11,2111,1.09,West Bengal-Uluberia Purba
1,Ashok Dalui,Communist Party of India  (Marxist),19259,33,19292,10.38,West Bengal-Uluberia Uttar
2,CHIRAN BERA,Bharatiya Janata Party,70378,120,70498,37.95,West Bengal-Uluberia Uttar
3,Dr. Nirmal Maji,All India Trinamool Congress,91324,177,91501,49.25,West Bengal-Uluberia Uttar
4,Avijit Das,Independent,935,0,935,0.5,West Bengal-Uluberia Uttar
5,Ganesh Chandra Hazra,Independent,365,2,367,0.2,West Bengal-Uluberia Uttar
6,NIRAPADA PANDIT,Independent,1181,0,1181,0.64,West Bengal-Uluberia Uttar
7,VIBEKANANDA MONDAL,Independent,758,0,758,0.41,West Bengal-Uluberia Uttar
8,NOTA,None of the Above,1244,4,1248,0.67,West Bengal-Uluberia Uttar
1,KANCHAN MULLICK,All India Trinamool Congress,93334,544,93878,46.96,West Bengal-Uttarpara
2,PRABIR KUMAR GHOSAL,Bharatiya Janata Party,57603,286,57889,28.96,West Bengal-Uttarpara
3,RAJAT BANERJEE (BAPPA),Communist Party of India  (Marxist),42376,342,42718,21.37,West Bengal-Uttarpara
4,SOURAV ROY,Communist Party of India  (Marxist-Leninist)  (Liberation),1217,6,1223,0.61,West Bengal-Uttarpara
5,RANJAN MUKHERJEE,Independent,826,7,833,0.42,West Bengal-Uttarpara
6,NOTA,None of the Above,3342,11,3353,1.68,West Bengal-Uttarpara
